84;Auvergne-Rhône-Alpes;01;2;08;001;L' Abergement-Clémenciat;776;18;794
84;Auvergne-Rhône-Alpes;01;1;01;002;L' Abergement-de-Varey;248;1;249
84;Auvergne-Rhône-Alpes;01;1;01;004;Ambérieu-en-Bugey;14035;393;14428
84;Auvergne-Rhône-Alpes;01;2;22;005;Ambérieux-en-Dombes;1689;34;1723
84;Auvergne-Rhône-Alpes;01;1;04;006;Ambléon;111;6;117
84;Auvergne-Rhône-Alpes;01;1;01;007;Ambronay;2726;115;2841
84;Auvergne-Rhône-Alpes;01;1;01;008;Ambutrix;752;15;767
84;Auvergne-Rhône-Alpes;01;1;04;009;Andert-et-Condon;330;9;339
84;Auvergne-Rhône-Alpes;01;1;10;010;Anglefort;1115;17;1132
84;Auvergne-Rhône-Alpes;01;4;14;011;Apremont;376;11;387
84;Auvergne-Rhône-Alpes;01;1;10;012;Aranc;326;4;330
84;Auvergne-Rhône-Alpes;01;1;01;013;Arandas;144;4;148
84;Auvergne-Rhône-Alpes;01;4;15;014;Arbent;3367;92;3459
84;Auvergne-Rhône-Alpes;01;2;17;016;Arbigny;463;5;468
84;Auvergne-Rhône-Alpes;01;1;04;015;Arboys en Bugey;644;17;661
84;Auvergne-Rhône-Alpes;01;1;01;017;Argis;442;16;458
84;Auvergne-Rhône-Alpes;01;1;10;019;Armix;28;1;29
84;Auvergne-Rhône-Alpes;01;2;22;021;Ars-sur-Formans;1408;30;1438
84;Auvergne-Rhône-Alpes;01;1;10;022;Artemare;1237;18;1255
84;Auvergne-Rhône-Alpes;01;1;10;453;Arvière-en-Valromey;713;22;735
84;Auvergne-Rhône-Alpes;01;2;17;023;Asnières-sur-Saône;66;0;66
84;Auvergne-Rhône-Alpes;01;2;02;024;Attignat;3211;64;3275
84;Auvergne-Rhône-Alpes;01;2;17;025;Bâgé-Dommartin;4092;108;4200
84;Auvergne-Rhône-Alpes;01;2;17;026;Bâgé-le-Châtel;923;60;983
84;Auvergne-Rhône-Alpes;01;2;12;027;Balan;2684;57;2741
84;Auvergne-Rhône-Alpes;01;2;22;028;Baneins;602;9;611
84;Auvergne-Rhône-Alpes;01;4;14;170;Béard-Géovreissiat;1051;28;1079
84;Auvergne-Rhône-Alpes;01;2;18;029;Beaupont;689;8;697
84;Auvergne-Rhône-Alpes;01;2;21;030;Beauregard;866;14;880
84;Auvergne-Rhône-Alpes;01;2;12;032;Béligneux;3333;29;3362
84;Auvergne-Rhône-Alpes;01;1;04;034;Belley;9103;396;9499
84;Auvergne-Rhône-Alpes;01;4;14;035;Belleydoux;314;8;322
84;Auvergne-Rhône-Alpes;01;4;14;031;Bellignat;3624;235;3859
84;Auvergne-Rhône-Alpes;01;1;11;037;Bénonces;298;4;302
84;Auvergne-Rhône-Alpes;01;2;18;038;Bény;756;21;777
84;Auvergne-Rhône-Alpes;01;1;10;039;Béon;454;8;462
84;Auvergne-Rhône-Alpes;01;2;02;040;Béréziat;496;5;501
84;Auvergne-Rhône-Alpes;01;1;01;041;Bettant;748;21;769
84;Auvergne-Rhône-Alpes;01;2;23;042;Bey;279;14;293
84;Auvergne-Rhône-Alpes;01;2;13;043;Beynost;4613;108;4721
84;Auvergne-Rhône-Alpes;01;4;03;044;Billiat;622;15;637
84;Auvergne-Rhône-Alpes;01;2;22;045;Birieux;283;4;287
84;Auvergne-Rhône-Alpes;01;2;23;046;Biziat;876;9;885
84;Auvergne-Rhône-Alpes;01;1;11;047;Blyes;1007;25;1032
84;Auvergne-Rhône-Alpes;01;2;18;245;Bohas-Meyriat-Rignat;913;21;934
84;Auvergne-Rhône-Alpes;01;2;13;049;La Boisse;3229;38;3267
84;Auvergne-Rhône-Alpes;01;2;17;050;Boissey;336;6;342
84;Auvergne-Rhône-Alpes;01;4;16;051;Bolozon;89;1;90
84;Auvergne-Rhône-Alpes;01;2;22;052;Bouligneux;328;6;334
84;Auvergne-Rhône-Alpes;01;2;99;053;Bourg-en-Bresse;41527;1779;43306
84;Auvergne-Rhône-Alpes;01;1;12;054;Bourg-Saint-Christophe;1366;29;1395
84;Auvergne-Rhône-Alpes;01;4;16;056;Boyeux-Saint-Jérôme;346;5;351
84;Auvergne-Rhône-Alpes;01;2;17;057;Boz;512;7;519
84;Auvergne-Rhône-Alpes;01;1;04;058;Brégnier-Cordon;839;13;852
84;Auvergne-Rhône-Alpes;01;4;10;060;Brénod;509;21;530
84;Auvergne-Rhône-Alpes;01;1;04;061;Brens;1166;27;1193
84;Auvergne-Rhône-Alpes;01;2;02;130;Bresse Vallons;2282;45;2327
84;Auvergne-Rhône-Alpes;01;2;12;062;Bressolles;911;20;931
84;Auvergne-Rhône-Alpes;01;4;14;063;Brion;521;7;528
84;Auvergne-Rhône-Alpes;01;1;11;064;Briord;1016;10;1026
84;Auvergne-Rhône-Alpes;01;2;02;065;Buellas;1782;63;1845
84;Auvergne-Rhône-Alpes;01;1;04;066;La Burbanche;77;1;78
84;Auvergne-Rhône-Alpes;01;4;16;067;Ceignes;254;13;267
84;Auvergne-Rhône-Alpes;01;4;16;068;Cerdon;783;14;797
84;Auvergne-Rhône-Alpes;01;2;07;069;Certines;1517;40;1557
84;Auvergne-Rhône-Alpes;01;3;09;071;Cessy;4856;116;4972
84;Auvergne-Rhône-Alpes;01;2;07;072;Ceyzériat;3157;61;3218
84;Auvergne-Rhône-Alpes;01;1;04;073;Ceyzérieu;1007;26;1033
84;Auvergne-Rhône-Alpes;01;2;07;074;Chalamont;2451;33;2484
84;Auvergne-Rhône-Alpes;01;2;22;075;Chaleins;1342;34;1376
84;Auvergne-Rhône-Alpes;01;1;10;076;Chaley;130;3;133
84;Auvergne-Rhône-Alpes;01;4;16;077;Challes-la-Montagne;194;3;197
84;Auvergne-Rhône-Alpes;01;3;20;078;Challex;1481;17;1498
84;Auvergne-Rhône-Alpes;01;1;10;079;Champagne-en-Valromey;820;31;851
84;Auvergne-Rhône-Alpes;01;1;10;080;Champdor-Corcelles;651;14;665
84;Auvergne-Rhône-Alpes;01;4;03;081;Champfromier;729;21;750
84;Auvergne-Rhône-Alpes;01;4;03;082;Chanay;625;14;639
84;Auvergne-Rhône-Alpes;01;2;22;083;Chaneins;910;15;925
84;Auvergne-Rhône-Alpes;01;2;23;084;Chanoz-Châtenay;844;17;861
84;Auvergne-Rhône-Alpes;01;2;08;085;La Chapelle-du-Châtelard;388;5;393
84;Auvergne-Rhône-Alpes;01;4;14;087;Charix;285;10;295
84;Auvergne-Rhône-Alpes;01;1;11;088;Charnoz-sur-Ain;913;27;940
84;Auvergne-Rhône-Alpes;01;1;01;089;Château-Gaillard;2138;49;2187
84;Auvergne-Rhône-Alpes;01;2;07;090;Châtenay;341;4;345
84;Auvergne-Rhône-Alpes;01;2;07;092;Châtillon-la-Palud;1584;68;1652
84;Auvergne-Rhône-Alpes;01;2;08;093;Châtillon-sur-Chalaronne;4859;201;5060
84;Auvergne-Rhône-Alpes;01;2;17;094;Chavannes-sur-Reyssouze;753;12;765
84;Auvergne-Rhône-Alpes;01;2;23;096;Chaveyriat;1008;29;1037
84;Auvergne-Rhône-Alpes;01;1;04;098;Chazey-Bons;1112;36;1148
84;Auvergne-Rhône-Alpes;01;1;11;099;Chazey-sur-Ain;1514;37;1551
84;Auvergne-Rhône-Alpes;01;1;04;100;Cheignieu-la-Balme;134;4;138
84;Auvergne-Rhône-Alpes;01;4;10;101;Chevillard;151;9;160
84;Auvergne-Rhône-Alpes;01;2;17;102;Chevroux;952;15;967
84;Auvergne-Rhône-Alpes;01;3;20;103;Chevry;1812;40;1852
84;Auvergne-Rhône-Alpes;01;3;20;104;Chézery-Forens;467;11;478
84;Auvergne-Rhône-Alpes;01;2;22;105;Civrieux;1680;56;1736
84;Auvergne-Rhône-Alpes;01;2;18;106;Cize;173;8;181
84;Auvergne-Rhône-Alpes;01;1;01;107;Cleyzieu;136;4;140
84;Auvergne-Rhône-Alpes;01;2;18;108;Coligny;1181;25;1206
84;Auvergne-Rhône-Alpes;01;3;20;109;Collonges;2219;46;2265
84;Auvergne-Rhône-Alpes;01;1;04;110;Colomieu;140;2;142
84;Auvergne-Rhône-Alpes;01;1;01;111;Conand;124;1;125
84;Auvergne-Rhône-Alpes;01;4;10;112;Condamine;411;37;448
84;Auvergne-Rhône-Alpes;01;2;08;113;Condeissiat;822;13;835
84;Auvergne-Rhône-Alpes;01;4;03;114;Confort;648;12;660
84;Auvergne-Rhône-Alpes;01;2;02;115;Confrançon;1336;29;1365
84;Auvergne-Rhône-Alpes;01;1;04;116;Contrevoz;499;11;510
84;Auvergne-Rhône-Alpes;01;1;04;117;Conzieu;148;2;150
84;Auvergne-Rhône-Alpes;01;1;10;118;Corbonod;1264;33;1297
84;Auvergne-Rhône-Alpes;01;1;10;121;Corlier;114;1;115
84;Auvergne-Rhône-Alpes;01;2;23;123;Cormoranche-sur-Saône;1138;37;1175
84;Auvergne-Rhône-Alpes;01;2;18;124;Cormoz;664;15;679
84;Auvergne-Rhône-Alpes;01;2;18;125;Corveissiat;621;13;634
84;Auvergne-Rhône-Alpes;01;2;18;127;Courmangoux;507;9;516
84;Auvergne-Rhône-Alpes;01;2;17;128;Courtes;313;2;315
84;Auvergne-Rhône-Alpes;01;2;07;129;Crans;266;4;270
84;Auvergne-Rhône-Alpes;01;1;04;133;Cressin-Rochefort;392;11;403
84;Auvergne-Rhône-Alpes;01;2;23;134;Crottet;1734;43;1777
84;Auvergne-Rhône-Alpes;01;3;20;135;Crozet;2138;63;2201
84;Auvergne-Rhône-Alpes;01;2;23;136;Cruzilles-lès-Mépillat;868;20;888
84;Auvergne-Rhône-Alpes;01;1;10;138;Culoz;3035;47;3082
84;Auvergne-Rhône-Alpes;01;2;17;139;Curciat-Dongalon;440;5;445
84;Auvergne-Rhône-Alpes;01;2;02;140;Curtafond;770;19;789
84;Auvergne-Rhône-Alpes;01;1;04;141;Cuzieu;448;15;463
84;Auvergne-Rhône-Alpes;01;2;12;142;Dagneux;4717;55;4772
84;Auvergne-Rhône-Alpes;01;3;09;143;Divonne-les-Bains;9644;234;9878
84;Auvergne-Rhône-Alpes;01;2;08;146;Dompierre-sur-Chalaronne;435;10;445
84;Auvergne-Rhône-Alpes;01;2;07;145;Dompierre-sur-Veyle;1166;21;1187
84;Auvergne-Rhône-Alpes;01;2;18;147;Domsure;486;3;489
84;Auvergne-Rhône-Alpes;01;4;16;148;Dortan;1846;44;1890
84;Auvergne-Rhône-Alpes;01;1;01;149;Douvres;1041;26;1067
84;Auvergne-Rhône-Alpes;01;2;18;150;Drom;216;5;221
84;Auvergne-Rhône-Alpes;01;2;07;151;Druillat;1159;19;1178
84;Auvergne-Rhône-Alpes;01;4;14;152;Échallon;757;20;777
84;Auvergne-Rhône-Alpes;01;3;20;153;Échenevex;2132;73;2205
84;Auvergne-Rhône-Alpes;01;1;10;155;Évosges;145;2;147
84;Auvergne-Rhône-Alpes;01;1;12;156;Faramans;806;12;818
84;Auvergne-Rhône-Alpes;01;2;22;157;Fareins;2204;42;2246
84;Auvergne-Rhône-Alpes;01;3;20;158;Farges;1038;11;1049
84;Auvergne-Rhône-Alpes;01;2;17;159;Feillens;3291;69;3360
84;Auvergne-Rhône-Alpes;01;3;19;160;Ferney-Voltaire;9766;162;9928
84;Auvergne-Rhône-Alpes;01;1;04;162;Flaxieu;68;3;71
84;Auvergne-Rhône-Alpes;01;2;02;163;Foissiat;2085;39;2124
84;Auvergne-Rhône-Alpes;01;2;22;165;Francheleins;1611;32;1643
84;Auvergne-Rhône-Alpes;01;2;21;166;Frans;2351;56;2407
84;Auvergne-Rhône-Alpes;01;2;08;167;Garnerans;647;25;672
84;Auvergne-Rhône-Alpes;01;2;08;169;Genouilleux;612;20;632
84;Auvergne-Rhône-Alpes;01;4;14;171;Géovreisset;874;43;917
84;Auvergne-Rhône-Alpes;01;3;09;173;Gex;13118;257;13375
84;Auvergne-Rhône-Alpes;01;4;03;174;Giron;183;4;187
84;Auvergne-Rhône-Alpes;01;2;17;175;Gorrevod;835;25;860
84;Auvergne-Rhône-Alpes;01;2;18;177;Grand-Corent;177;6;183
84;Auvergne-Rhône-Alpes;01;2;23;179;Grièges;1876;52;1928
84;Auvergne-Rhône-Alpes;01;3;09;180;Grilly;833;20;853
84;Auvergne-Rhône-Alpes;01;4;14;181;Groissiat;1229;52;1281
84;Auvergne-Rhône-Alpes;01;1;89;338;Groslée-Saint-Benoit;1193;36;1229
84;Auvergne-Rhône-Alpes;01;2;08;183;Guéreins;1452;25;1477
84;Auvergne-Rhône-Alpes;01;1;10;187;Haut Valromey;669;22;691
84;Auvergne-Rhône-Alpes;01;2;18;184;Hautecourt-Romanèche;777;20;797
84;Auvergne-Rhône-Alpes;01;2;08;188;Illiat;627;17;644
84;Auvergne-Rhône-Alpes;01;4;03;189;Injoux-Génissiat;1136;26;1162
84;Auvergne-Rhône-Alpes;01;1;11;190;Innimond;89;3;92
84;Auvergne-Rhône-Alpes;01;4;10;191;Izenave;156;4;160
84;Auvergne-Rhône-Alpes;01;4;16;192;Izernore;2247;62;2309
84;Auvergne-Rhône-Alpes;01;1;04;193;Izieu;235;7;242
84;Auvergne-Rhône-Alpes;01;2;21;194;Jassans-Riottier;6339;119;6458
84;Auvergne-Rhône-Alpes;01;2;18;195;Jasseron;1755;52;1807
84;Auvergne-Rhône-Alpes;01;2;02;196;Jayat;1182;12;1194
84;Auvergne-Rhône-Alpes;01;2;07;197;Journans;355;14;369
84;Auvergne-Rhône-Alpes;01;1;12;198;Joyeux;271;3;274
84;Auvergne-Rhône-Alpes;01;4;16;199;Jujurieux;2156;44;2200
84;Auvergne-Rhône-Alpes;01;4;16;200;Labalme;210;2;212
84;Auvergne-Rhône-Alpes;01;1;11;202;Lagnieu;7143;146;7289
84;Auvergne-Rhône-Alpes;01;2;23;203;Laiz;1212;39;1251
84;Auvergne-Rhône-Alpes;01;4;10;206;Lantenay;277;6;283
84;Auvergne-Rhône-Alpes;01;2;22;207;Lapeyrouse;316;12;328
84;Auvergne-Rhône-Alpes;01;1;04;208;Lavours;124;6;130
84;Auvergne-Rhône-Alpes;01;3;20;209;Léaz;739;15;754
84;Auvergne-Rhône-Alpes;01;3;20;210;Lélex;227;4;231
84;Auvergne-Rhône-Alpes;01;2;07;211;Lent;1405;34;1439
84;Auvergne-Rhône-Alpes;01;2;17;212;Lescheroux;735;8;743
84;Auvergne-Rhône-Alpes;01;1;11;213;Leyment;1303;29;1332
84;Auvergne-Rhône-Alpes;01;4;16;214;Leyssard;152;4;156
84;Auvergne-Rhône-Alpes;01;1;11;216;Lhuis;889;21;910
84;Auvergne-Rhône-Alpes;01;1;11;219;Lompnas;168;3;171
84;Auvergne-Rhône-Alpes;01;1;11;224;Loyettes;3146;30;3176
84;Auvergne-Rhône-Alpes;01;2;22;225;Lurcy;384;9;393
84;Auvergne-Rhône-Alpes;01;1;04;227;Magnieu;644;13;657
84;Auvergne-Rhône-Alpes;01;4;14;228;Maillat;635;13;648
84;Auvergne-Rhône-Alpes;01;2;02;229;Malafretaz;1216;24;1240
84;Auvergne-Rhône-Alpes;01;2;17;230;Mantenay-Montlin;313;7;320
84;Auvergne-Rhône-Alpes;01;2;17;231;Manziat;1963;49;2012
84;Auvergne-Rhône-Alpes;01;2;18;232;Marboz;2244;47;2291
84;Auvergne-Rhône-Alpes;01;1;11;233;Marchamp;131;3;134
84;Auvergne-Rhône-Alpes;01;1;04;234;Marignieu;172;3;175
84;Auvergne-Rhône-Alpes;01;2;08;235;Marlieux;1112;95;1207
84;Auvergne-Rhône-Alpes;01;2;02;236;Marsonnas;991;28;1019
84;Auvergne-Rhône-Alpes;01;4;14;237;Martignat;1654;66;1720
84;Auvergne-Rhône-Alpes;01;2;21;238;Massieux;2590;60;2650
84;Auvergne-Rhône-Alpes;01;1;04;239;Massignieu-de-Rives;614;14;628
84;Auvergne-Rhône-Alpes;01;4;16;240;Matafelon-Granges;641;17;658
84;Auvergne-Rhône-Alpes;01;2;18;241;Meillonnas;1335;33;1368
84;Auvergne-Rhône-Alpes;01;4;16;242;Mérignat;130;4;134
84;Auvergne-Rhône-Alpes;01;2;22;243;Messimy-sur-Saône;1224;32;1256
84;Auvergne-Rhône-Alpes;01;1;12;244;Meximieux;7743;128;7871
84;Auvergne-Rhône-Alpes;01;2;23;246;Mézériat;2172;37;2209
84;Auvergne-Rhône-Alpes;01;3;20;247;Mijoux;341;12;353
84;Auvergne-Rhône-Alpes;01;2;22;248;Mionnay;2100;47;2147
84;Auvergne-Rhône-Alpes;01;2;13;249;Miribel;9963;112;10075
84;Auvergne-Rhône-Alpes;01;2;21;250;Misérieux;1941;254;2195
84;Auvergne-Rhône-Alpes;01;2;08;252;Mogneneins;778;23;801
84;Auvergne-Rhône-Alpes;01;2;07;254;Montagnat;1992;48;2040
84;Auvergne-Rhône-Alpes;01;1;11;255;Montagnieu;622;12;634
84;Auvergne-Rhône-Alpes;01;4;03;257;Montanges;344;10;354
84;Auvergne-Rhône-Alpes;01;2;08;258;Montceaux;1195;36;1231
84;Auvergne-Rhône-Alpes;01;2;02;259;Montcet;691;15;706
84;Auvergne-Rhône-Alpes;01;1;12;260;Le Montellier;297;8;305
84;Auvergne-Rhône-Alpes;01;2;22;261;Monthieux;646;23;669
84;Auvergne-Rhône-Alpes;01;2;12;262;Montluel;6964;84;7048
84;Auvergne-Rhône-Alpes;01;2;08;263;Montmerle-sur-Saône;3793;66;3859
84;Auvergne-Rhône-Alpes;01;2;02;264;Montracol;1040;20;1060
84;Auvergne-Rhône-Alpes;01;4;14;265;Montréal-la-Cluse;3435;70;3505
84;Auvergne-Rhône-Alpes;01;2;02;266;Montrevel-en-Bresse;2489;42;2531
84;Auvergne-Rhône-Alpes;01;1;04;268;Murs-et-Gélignieux;252;4;256
84;Auvergne-Rhône-Alpes;01;4;14;269;Nantua;3446;138;3584
84;Auvergne-Rhône-Alpes;01;2;08;272;Neuville-les-Dames;1510;21;1531
84;Auvergne-Rhône-Alpes;01;4;16;273;Neuville-sur-Ain;1756;28;1784
84;Auvergne-Rhône-Alpes;01;4;14;274;Les Neyrolles;639;15;654
84;Auvergne-Rhône-Alpes;01;2;13;275;Neyron;2527;49;2576
84;Auvergne-Rhône-Alpes;01;2;13;276;Niévroz;1619;27;1646
84;Auvergne-Rhône-Alpes;01;2;18;095;Nivigne et Suran;814;11;825
84;Auvergne-Rhône-Alpes;01;1;01;277;Nivollet-Montgriffon;119;2;121
84;Auvergne-Rhône-Alpes;01;4;16;267;Nurieux-Volognat;1028;24;1052
84;Auvergne-Rhône-Alpes;01;1;01;279;Oncieu;89;6;95
84;Auvergne-Rhône-Alpes;01;1;11;280;Ordonnaz;141;1;142
84;Auvergne-Rhône-Alpes;01;3;19;281;Ornex;4410;165;4575
84;Auvergne-Rhône-Alpes;01;4;10;282;Outriaz;260;6;266
84;Auvergne-Rhône-Alpes;01;4;15;283;Oyonnax;22427;516;22943
84;Auvergne-Rhône-Alpes;01;2;17;284;Ozan;686;6;692
84;Auvergne-Rhône-Alpes;01;2;21;285;Parcieux;1206;29;1235
84;Auvergne-Rhône-Alpes;01;1;04;286;Parves et Nattages;942;38;980
84;Auvergne-Rhône-Alpes;01;3;20;288;Péron;2620;53;2673
84;Auvergne-Rhône-Alpes;01;2;06;289;Péronnas;6385;290;6675
84;Auvergne-Rhône-Alpes;01;1;12;290;Pérouges;1201;27;1228
84;Auvergne-Rhône-Alpes;01;2;23;291;Perrex;838;7;845
84;Auvergne-Rhône-Alpes;01;4;16;293;Peyriat;157;4;161
84;Auvergne-Rhône-Alpes;01;1;04;294;Peyrieu;873;15;888
84;Auvergne-Rhône-Alpes;01;2;08;295;Peyzieux-sur-Saône;661;13;674
84;Auvergne-Rhône-Alpes;01;2;18;296;Pirajoux;408;7;415
84;Auvergne-Rhône-Alpes;01;2;12;297;Pizay;820;14;834
84;Auvergne-Rhône-Alpes;01;4;03;298;Plagne;132;2;134
84;Auvergne-Rhône-Alpes;01;2;07;299;Le Plantay;564;9;573
84;Auvergne-Rhône-Alpes;01;1;10;185;Plateau d'Hauteville;4853;178;5031
84;Auvergne-Rhône-Alpes;01;4;14;204;Le Poizat-Lalleyriat;720;15;735
84;Auvergne-Rhône-Alpes;01;2;02;301;Polliat;2511;61;2572
84;Auvergne-Rhône-Alpes;01;1;04;302;Pollieu;159;6;165
84;Auvergne-Rhône-Alpes;01;4;16;303;Poncin;1703;35;1738
84;Auvergne-Rhône-Alpes;01;4;16;304;Pont-d'Ain;2964;29;2993
84;Auvergne-Rhône-Alpes;01;2;17;305;Pont-de-Vaux;2258;45;2303
84;Auvergne-Rhône-Alpes;01;2;23;306;Pont-de-Veyle;1625;65;1690
84;Auvergne-Rhône-Alpes;01;4;14;307;Port;849;20;869
84;Auvergne-Rhône-Alpes;01;3;20;308;Pougny;812;14;826
84;Auvergne-Rhône-Alpes;01;2;18;309;Pouillat;88;0;88
84;Auvergne-Rhône-Alpes;01;1;04;310;Prémeyzel;248;4;252
84;Auvergne-Rhône-Alpes;01;1;10;311;Prémillieu;45;0;45
84;Auvergne-Rhône-Alpes;01;3;19;313;Prévessin-Moëns;8233;198;8431
84;Auvergne-Rhône-Alpes;01;4;16;314;Priay;1729;34;1763
84;Auvergne-Rhône-Alpes;01;2;18;317;Ramasse;324;6;330
84;Auvergne-Rhône-Alpes;01;2;22;318;Rancé;727;17;744
84;Auvergne-Rhône-Alpes;01;2;22;319;Relevant;463;5;468
84;Auvergne-Rhône-Alpes;01;2;17;320;Replonges;3717;79;3796
84;Auvergne-Rhône-Alpes;01;2;07;321;Revonnas;905;29;934
84;Auvergne-Rhône-Alpes;01;2;21;322;Reyrieux;4797;132;4929
84;Auvergne-Rhône-Alpes;01;2;17;323;Reyssouze;980;13;993
84;Auvergne-Rhône-Alpes;01;1;12;325;Rignieux-le-Franc;971;17;988
84;Auvergne-Rhône-Alpes;01;2;08;328;Romans;590;4;594
84;Auvergne-Rhône-Alpes;01;1;04;329;Rossillon;151;6;157
84;Auvergne-Rhône-Alpes;01;1;10;330;Ruffieu;186;5;191
84;Auvergne-Rhône-Alpes;01;4;16;331;Saint-Alban;178;4;182
84;Auvergne-Rhône-Alpes;01;2;23;334;Saint-André-d'Huiriat;626;9;635
84;Auvergne-Rhône-Alpes;01;2;17;332;Saint-André-de-Bâgé;751;22;773
84;Auvergne-Rhône-Alpes;01;2;22;333;Saint-André-de-Corcy;3354;54;3408
84;Auvergne-Rhône-Alpes;01;2;08;335;Saint-André-le-Bouchoux;390;6;396
84;Auvergne-Rhône-Alpes;01;2;07;336;Saint-André-sur-Vieux-Jonc;1147;29;1176
84;Auvergne-Rhône-Alpes;01;2;17;337;Saint-Bénigne;1265;27;1292
84;Auvergne-Rhône-Alpes;01;2;21;339;Saint-Bernard;1433;42;1475
84;Auvergne-Rhône-Alpes;01;2;23;343;Saint-Cyr-sur-Menthon;1776;40;1816
84;Auvergne-Rhône-Alpes;01;1;01;345;Saint-Denis-en-Bugey;2309;27;2336
84;Auvergne-Rhône-Alpes;01;2;06;344;Saint-Denis-lès-Bourg;5747;161;5908
84;Auvergne-Rhône-Alpes;01;2;02;346;Saint-Didier-d'Aussiat;871;13;884
84;Auvergne-Rhône-Alpes;01;2;21;347;Saint-Didier-de-Formans;1960;69;2029
84;Auvergne-Rhône-Alpes;01;2;08;348;Saint-Didier-sur-Chalaronne;2875;63;2938
84;Auvergne-Rhône-Alpes;01;1;12;349;Saint-Éloi;456;5;461
84;Auvergne-Rhône-Alpes;01;2;18;350;Saint-Étienne-du-Bois;2448;37;2485
84;Auvergne-Rhône-Alpes;01;2;08;351;Saint-Étienne-sur-Chalaronne;1555;27;1582
84;Auvergne-Rhône-Alpes;01;2;17;352;Saint-Étienne-sur-Reyssouze;571;6;577
84;Auvergne-Rhône-Alpes;01;3;19;354;Saint-Genis-Pouilly;12544;181;12725
84;Auvergne-Rhône-Alpes;01;2;23;355;Saint-Genis-sur-Menthon;472;7;479
84;Auvergne-Rhône-Alpes;01;2;08;356;Saint-Georges-sur-Renon;214;5;219
84;Auvergne-Rhône-Alpes;01;4;03;357;Saint-Germain-de-Joux;501;5;506
84;Auvergne-Rhône-Alpes;01;1;04;358;Saint-Germain-les-Paroisses;434;3;437
84;Auvergne-Rhône-Alpes;01;2;08;359;Saint-Germain-sur-Renon;236;4;240
84;Auvergne-Rhône-Alpes;01;3;20;360;Saint-Jean-de-Gonville;1787;44;1831
84;Auvergne-Rhône-Alpes;01;1;11;361;Saint-Jean-de-Niost;1477;42;1519
84;Auvergne-Rhône-Alpes;01;2;22;362;Saint-Jean-de-Thurigneux;771;13;784
84;Auvergne-Rhône-Alpes;01;4;16;363;Saint-Jean-le-Vieux;1723;79;1802
84;Auvergne-Rhône-Alpes;01;2;17;364;Saint-Jean-sur-Reyssouze;744;7;751
84;Auvergne-Rhône-Alpes;01;2;23;365;Saint-Jean-sur-Veyle;1149;20;1169
84;Auvergne-Rhône-Alpes;01;2;17;367;Saint-Julien-sur-Reyssouze;749;4;753
84;Auvergne-Rhône-Alpes;01;2;23;368;Saint-Julien-sur-Veyle;817;15;832
84;Auvergne-Rhône-Alpes;01;2;07;369;Saint-Just;926;24;950
84;Auvergne-Rhône-Alpes;01;2;23;370;Saint-Laurent-sur-Saône;1722;27;1749
84;Auvergne-Rhône-Alpes;01;2;22;371;Saint-Marcel;1279;25;1304
84;Auvergne-Rhône-Alpes;01;1;04;372;Saint-Martin-de-Bavel;438;5;443
84;Auvergne-Rhône-Alpes;01;4;14;373;Saint-Martin-du-Frêne;1049;36;1085
84;Auvergne-Rhône-Alpes;01;2;07;374;Saint-Martin-du-Mont;1826;45;1871
84;Auvergne-Rhône-Alpes;01;2;02;375;Saint-Martin-le-Châtel;787;20;807
84;Auvergne-Rhône-Alpes;01;2;13;376;Saint-Maurice-de-Beynost;3967;39;4006
84;Auvergne-Rhône-Alpes;01;1;11;378;Saint-Maurice-de-Gourdans;2572;53;2625
84;Auvergne-Rhône-Alpes;01;1;01;379;Saint-Maurice-de-Rémens;756;9;765
84;Auvergne-Rhône-Alpes;01;2;17;380;Saint-Nizier-le-Bouchoux;680;12;692
84;Auvergne-Rhône-Alpes;01;2;07;381;Saint-Nizier-le-Désert;916;19;935
84;Auvergne-Rhône-Alpes;01;2;08;383;Saint-Paul-de-Varax;1529;20;1549
84;Auvergne-Rhône-Alpes;01;1;01;384;Saint-Rambert-en-Bugey;2269;33;2302
84;Auvergne-Rhône-Alpes;01;2;06;385;Saint-Rémy;994;23;1017
84;Auvergne-Rhône-Alpes;01;1;11;386;Saint-Sorlin-en-Bugey;1157;62;1219
84;Auvergne-Rhône-Alpes;01;2;02;387;Saint-Sulpice;257;4;261
84;Auvergne-Rhône-Alpes;01;2;17;388;Saint-Trivier-de-Courtes;1093;9;1102
84;Auvergne-Rhône-Alpes;01;2;22;389;Saint-Trivier-sur-Moignans;1799;41;1840
84;Auvergne-Rhône-Alpes;01;1;11;390;Saint-Vulbas;1286;20;1306
84;Auvergne-Rhône-Alpes;01;2;12;342;Sainte-Croix;570;8;578
84;Auvergne-Rhône-Alpes;01;2;21;353;Sainte-Euphémie;1667;28;1695
84;Auvergne-Rhône-Alpes;01;1;11;366;Sainte-Julie;1017;17;1034
84;Auvergne-Rhône-Alpes;01;2;22;382;Sainte-Olive;283;2;285
84;Auvergne-Rhône-Alpes;01;2;18;391;Salavre;272;9;281
84;Auvergne-Rhône-Alpes;01;4;16;392;Samognat;653;27;680
84;Auvergne-Rhône-Alpes;01;2;08;393;Sandrans;530;5;535
84;Auvergne-Rhône-Alpes;01;1;11;396;Sault-Brénaz;953;13;966
84;Auvergne-Rhône-Alpes;01;3;09;397;Sauverny;1009;21;1030
84;Auvergne-Rhône-Alpes;01;2;22;398;Savigneux;1351;16;1367
84;Auvergne-Rhône-Alpes;01;3;20;399;Ségny;2062;50;2112
84;Auvergne-Rhône-Alpes;01;1;11;400;Seillonnaz;137;3;140
84;Auvergne-Rhône-Alpes;01;3;20;401;Sergy;2084;40;2124
84;Auvergne-Rhône-Alpes;01;2;17;402;Sermoyer;668;20;688
84;Auvergne-Rhône-Alpes;01;1;11;403;Serrières-de-Briord;1264;18;1282
84;Auvergne-Rhône-Alpes;01;4;16;404;Serrières-sur-Ain;134;2;136
84;Auvergne-Rhône-Alpes;01;2;07;405;Servas;1247;28;1275
84;Auvergne-Rhône-Alpes;01;2;17;406;Servignat;175;1;176
84;Auvergne-Rhône-Alpes;01;1;10;407;Seyssel;999;18;1017
84;Auvergne-Rhône-Alpes;01;2;18;408;Simandre-sur-Suran;671;12;683
84;Auvergne-Rhône-Alpes;01;4;16;410;Sonthonnax-la-Montagne;312;7;319
84;Auvergne-Rhône-Alpes;01;1;11;411;Souclin;273;6;279
84;Auvergne-Rhône-Alpes;01;2;08;412;Sulignat;586;12;598
84;Auvergne-Rhône-Alpes;01;4;03;215;Surjoux-Lhopital;131;3;134
84;Auvergne-Rhône-Alpes;01;1;10;415;Talissieu;450;10;460
84;Auvergne-Rhône-Alpes;01;1;10;416;Tenay;1035;12;1047
84;Auvergne-Rhône-Alpes;01;2;13;418;Thil;1088;25;1113
84;Auvergne-Rhône-Alpes;01;3;20;419;Thoiry;6038;177;6215
84;Auvergne-Rhône-Alpes;01;2;08;420;Thoissey;1741;15;1756
84;Auvergne-Rhône-Alpes;01;1;01;421;Torcieu;726;16;742
84;Auvergne-Rhône-Alpes;01;2;07;422;Tossiat;1362;36;1398
84;Auvergne-Rhône-Alpes;01;2;21;423;Toussieux;1091;20;1111
84;Auvergne-Rhône-Alpes;01;2;13;424;Tramoyes;1681;43;1724
84;Auvergne-Rhône-Alpes;01;2;07;425;La Tranclière;286;7;293
84;Auvergne-Rhône-Alpes;01;2;21;427;Trévoux;6845;164;7009
84;Auvergne-Rhône-Alpes;01;2;18;426;Val-Revermont;2601;53;2654
84;Auvergne-Rhône-Alpes;01;2;08;428;Valeins;130;1;131
84;Auvergne-Rhône-Alpes;01;1;10;036;Valromey-sur-Séran;1311;18;1329
84;Auvergne-Rhône-Alpes;01;4;03;033;Valserhône;16423;381;16804
84;Auvergne-Rhône-Alpes;01;2;02;429;Vandeins;687;13;700
84;Auvergne-Rhône-Alpes;01;4;16;430;Varambon;584;14;598
84;Auvergne-Rhône-Alpes;01;1;01;431;Vaux-en-Bugey;1224;30;1254
84;Auvergne-Rhône-Alpes;01;2;18;432;Verjon;295;2;297
84;Auvergne-Rhône-Alpes;01;2;17;433;Vernoux;330;1;331
84;Auvergne-Rhône-Alpes;01;2;07;434;Versailleux;438;9;447
84;Auvergne-Rhône-Alpes;01;3;09;435;Versonnex;2176;70;2246
84;Auvergne-Rhône-Alpes;01;3;09;436;Vesancy;484;11;495
84;Auvergne-Rhône-Alpes;01;2;17;437;Vescours;241;5;246
84;Auvergne-Rhône-Alpes;01;2;17;439;Vésines;99;4;103
84;Auvergne-Rhône-Alpes;01;4;10;441;Vieu-d'Izenave;707;17;724
84;Auvergne-Rhône-Alpes;01;2;22;443;Villars-les-Dombes;4795;89;4884
84;Auvergne-Rhône-Alpes;01;1;11;444;Villebois;1173;17;1190
84;Auvergne-Rhône-Alpes;01;2;18;445;Villemotier;656;22;678
84;Auvergne-Rhône-Alpes;01;2;22;446;Villeneuve;1501;36;1537
84;Auvergne-Rhône-Alpes;01;2;18;447;Villereversure;1291;48;1339
84;Auvergne-Rhône-Alpes;01;4;03;448;Villes;376;8;384
84;Auvergne-Rhône-Alpes;01;2;07;449;Villette-sur-Ain;755;12;767
84;Auvergne-Rhône-Alpes;01;1;11;450;Villieu-Loyes-Mollon;3653;64;3717
84;Auvergne-Rhône-Alpes;01;2;05;451;Viriat;6418;148;6566
84;Auvergne-Rhône-Alpes;01;1;04;452;Virieu-le-Grand;1081;25;1106
84;Auvergne-Rhône-Alpes;01;1;04;454;Virignin;1097;21;1118
84;Auvergne-Rhône-Alpes;01;1;04;456;Vongnes;70;2;72
84;Auvergne-Rhône-Alpes;01;2;23;457;Vonnas;2961;58;3019
32;Hauts-de-France;02;2;03;001;Abbécourt;498;8;506
32;Hauts-de-France;02;2;18;002;Achery;598;8;606
32;Hauts-de-France;02;4;17;003;Acy;1012;23;1035
32;Hauts-de-France;02;2;11;004;Agnicourt-et-Séchelles;177;8;185
32;Hauts-de-France;02;2;06;005;Aguilcourt;384;8;392
32;Hauts-de-France;02;5;07;006;Aisonville-et-Bernoville;255;9;264
32;Hauts-de-France;02;2;06;007;Aizelles;125;1;126
32;Hauts-de-France;02;4;05;008;Aizy-Jouy;291;4;295
32;Hauts-de-France;02;3;12;009;Alaincourt;543;6;549
32;Hauts-de-France;02;4;05;010;Allemant;177;4;181
32;Hauts-de-France;02;4;20;011;Ambleny;1155;54;1209
32;Hauts-de-France;02;4;21;012;Ambrief;70;0;70
32;Hauts-de-France;02;2;06;013;Amifontaine;404;9;413
32;Hauts-de-France;02;2;03;014;Amigny-Rouy;744;14;758
32;Hauts-de-France;02;4;21;015;Ancienville;75;0;75
32;Hauts-de-France;02;2;18;016;Andelain;228;9;237
32;Hauts-de-France;02;2;18;017;Anguilcourt-le-Sart;315;4;319
32;Hauts-de-France;02;2;09;018;Anizy-le-Grand;2533;51;2584
32;Hauts-de-France;02;3;12;019;Annois;364;5;369
32;Hauts-de-France;02;5;08;020;Any-Martin-Rieux;456;4;460
32;Hauts-de-France;02;5;19;021;Archon;87;3;90
32;Hauts-de-France;02;4;21;022;Arcy-Sainte-Restitue;403;6;409
32;Hauts-de-France;02;1;21;023;Armentières-sur-Ourcq;103;3;106
32;Hauts-de-France;02;2;10;024;Arrancy;53;0;53
32;Hauts-de-France;02;3;12;025;Artemps;371;2;373
32;Hauts-de-France;02;2;11;027;Assis-sur-Serre;222;8;230
32;Hauts-de-France;02;2;10;028;Athies-sous-Laon;2604;59;2663
32;Hauts-de-France;02;3;13;029;Attilly;363;12;375
32;Hauts-de-France;02;3;01;030;Aubencheul-aux-Bois;269;4;273
32;Hauts-de-France;02;5;08;031;Aubenton;657;6;663
32;Hauts-de-France;02;3;12;032;Aubigny-aux-Kaisnes;253;4;257
32;Hauts-de-France;02;2;06;033;Aubigny-en-Laonnois;105;2;107
32;Hauts-de-France;02;4;20;034;Audignicourt;118;4;122
32;Hauts-de-France;02;5;07;035;Audigny;279;8;287
32;Hauts-de-France;02;4;05;036;Augy;82;1;83
32;Hauts-de-France;02;2;09;037;Aulnois-sous-Laon;1422;31;1453
32;Hauts-de-France;02;5;19;038;Les Autels;57;0;57
32;Hauts-de-France;02;2;11;039;Autremencourt;169;3;172
32;Hauts-de-France;02;5;19;040;Autreppes;178;4;182
32;Hauts-de-France;02;2;03;041;Autreville;814;13;827
32;Hauts-de-France;02;1;04;042;Azy-sur-Marne;389;2;391
32;Hauts-de-France;02;4;16;043;Bagneux;69;1;70
32;Hauts-de-France;02;5;19;044;Bancigny;26;0;26
32;Hauts-de-France;02;2;11;046;Barenton-Bugny;555;8;563
32;Hauts-de-France;02;2;11;047;Barenton-Cel;114;6;120
32;Hauts-de-France;02;2;11;048;Barenton-sur-Serre;134;4;138
32;Hauts-de-France;02;2;20;049;Barisis-aux-Bois;740;12;752
32;Hauts-de-France;02;5;07;050;Barzy-en-Thiérache;330;2;332
32;Hauts-de-France;02;1;04;051;Barzy-sur-Marne;384;6;390
32;Hauts-de-France;02;2;09;052;Bassoles-Aulers;139;6;145
32;Hauts-de-France;02;4;05;054;Bazoches-sur-Vesles;460;4;464
32;Hauts-de-France;02;5;08;055;Beaumé;92;2;94
32;Hauts-de-France;02;2;03;056;Beaumont-en-Beine;177;1;178
32;Hauts-de-France;02;3;01;057;Beaurevoir;1424;19;1443
32;Hauts-de-France;02;2;06;058;Beaurieux;844;10;854
32;Hauts-de-France;02;2;18;059;Beautor;2699;28;2727
32;Hauts-de-France;02;3;13;060;Beauvois-en-Vermandois;268;7;275
32;Hauts-de-France;02;3;01;061;Becquigny;250;7;257
32;Hauts-de-France;02;1;02;062;Belleau;136;4;140
32;Hauts-de-France;02;3;01;063;Bellenglise;381;9;390
32;Hauts-de-France;02;4;17;064;Belleu;3810;51;3861
32;Hauts-de-France;02;3;01;065;Bellicourt;602;12;614
32;Hauts-de-France;02;3;12;066;Benay;204;2;206
32;Hauts-de-France;02;5;07;067;Bergues-sur-Sambre;213;6;219
32;Hauts-de-France;02;5;11;068;Berlancourt;103;5;108
32;Hauts-de-France;02;5;19;069;Berlise;111;2;113
32;Hauts-de-France;02;5;07;070;Bernot;452;12;464
32;Hauts-de-France;02;4;20;071;Berny-Rivière;651;16;667
32;Hauts-de-France;02;2;06;072;Berrieux;188;1;189
32;Hauts-de-France;02;2;06;073;Berry-au-Bac;653;5;658
32;Hauts-de-France;02;2;18;074;Bertaucourt-Epourdon;604;10;614
32;Hauts-de-France;02;3;12;075;Berthenicourt;199;2;201
32;Hauts-de-France;02;2;06;076;Bertricourt;162;3;165
32;Hauts-de-France;02;4;17;077;Berzy-le-Sec;385;9;394
32;Hauts-de-France;02;2;20;078;Besmé;160;2;162
32;Hauts-de-France;02;5;08;079;Besmont;152;0;152
32;Hauts-de-France;02;2;09;080;Besny-et-Loizy;350;10;360
32;Hauts-de-France;02;2;03;081;Béthancourt-en-Vaux;440;8;448
32;Hauts-de-France;02;4;21;082;Beugneux;111;0;111
32;Hauts-de-France;02;1;05;083;Beuvardes;749;15;764
32;Hauts-de-France;02;1;04;084;Bézu-le-Guéry;260;5;265
32;Hauts-de-France;02;1;02;085;Bézu-Saint-Germain;1043;26;1069
32;Hauts-de-France;02;2;20;086;Bichancourt;1048;10;1058
32;Hauts-de-France;02;4;20;087;Bieuxy;30;1;31
32;Hauts-de-France;02;2;10;088;Bièvres;88;3;91
32;Hauts-de-France;02;4;17;089;Billy-sur-Aisne;1154;21;1175
32;Hauts-de-France;02;4;21;090;Billy-sur-Ourcq;213;10;223
32;Hauts-de-France;02;4;05;091;Blanzy-lès-Fismes;106;1;107
32;Hauts-de-France;02;2;20;093;Blérancourt;1290;58;1348
32;Hauts-de-France;02;1;02;094;Blesmes;447;9;456
32;Hauts-de-France;02;3;01;095;Bohain-en-Vermandois;5664;90;5754
32;Hauts-de-France;02;2;11;096;Bois-lès-Pargny;201;3;204
32;Hauts-de-France;02;2;06;097;Boncourt;259;2;261
32;Hauts-de-France;02;1;04;098;Bonneil;375;14;389
32;Hauts-de-France;02;1;21;099;Bonnesvalyn;236;5;241
32;Hauts-de-France;02;3;01;100;Bony;137;1;138
32;Hauts-de-France;02;2;11;101;Bosmont-sur-Serre;193;5;198
32;Hauts-de-France;02;2;06;102;Bouconville-Vauclair;187;6;193
32;Hauts-de-France;02;5;07;103;Boué;1324;15;1339
32;Hauts-de-France;02;2;06;104;Bouffignereux;102;4;106
32;Hauts-de-France;02;1;02;105;Bouresches;202;5;207
32;Hauts-de-France;02;2;06;106;Bourg-et-Comin;822;11;833
32;Hauts-de-France;02;2;20;107;Bourguignon-sous-Coucy;103;4;107
32;Hauts-de-France;02;2;09;108;Bourguignon-sous-Montbavin;158;4;162
32;Hauts-de-France;02;5;19;109;La Bouteille;486;10;496
32;Hauts-de-France;02;4;05;110;Braine;2213;25;2238
32;Hauts-de-France;02;2;09;111;Brancourt-en-Laonnois;708;12;720
32;Hauts-de-France;02;3;01;112;Brancourt-le-Grand;565;13;578
32;Hauts-de-France;02;1;02;114;Brasles;1529;36;1565
32;Hauts-de-France;02;3;12;117;Bray-Saint-Christophe;67;0;67
32;Hauts-de-France;02;4;05;118;Braye;121;2;123
32;Hauts-de-France;02;2;06;115;Braye-en-Laonnois;203;6;209
32;Hauts-de-France;02;5;19;116;Braye-en-Thiérache;146;1;147
32;Hauts-de-France;02;1;02;119;Brécy;340;7;347
32;Hauts-de-France;02;4;05;120;Brenelle;195;4;199
32;Hauts-de-France;02;4;21;121;Breny;244;4;248
32;Hauts-de-France;02;2;18;122;Brie;53;2;55
32;Hauts-de-France;02;3;12;123;Brissay-Choigny;303;6;309
32;Hauts-de-France;02;3;12;124;Brissy-Hamégicourt;653;10;663
32;Hauts-de-France;02;1;21;125;Brumetz;213;3;216
32;Hauts-de-France;02;5;19;126;Brunehamel;456;5;461
32;Hauts-de-France;02;2;10;128;Bruyères-et-Montbérault;1532;36;1568
32;Hauts-de-France;02;1;05;127;Bruyères-sur-Fère;189;5;194
32;Hauts-de-France;02;4;05;129;Bruys;19;0;19
32;Hauts-de-France;02;5;08;130;Bucilly;193;7;200
32;Hauts-de-France;02;4;05;131;Bucy-le-Long;1880;42;1922
32;Hauts-de-France;02;2;09;132;Bucy-lès-Cerny;203;3;206
32;Hauts-de-France;02;2;06;133;Bucy-lès-Pierrepont;411;6;417
32;Hauts-de-France;02;5;08;134;Buire;869;17;886
32;Hauts-de-France;02;5;19;135;Buironfosse;1168;16;1184
32;Hauts-de-France;02;5;19;136;Burelles;128;4;132
32;Hauts-de-France;02;1;21;137;Bussiares;152;0;152
32;Hauts-de-France;02;4;21;138;Buzancy;190;2;192
32;Hauts-de-France;02;2;03;139;Caillouël-Crépigny;438;8;446
32;Hauts-de-France;02;2;20;140;Camelin;454;7;461
32;Hauts-de-France;02;5;19;141;La Capelle;1788;79;1867
32;Hauts-de-France;02;3;15;142;Castres;244;5;249
32;Hauts-de-France;02;3;01;143;Le Catelet;192;6;198
32;Hauts-de-France;02;3;13;144;Caulaincourt;145;3;148
32;Hauts-de-France;02;2;03;145;Caumont;546;18;564
32;Hauts-de-France;02;1;04;146;Celles-lès-Condé;87;1;88
32;Hauts-de-France;02;4;05;148;Celles-sur-Aisne;258;2;260
32;Hauts-de-France;02;3;12;149;Cerizy;67;0;67
32;Hauts-de-France;02;2;10;150;Cerny-en-Laonnois;64;0;64
32;Hauts-de-France;02;2;09;151;Cerny-lès-Bucy;115;3;118
32;Hauts-de-France;02;4;05;152;Cerseuil;89;1;90
32;Hauts-de-France;02;2;09;153;Cessières-Suzy;763;20;783
32;Hauts-de-France;02;4;21;154;Chacrise;361;7;368
32;Hauts-de-France;02;2;09;155;Chaillevois;174;5;179
32;Hauts-de-France;02;2;11;156;Chalandry;253;1;254
32;Hauts-de-France;02;2;09;157;Chambry;848;12;860
32;Hauts-de-France;02;2;10;158;Chamouille;284;2;286
32;Hauts-de-France;02;2;20;159;Champs;280;3;283
32;Hauts-de-France;02;5;19;160;Chaourse;539;11;550
32;Hauts-de-France;02;1;04;162;La Chapelle-sur-Chézy;278;5;283
32;Hauts-de-France;02;1;04;163;Charly-sur-Marne;2617;42;2659
32;Hauts-de-France;02;1;05;164;Le Charmel;316;7;323
32;Hauts-de-France;02;2;18;165;Charmes;1652;28;1680
32;Hauts-de-France;02;1;04;166;Chartèves;352;9;361
32;Hauts-de-France;02;4;05;167;Chassemy;881;14;895
32;Hauts-de-France;02;1;02;168;Château-Thierry;15107;379;15486
32;Hauts-de-France;02;2;11;169;Châtillon-lès-Sons;83;0;83
32;Hauts-de-France;02;3;12;170;Châtillon-sur-Oise;127;3;130
32;Hauts-de-France;02;2;06;171;Chaudardes;87;1;88
32;Hauts-de-France;02;4;21;172;Chaudun;249;10;259
32;Hauts-de-France;02;2;03;173;Chauny;11878;439;12317
32;Hauts-de-France;02;4;05;174;Chavignon;818;24;842
32;Hauts-de-France;02;4;16;175;Chavigny;150;4;154
32;Hauts-de-France;02;4;05;176;Chavonne;205;3;208
32;Hauts-de-France;02;2;10;177;Chérêt;142;2;144
32;Hauts-de-France;02;2;06;178;Chermizy-Ailles;106;2;108
32;Hauts-de-France;02;4;05;179;Chéry-Chartreuve;392;10;402
32;Hauts-de-France;02;2;11;180;Chéry-lès-Pouilly;710;8;718
32;Hauts-de-France;02;5;19;181;Chéry-lès-Rozoy;80;1;81
32;Hauts-de-France;02;5;11;182;Chevennes;125;3;128
32;Hauts-de-France;02;2;06;183;Chevregny;187;1;188
32;Hauts-de-France;02;3;12;184;Chevresis-Monceau;355;5;360
32;Hauts-de-France;02;1;21;185;Chézy-en-Orxois;404;15;419
32;Hauts-de-France;02;1;04;186;Chézy-sur-Marne;1353;45;1398
32;Hauts-de-France;02;1;02;187;Chierry;1109;15;1124
32;Hauts-de-France;02;5;07;188;Chigny;149;4;153
32;Hauts-de-France;02;2;06;189;Chivres-en-Laonnois;362;8;370
32;Hauts-de-France;02;4;05;190;Chivres-Val;530;12;542
32;Hauts-de-France;02;2;10;191;Chivy-lès-Étouvelles;510;5;515
32;Hauts-de-France;02;4;21;192;Chouy;370;7;377
32;Hauts-de-France;02;1;05;193;Cierges;66;1;67
32;Hauts-de-France;02;2;11;194;Cilly;193;8;201
32;Hauts-de-France;02;4;05;195;Ciry-Salsogne;930;9;939
32;Hauts-de-France;02;2;09;196;Clacy-et-Thierret;314;7;321
32;Hauts-de-France;02;5;19;197;Clairfontaine;552;86;638
32;Hauts-de-France;02;4;05;198;Clamecy;228;2;230
32;Hauts-de-France;02;3;12;199;Clastres;635;9;644
32;Hauts-de-France;02;5;19;200;Clermont-les-Fermes;120;1;121
32;Hauts-de-France;02;1;02;203;Coincy;1310;19;1329
32;Hauts-de-France;02;5;08;204;Coingt;68;1;69
32;Hauts-de-France;02;2;10;205;Colligis-Crandelain;248;3;251
32;Hauts-de-France;02;5;11;206;Colonfay;78;3;81
32;Hauts-de-France;02;2;03;207;Commenchon;214;3;217
32;Hauts-de-France;02;2;06;208;Concevreux;278;5;283
32;Hauts-de-France;02;1;04;209;Condé-en-Brie;685;10;695
32;Hauts-de-France;02;4;05;210;Condé-sur-Aisne;360;6;366
32;Hauts-de-France;02;2;06;211;Condé-sur-Suippe;285;3;288
32;Hauts-de-France;02;2;03;212;Condren;707;11;718
32;Hauts-de-France;02;1;04;213;Connigis;332;2;334
32;Hauts-de-France;02;3;15;214;Contescourt;61;1;62
32;Hauts-de-France;02;2;06;215;Corbeny;801;6;807
32;Hauts-de-France;02;4;21;216;Corcy;306;4;310
32;Hauts-de-France;02;2;20;219;Coucy-la-Ville;219;70;289
32;Hauts-de-France;02;2;20;217;Coucy-le-Château-Auffrique;1014;17;1031
32;Hauts-de-France;02;2;06;218;Coucy-lès-Eppes;624;12;636
32;Hauts-de-France;02;1;05;220;Coulonges-Cohan;436;15;451
32;Hauts-de-France;02;1;04;221;Coupru;149;5;154
32;Hauts-de-France;02;2;18;222;Courbes;31;0;31
32;Hauts-de-France;02;1;04;223;Courboin;300;12;312
32;Hauts-de-France;02;4;05;224;Courcelles-sur-Vesle;350;4;354
32;Hauts-de-France;02;1;21;225;Courchamps;88;2;90
32;Hauts-de-France;02;4;17;226;Courmelles;1826;30;1856
32;Hauts-de-France;02;1;05;227;Courmont;133;1;134
32;Hauts-de-France;02;1;04;228;Courtemont-Varennes;333;6;339
32;Hauts-de-France;02;2;06;229;Courtrizy-et-Fussigny;66;1;67
32;Hauts-de-France;02;4;05;230;Couvrelles;188;11;199
32;Hauts-de-France;02;2;11;231;Couvron-et-Aumencourt;938;9;947
32;Hauts-de-France;02;4;21;232;Coyolles;344;21;365
32;Hauts-de-France;02;4;21;233;Cramaille;143;8;151
32;Hauts-de-France;02;2;06;234;Craonne;82;0;82
32;Hauts-de-France;02;2;06;235;Craonnelle;117;3;120
32;Hauts-de-France;02;2;20;236;Crécy-au-Mont;346;3;349
32;Hauts-de-France;02;2;11;237;Crécy-sur-Serre;1498;17;1515
32;Hauts-de-France;02;2;09;238;Crépy;1837;31;1868
32;Hauts-de-France;02;1;04;239;Crézancy;1230;84;1314
32;Hauts-de-France;02;3;01;240;Croix-Fonsomme;257;3;260
32;Hauts-de-France;02;1;21;241;La Croix-sur-Ourcq;105;2;107
32;Hauts-de-France;02;1;04;242;Crouttes-sur-Marne;647;11;658
32;Hauts-de-France;02;4;16;243;Crouy;2905;47;2952
32;Hauts-de-France;02;5;07;244;Crupilly;64;3;67
32;Hauts-de-France;02;4;16;245;Cuffies;1789;35;1824
32;Hauts-de-France;02;3;12;246;Cugny;606;5;611
32;Hauts-de-France;02;2;11;248;Cuirieux;157;3;160
32;Hauts-de-France;02;4;21;249;Cuiry-Housse;102;0;102
32;Hauts-de-France;02;2;06;250;Cuiry-lès-Chaudardes;76;4;80
32;Hauts-de-France;02;5;19;251;Cuiry-lès-Iviers;28;1;29
32;Hauts-de-France;02;2;06;252;Cuissy-et-Geny;71;2;73
32;Hauts-de-France;02;4;16;253;Cuisy-en-Almont;355;3;358
32;Hauts-de-France;02;4;20;254;Cutry;128;5;133
32;Hauts-de-France;02;4;05;255;Cys-la-Commune;143;2;145
32;Hauts-de-France;02;4;20;201;Cœuvres-et-Valsery;438;6;444
32;Hauts-de-France;02;5;19;256;Dagny-Lambercy;125;3;128
32;Hauts-de-France;02;3;12;257;Dallon;436;13;449
32;Hauts-de-France;02;4;21;258;Dammard;379;13;392
32;Hauts-de-France;02;4;21;259;Dampleux;398;15;413
32;Hauts-de-France;02;2;18;260;Danizy;650;11;661
32;Hauts-de-France;02;2;11;261;Dercy;391;9;400
32;Hauts-de-France;02;2;18;262;Deuillet;216;3;219
32;Hauts-de-France;02;4;05;263;Dhuizel;114;0;114
32;Hauts-de-France;02;1;04;458;Dhuys et Morin-en-Brie;818;16;834
32;Hauts-de-France;02;5;19;264;Dizy-le-Gros;747;15;762
32;Hauts-de-France;02;5;19;265;Dohis;99;2;101
32;Hauts-de-France;02;5;19;266;Dolignon;49;2;51
32;Hauts-de-France;02;4;20;267;Dommiers;289;10;299
32;Hauts-de-France;02;1;04;268;Domptin;654;14;668
32;Hauts-de-France;02;5;07;269;Dorengt;154;6;160
32;Hauts-de-France;02;3;13;270;Douchy;162;4;166
32;Hauts-de-France;02;1;05;271;Dravegny;132;2;134
32;Hauts-de-France;02;4;21;272;Droizy;75;2;77
32;Hauts-de-France;02;3;12;273;Dury;222;5;227
32;Hauts-de-France;02;2;06;274;Ébouleau;200;6;206
32;Hauts-de-France;02;5;08;275;Effry;324;5;329
32;Hauts-de-France;02;5;19;276;Englancourt;122;5;127
32;Hauts-de-France;02;4;20;277;Épagny;340;6;346
32;Hauts-de-France;02;5;08;278;Éparcy;30;6;36
32;Hauts-de-France;02;1;02;279;Épaux-Bézu;556;19;575
32;Hauts-de-France;02;1;02;280;Épieds;392;12;404
32;Hauts-de-France;02;1;04;281;L' Épine-aux-Bois;261;11;272
32;Hauts-de-France;02;2;10;282;Eppes;417;14;431
32;Hauts-de-France;02;2;11;283;Erlon;284;9;293
32;Hauts-de-France;02;5;19;284;Erloy;97;1;98
32;Hauts-de-France;02;5;07;286;Esquéhéries;858;11;869
32;Hauts-de-France;02;3;12;287;Essigny-le-Grand;1022;24;1046
32;Hauts-de-France;02;3;14;288;Essigny-le-Petit;344;5;349
32;Hauts-de-France;02;1;04;289;Essises;417;11;428
32;Hauts-de-France;02;1;04;290;Essômes-sur-Marne;2776;75;2851
32;Hauts-de-France;02;3;01;291;Estrées;412;8;420
32;Hauts-de-France;02;1;02;292;Étampes-sur-Marne;1253;27;1280
32;Hauts-de-France;02;3;01;293;Étaves-et-Bocquiaux;557;10;567
32;Hauts-de-France;02;2;10;294;Étouvelles;213;8;221
32;Hauts-de-France;02;5;19;295;Étréaupont;859;8;867
32;Hauts-de-France;02;3;13;296;Étreillers;1208;21;1229
32;Hauts-de-France;02;1;02;297;Étrépilly;118;1;119
32;Hauts-de-France;02;5;07;298;Étreux;1459;9;1468
32;Hauts-de-France;02;2;06;299;Évergnicourt;570;6;576
32;Hauts-de-France;02;4;21;302;Faverolles;317;12;329
32;Hauts-de-France;02;3;13;303;Fayet;654;17;671
32;Hauts-de-France;02;2;18;304;La Fère;2859;140;2999
32;Hauts-de-France;02;1;05;305;Fère-en-Tardenois;3053;55;3108
32;Hauts-de-France;02;3;12;306;La Ferté-Chevresis;542;8;550
32;Hauts-de-France;02;4;21;307;La Ferté-Milon;2085;158;2243
32;Hauts-de-France;02;5;07;308;Fesmy-le-Sart;486;8;494
32;Hauts-de-France;02;2;10;309;Festieux;680;5;685
32;Hauts-de-France;02;3;14;310;Fieulaine;256;7;263
32;Hauts-de-France;02;4;05;311;Filain;129;2;131
32;Hauts-de-France;02;5;19;312;La Flamengrie;1118;10;1128
32;Hauts-de-France;02;5;07;313;Flavigny-le-Grand-et-Beaurain;468;5;473
32;Hauts-de-France;02;3;12;315;Flavy-le-Martel;1687;29;1716
32;Hauts-de-France;02;4;21;316;Fleury;136;5;141
32;Hauts-de-France;02;3;13;317;Fluquières;220;4;224
32;Hauts-de-France;02;2;20;318;Folembray;1386;18;1404
32;Hauts-de-France;02;3;14;319;Fonsomme;469;7;476
32;Hauts-de-France;02;3;12;320;Fontaine-lès-Clercs;250;4;254
32;Hauts-de-France;02;5;19;321;Fontaine-lès-Vervins;913;182;1095
32;Hauts-de-France;02;3;14;322;Fontaine-Notre-Dame;389;3;392
32;Hauts-de-France;02;3;01;323;Fontaine-Uterte;127;4;131
32;Hauts-de-France;02;5;19;324;Fontenelle;277;3;280
32;Hauts-de-France;02;4;20;326;Fontenoy;489;9;498
32;Hauts-de-France;02;3;13;327;Foreste;165;1;166
32;Hauts-de-France;02;1;02;328;Fossoy;524;6;530
32;Hauts-de-France;02;2;18;329;Fourdrain;419;9;428
32;Hauts-de-France;02;3;13;330;Francilly-Selency;474;7;481
32;Hauts-de-France;02;5;11;331;Franqueville;113;3;116
32;Hauts-de-France;02;1;05;332;Fresnes-en-Tardenois;268;4;272
32;Hauts-de-France;02;2;20;333;Fresnes-sous-Coucy;161;0;161
32;Hauts-de-France;02;3;01;334;Fresnoy-le-Grand;2945;69;3014
32;Hauts-de-France;02;2;18;335;Fressancourt;192;5;197
32;Hauts-de-France;02;2;03;336;Frières-Faillouël;998;15;1013
32;Hauts-de-France;02;5;19;337;Froidestrées;176;4;180
32;Hauts-de-France;02;2;11;338;Froidmont-Cohartille;261;8;269
32;Hauts-de-France;02;1;21;339;Gandelu;687;9;696
32;Hauts-de-France;02;3;15;340;Gauchy;5276;84;5360
32;Hauts-de-France;02;5;19;341;Gercy;277;1;278
32;Hauts-de-France;02;5;19;342;Gergny;135;2;137
32;Hauts-de-France;02;3;13;343;Germaine;81;0;81
32;Hauts-de-France;02;3;12;345;Gibercourt;42;1;43
32;Hauts-de-France;02;2;06;346;Gizy;672;12;684
32;Hauts-de-France;02;1;02;347;Gland;450;6;456
32;Hauts-de-France;02;2;06;349;Goudelancourt-lès-Berrieux;57;0;57
32;Hauts-de-France;02;2;06;350;Goudelancourt-lès-Pierrepont;135;2;137
32;Hauts-de-France;02;1;05;351;Goussancourt;116;6;122
32;Hauts-de-France;02;3;01;352;Gouy;560;10;570
32;Hauts-de-France;02;4;21;665;Grand-Rozoy;304;5;309
32;Hauts-de-France;02;5;07;783;Grand-Verly;138;0;138
32;Hauts-de-France;02;2;11;353;Grandlup-et-Fay;301;11;312
32;Hauts-de-France;02;5;19;354;Grandrieux;83;2;85
32;Hauts-de-France;02;3;13;355;Gricourt;980;27;1007
32;Hauts-de-France;02;1;02;356;Grisolles;252;2;254
32;Hauts-de-France;02;5;19;357;Gronard;73;2;75
32;Hauts-de-France;02;5;07;358;Grougis;358;5;363
32;Hauts-de-France;02;3;15;359;Grugies;1355;27;1382
32;Hauts-de-France;02;5;07;361;Guise;4824;105;4929
32;Hauts-de-France;02;2;03;362;Guivry;243;11;254
32;Hauts-de-France;02;2;20;363;Guny;423;4;427
32;Hauts-de-France;02;2;06;364;Guyencourt;253;5;258
32;Hauts-de-France;02;5;07;366;Hannapes;318;6;324
32;Hauts-de-France;02;3;12;367;Happencourt;133;4;137
32;Hauts-de-France;02;4;21;368;Haramont;580;8;588
32;Hauts-de-France;02;5;19;369;Harcigny;242;2;244
32;Hauts-de-France;02;3;01;370;Hargicourt;598;4;602
32;Hauts-de-France;02;3;15;371;Harly;1610;36;1646
32;Hauts-de-France;02;4;21;372;Hartennes-et-Taux;371;10;381
32;Hauts-de-France;02;5;19;373;Hary;208;5;213
32;Hauts-de-France;02;1;21;375;Hautevesnes;167;3;170
32;Hauts-de-France;02;5;07;376;Hauteville;166;5;171
32;Hauts-de-France;02;5;19;377;Haution;144;7;151
32;Hauts-de-France;02;5;08;378;La Hérie;143;6;149
32;Hauts-de-France;02;5;11;379;Le Hérie-la-Viéville;230;121;351
32;Hauts-de-France;02;3;12;380;Hinacourt;25;1;26
32;Hauts-de-France;02;5;08;381;Hirson;8813;188;9001
32;Hauts-de-France;02;3;13;382;Holnon;1387;40;1427
32;Hauts-de-France;02;3;15;383;Homblières;1464;46;1510
32;Hauts-de-France;02;5;19;384;Houry;53;2;55
32;Hauts-de-France;02;5;11;385;Housset;149;7;156
32;Hauts-de-France;02;5;07;386;Iron;239;2;241
32;Hauts-de-France;02;3;12;387;Itancourt;1031;35;1066
32;Hauts-de-France;02;5;08;388;Iviers;232;2;234
32;Hauts-de-France;02;1;04;389;Jaulgonne;645;16;661
32;Hauts-de-France;02;3;13;390;Jeancourt;271;2;273
32;Hauts-de-France;02;5;08;391;Jeantes;205;0;205
32;Hauts-de-France;02;3;01;392;Joncourt;299;3;302
32;Hauts-de-France;02;4;05;393;Jouaignes;144;5;149
32;Hauts-de-France;02;2;20;395;Jumencourt;146;6;152
32;Hauts-de-France;02;2;06;396;Jumigny;64;1;65
32;Hauts-de-France;02;3;12;397;Jussy;1260;18;1278
32;Hauts-de-France;02;4;16;398;Juvigny;277;4;281
32;Hauts-de-France;02;2;06;399;Juvincourt-et-Damary;599;5;604
32;Hauts-de-France;02;4;05;400;Laffaux;149;4;153
32;Hauts-de-France;02;5;19;401;Laigny;196;1;197
32;Hauts-de-France;02;3;13;402;Lanchy;37;1;38
32;Hauts-de-France;02;5;11;403;Landifay-et-Bertaignemont;269;7;276
32;Hauts-de-France;02;5;19;404;Landouzy-la-Cour;187;0;187
32;Hauts-de-France;02;5;08;405;Landouzy-la-Ville;541;5;546
32;Hauts-de-France;02;2;20;406;Landricourt;137;5;142
32;Hauts-de-France;02;2;09;407;Laniscourt;182;5;187
32;Hauts-de-France;02;2;97;408;Laon;24876;673;25549
32;Hauts-de-France;02;2;06;409;Lappion;268;4;272
32;Hauts-de-France;02;4;21;410;Largny-sur-Automne;244;11;255
32;Hauts-de-France;02;1;21;411;Latilly;208;5;213
32;Hauts-de-France;02;4;21;412;Launoy;99;1;100
32;Hauts-de-France;02;2;10;413;Laval-en-Laonnois;250;4;254
32;Hauts-de-France;02;5;07;414;Lavaqueresse;202;5;207
32;Hauts-de-France;02;4;20;415;Laversine;159;4;163
32;Hauts-de-France;02;3;01;374;Lehaucourt;877;8;885
32;Hauts-de-France;02;5;11;416;Lemé;430;11;441
32;Hauts-de-France;02;3;01;417;Lempire;100;0;100
32;Hauts-de-France;02;5;19;418;Lerzy;213;4;217
32;Hauts-de-France;02;5;07;419;Leschelle;270;9;279
32;Hauts-de-France;02;3;14;420;Lesdins;832;12;844
32;Hauts-de-France;02;4;05;421;Lesges;102;1;103
32;Hauts-de-France;02;5;07;422;Lesquielles-Saint-Germain;810;7;817
32;Hauts-de-France;02;2;20;423;Leuilly-sous-Coucy;420;8;428
32;Hauts-de-France;02;4;16;424;Leury;106;0;106
32;Hauts-de-France;02;5;08;425;Leuze;173;3;176
32;Hauts-de-France;02;3;01;426;Levergies;545;10;555
32;Hauts-de-France;02;4;05;427;Lhuys;141;1;142
32;Hauts-de-France;02;1;21;428;Licy-Clignon;74;2;76
32;Hauts-de-France;02;2;10;429;Lierval;118;1;119
32;Hauts-de-France;02;2;06;430;Liesse-Notre-Dame;1298;106;1404
32;Hauts-de-France;02;2;18;431;Liez;391;10;401
32;Hauts-de-France;02;4;05;432;Limé;187;3;190
32;Hauts-de-France;02;5;19;433;Lislet;225;10;235
32;Hauts-de-France;02;5;08;435;Logny-lès-Aubenton;74;0;74
32;Hauts-de-France;02;4;21;438;Longpont;262;9;271
32;Hauts-de-France;02;2;06;440;Lor;142;0;142
32;Hauts-de-France;02;4;21;441;Louâtre;199;3;202
32;Hauts-de-France;02;1;05;442;Loupeigne;91;1;92
32;Hauts-de-France;02;1;04;443;Lucy-le-Bocage;195;7;202
32;Hauts-de-France;02;5;11;444;Lugny;114;0;114
32;Hauts-de-France;02;5;19;445;Luzoir;285;6;291
32;Hauts-de-France;02;3;12;446;Ly-Fontaine;121;1;122
32;Hauts-de-France;02;4;21;447;Maast-et-Violaine;147;5;152
32;Hauts-de-France;02;2;06;448;Mâchecourt;122;3;125
32;Hauts-de-France;02;4;21;449;Macogny;73;3;76
32;Hauts-de-France;02;5;07;450;Macquigny;376;2;378
32;Hauts-de-France;02;3;01;451;Magny-la-Fosse;125;1;126
32;Hauts-de-France;02;3;13;452;Maissemy;239;7;246
32;Hauts-de-France;02;2;06;453;Maizy;411;3;414
32;Hauts-de-France;02;2;06;454;La Malmaison;410;3;413
32;Hauts-de-France;02;5;07;455;Malzy;203;1;204
32;Hauts-de-France;02;2;20;456;Manicamp;307;4;311
32;Hauts-de-France;02;2;06;457;Marchais;435;3;438
32;Hauts-de-France;02;3;14;459;Marcy;173;8;181
32;Hauts-de-France;02;2;11;460;Marcy-sous-Marle;192;3;195
32;Hauts-de-France;02;2;03;461;Marest-Dampcourt;369;6;375
32;Hauts-de-France;02;1;05;462;Mareuil-en-Dôle;240;2;242
32;Hauts-de-France;02;5;11;463;Marfontaine;86;2;88
32;Hauts-de-France;02;4;05;464;Margival;370;2;372
32;Hauts-de-France;02;1;04;465;Marigny-en-Orxois;485;5;490
32;Hauts-de-France;02;4;21;467;Marizy-Saint-Mard;50;1;51
32;Hauts-de-France;02;4;21;466;Marizy-Sainte-Geneviève;130;0;130
32;Hauts-de-France;02;2;11;468;Marle;2268;37;2305
32;Hauts-de-France;02;5;07;469;Marly-Gomont;475;15;490
32;Hauts-de-France;02;5;08;470;Martigny;434;12;446
32;Hauts-de-France;02;2;10;471;Martigny-Courpierre;124;2;126
32;Hauts-de-France;02;2;06;472;Mauregny-en-Haye;420;4;424
32;Hauts-de-France;02;2;18;473;Mayot;211;1;212
32;Hauts-de-France;02;2;18;474;Mennessis;408;4;412
32;Hauts-de-France;02;5;07;476;Mennevret;651;12;663
32;Hauts-de-France;02;4;17;477;Mercin-et-Vaux;962;21;983
32;Hauts-de-France;02;2;09;478;Merlieux-et-Fouquerolles;259;8;267
32;Hauts-de-France;02;2;11;480;Mesbrecourt-Richecourt;305;2;307
32;Hauts-de-France;02;3;15;481;Mesnil-Saint-Laurent;476;16;492
32;Hauts-de-France;02;2;06;482;Meurival;52;0;52
32;Hauts-de-France;02;3;12;483;Mézières-sur-Oise;516;8;524
32;Hauts-de-France;02;1;04;484;Mézy-Moulins;517;8;525
32;Hauts-de-France;02;4;17;485;Missy-aux-Bois;97;3;100
32;Hauts-de-France;02;2;06;486;Missy-lès-Pierrepont;108;1;109
32;Hauts-de-France;02;4;05;487;Missy-sur-Aisne;640;18;658
32;Hauts-de-France;02;5;07;488;Molain;152;1;153
32;Hauts-de-France;02;2;09;489;Molinchart;329;8;337
32;Hauts-de-France;02;4;05;490;Monampteuil;131;7;138
32;Hauts-de-France;02;5;11;491;Monceau-le-Neuf-et-Faucouzy;319;9;328
32;Hauts-de-France;02;2;11;493;Monceau-le-Waast;220;6;226
32;Hauts-de-France;02;2;18;492;Monceau-lès-Leups;473;7;480
32;Hauts-de-France;02;5;07;494;Monceau-sur-Oise;128;2;130
32;Hauts-de-France;02;5;08;495;Mondrepuis;1040;15;1055
32;Hauts-de-France;02;4;21;496;Monnes;104;0;104
32;Hauts-de-France;02;2;09;497;Mons-en-Laonnois;1152;28;1180
32;Hauts-de-France;02;3;12;503;Mont-d'Origny;847;4;851
32;Hauts-de-France;02;4;05;520;Mont-Notre-Dame;736;7;743
32;Hauts-de-France;02;5;08;522;Mont-Saint-Jean;75;2;77
32;Hauts-de-France;02;4;05;523;Mont-Saint-Martin;74;2;76
32;Hauts-de-France;02;1;02;524;Mont-Saint-Père;700;14;714
32;Hauts-de-France;02;2;06;498;Montaigu;761;10;771
32;Hauts-de-France;02;2;09;499;Montbavin;44;2;46
32;Hauts-de-France;02;3;01;500;Montbrehain;810;19;829
32;Hauts-de-France;02;2;10;501;Montchâlons;84;2;86
32;Hauts-de-France;02;5;19;502;Montcornet;1338;9;1347
32;Hauts-de-France;02;3;12;504;Montescourt-Lizerolles;1648;31;1679
32;Hauts-de-France;02;1;04;505;Montfaucon;203;5;208
32;Hauts-de-France;02;4;21;506;Montgobert;193;6;199
32;Hauts-de-France;02;4;21;507;Montgru-Saint-Hilaire;32;1;33
32;Hauts-de-France;02;2;10;508;Monthenault;152;6;158
32;Hauts-de-France;02;1;21;509;Monthiers;161;4;165
32;Hauts-de-France;02;1;04;510;Monthurel;151;2;153
32;Hauts-de-France;02;3;01;511;Montigny-en-Arrouaise;291;4;295
32;Hauts-de-France;02;1;21;512;Montigny-l'Allier;274;5;279
32;Hauts-de-France;02;2;11;513;Montigny-le-Franc;142;2;144
32;Hauts-de-France;02;4;20;514;Montigny-Lengrain;702;16;718
32;Hauts-de-France;02;1;04;515;Montigny-lès-Condé;59;6;65
32;Hauts-de-France;02;2;11;516;Montigny-sous-Marle;63;1;64
32;Hauts-de-France;02;2;11;517;Montigny-sur-Crécy;315;5;320
32;Hauts-de-France;02;1;04;518;Montlevon;301;3;304
32;Hauts-de-France;02;5;19;519;Montloué;187;4;191
32;Hauts-de-France;02;1;04;521;Montreuil-aux-Lions;1369;14;1383
32;Hauts-de-France;02;3;14;525;Morcourt;574;14;588
32;Hauts-de-France;02;5;19;526;Morgny-en-Thiérache;89;3;92
32;Hauts-de-France;02;4;20;527;Morsain;444;9;453
32;Hauts-de-France;02;4;20;528;Mortefontaine;233;5;238
32;Hauts-de-France;02;2;11;529;Mortiers;187;1;188
32;Hauts-de-France;02;2;06;530;Moulins;76;1;77
32;Hauts-de-France;02;2;06;531;Moussy-Verneuil;123;1;124
32;Hauts-de-France;02;3;12;532;Moÿ-de-l'Aisne;975;18;993
32;Hauts-de-France;02;4;21;533;Muret-et-Crouttes;119;8;127
32;Hauts-de-France;02;2;06;534;Muscourt;52;1;53
32;Hauts-de-France;02;5;19;535;Nampcelles-la-Cour;118;4;122
32;Hauts-de-France;02;4;21;536;Nampteuil-sous-Muret;103;1;104
32;Hauts-de-France;02;4;05;537;Nanteuil-la-Fosse;193;1;194
32;Hauts-de-France;02;1;05;538;Nanteuil-Notre-Dame;62;0;62
32;Hauts-de-France;02;3;01;539;Nauroy;703;9;712
32;Hauts-de-France;02;1;02;540;Nesles-la-Montagne;1230;35;1265
32;Hauts-de-France;02;2;06;541;Neufchâtel-sur-Aisne;423;7;430
32;Hauts-de-France;02;2;03;542;Neuflieux;91;2;93
32;Hauts-de-France;02;1;21;543;Neuilly-Saint-Front;2078;34;2112
32;Hauts-de-France;02;5;08;544;Neuve-Maison;611;14;625
32;Hauts-de-France;02;2;11;545;La Neuville-Bosmont;187;2;189
32;Hauts-de-France;02;2;03;546;La Neuville-en-Beine;197;3;200
32;Hauts-de-France;02;5;11;547;La Neuville-Housset;67;2;69
32;Hauts-de-France;02;5;07;548;La Neuville-lès-Dorengt;380;6;386
32;Hauts-de-France;02;3;15;549;Neuville-Saint-Amand;842;20;862
32;Hauts-de-France;02;2;06;550;Neuville-sur-Ailette;105;2;107
32;Hauts-de-France;02;4;05;551;Neuville-sur-Margival;117;0;117
32;Hauts-de-France;02;3;12;552;Neuvillette;186;9;195
32;Hauts-de-France;02;2;06;553;Nizy-le-Comte;244;4;248
32;Hauts-de-France;02;1;04;555;Nogent-l'Artaud;2167;47;2214
32;Hauts-de-France;02;1;04;554;Nogentel;1012;23;1035
32;Hauts-de-France;02;5;19;556;Noircourt;81;0;81
32;Hauts-de-France;02;4;21;557;Noroy-sur-Ourcq;130;0;130
32;Hauts-de-France;02;5;07;558;Le Nouvion-en-Thiérache;2602;28;2630
32;Hauts-de-France;02;2;11;559;Nouvion-et-Catillon;474;4;478
32;Hauts-de-France;02;2;11;560;Nouvion-le-Comte;249;9;258
32;Hauts-de-France;02;2;10;561;Nouvion-le-Vineux;165;3;168
32;Hauts-de-France;02;4;20;562;Nouvron-Vingré;225;2;227
32;Hauts-de-France;02;5;07;563;Noyales;167;3;170
32;Hauts-de-France;02;4;17;564;Noyant-et-Aconin;502;5;507
32;Hauts-de-France;02;2;03;566;Ognes;1113;22;1135
32;Hauts-de-France;02;5;08;567;Ohis;303;8;311
32;Hauts-de-France;02;4;21;568;Oigny-en-Valois;155;4;159
32;Hauts-de-France;02;5;07;569;Oisy;466;3;469
32;Hauts-de-France;02;3;12;570;Ollezy;184;0;184
32;Hauts-de-France;02;3;14;571;Omissy;714;81;795
32;Hauts-de-France;02;2;06;572;Orainville;507;9;516
32;Hauts-de-France;02;2;10;573;Orgeval;66;2;68
32;Hauts-de-France;02;5;08;574;Origny-en-Thiérache;1453;28;1481
32;Hauts-de-France;02;3;12;575;Origny-Sainte-Benoite;1685;16;1701
32;Hauts-de-France;02;4;16;576;Osly-Courtil;326;8;334
32;Hauts-de-France;02;4;05;577;Ostel;80;1;81
32;Hauts-de-France;02;2;06;578;Oulches-la-Vallée-Foulon;85;1;86
32;Hauts-de-France;02;4;21;579;Oulchy-la-Ville;122;9;131
32;Hauts-de-France;02;4;21;580;Oulchy-le-Château;823;10;833
32;Hauts-de-France;02;4;05;581;Paars;314;1;315
32;Hauts-de-France;02;2;06;582;Paissy;75;2;77
32;Hauts-de-France;02;2;06;583;Pancy-Courtecon;56;2;58
32;Hauts-de-France;02;5;19;584;Papleux;128;0;128
32;Hauts-de-France;02;4;21;585;Parcy-et-Tigny;256;7;263
32;Hauts-de-France;02;5;19;586;Parfondeval;142;6;148
32;Hauts-de-France;02;2;10;587;Parfondru;352;7;359
32;Hauts-de-France;02;2;06;588;Pargnan;74;3;77
32;Hauts-de-France;02;4;05;589;Pargny-Filain;259;0;259
32;Hauts-de-France;02;1;04;590;Pargny-la-Dhuys;170;4;174
32;Hauts-de-France;02;2;11;591;Pargny-les-Bois;131;1;132
32;Hauts-de-France;02;3;12;592;Parpeville;189;6;195
32;Hauts-de-France;02;4;16;593;Pasly;1019;20;1039
32;Hauts-de-France;02;4;21;594;Passy-en-Valois;148;7;155
32;Hauts-de-France;02;1;04;595;Passy-sur-Marne;126;2;128
32;Hauts-de-France;02;1;04;596;Pavant;781;15;796
32;Hauts-de-France;02;4;20;598;Pernant;650;22;672
32;Hauts-de-France;02;5;07;784;Petit-Verly;149;0;149
32;Hauts-de-France;02;2;03;599;Pierremande;279;2;281
32;Hauts-de-France;02;2;11;600;Pierrepont;370;6;376
32;Hauts-de-France;02;2;06;601;Pignicourt;197;2;199
32;Hauts-de-France;02;2;09;602;Pinon;1765;15;1780
32;Hauts-de-France;02;3;12;604;Pithon;83;1;84
32;Hauts-de-France;02;3;12;605;Pleine-Selve;172;4;176
32;Hauts-de-France;02;4;21;606;Le Plessier-Huleu;71;3;74
32;Hauts-de-France;02;4;17;607;Ploisy;77;2;79
32;Hauts-de-France;02;5;19;608;Plomion;462;2;464
32;Hauts-de-France;02;2;06;609;Ployart-et-Vaurseine;21;0;21
32;Hauts-de-France;02;4;16;610;Pommiers;688;11;699
32;Hauts-de-France;02;4;05;612;Pont-Arcy;127;1;128
32;Hauts-de-France;02;2;20;616;Pont-Saint-Mard;205;3;208
32;Hauts-de-France;02;2;06;613;Pontavert;610;9;619
32;Hauts-de-France;02;3;13;614;Pontru;251;10;261
32;Hauts-de-France;02;3;13;615;Pontruet;344;5;349
32;Hauts-de-France;02;2;11;617;Pouilly-sur-Serre;502;3;505
32;Hauts-de-France;02;3;01;618;Prémont;700;13;713
32;Hauts-de-France;02;2;09;619;Prémontré;661;0;661
32;Hauts-de-France;02;4;05;620;Presles-et-Boves;360;9;369
32;Hauts-de-France;02;2;10;621;Presles-et-Thierny;385;15;400
32;Hauts-de-France;02;1;21;622;Priez;52;0;52
32;Hauts-de-France;02;5;19;623;Prisces;103;3;106
32;Hauts-de-France;02;5;07;624;Proisy;274;65;339
32;Hauts-de-France;02;5;07;625;Proix;144;2;146
32;Hauts-de-France;02;2;06;626;Prouvais;319;7;326
32;Hauts-de-France;02;2;06;627;Proviseux-et-Plesnoy;120;3;123
32;Hauts-de-France;02;4;21;628;Puiseux-en-Retz;214;6;220
32;Hauts-de-France;02;5;11;629;Puisieux-et-Clanlieu;289;9;298
32;Hauts-de-France;02;2;20;631;Quierzy;420;6;426
32;Hauts-de-France;02;2;20;632;Quincy-Basse;60;1;61
32;Hauts-de-France;02;4;05;633;Quincy-sous-le-Mont;61;0;61
32;Hauts-de-France;02;5;19;634;Raillimont;79;4;83
32;Hauts-de-France;02;3;01;635;Ramicourt;150;5;155
32;Hauts-de-France;02;3;12;636;Regny;201;5;206
32;Hauts-de-France;02;3;14;637;Remaucourt;299;10;309
32;Hauts-de-France;02;2;11;638;Remies;235;1;236
32;Hauts-de-France;02;3;12;639;Remigny;351;8;359
32;Hauts-de-France;02;3;12;640;Renansart;164;4;168
32;Hauts-de-France;02;5;19;641;Renneval;113;3;116
32;Hauts-de-France;02;5;19;642;Résigny;186;1;187
32;Hauts-de-France;02;4;20;643;Ressons-le-Long;772;8;780
32;Hauts-de-France;02;4;21;644;Retheuil;359;13;372
32;Hauts-de-France;02;1;04;645;Reuilly-Sauvigny;201;9;210
32;Hauts-de-France;02;5;07;647;Ribeauville;63;0;63
32;Hauts-de-France;02;3;12;648;Ribemont;1982;27;2009
32;Hauts-de-France;02;1;02;649;Rocourt-Saint-Martin;289;4;293
32;Hauts-de-France;02;5;19;650;Rocquigny;361;5;366
32;Hauts-de-France;02;2;18;651;Rogécourt;105;1;106
32;Hauts-de-France;02;5;11;652;Rogny;112;1;113
32;Hauts-de-France;02;1;04;653;Romeny-sur-Marne;504;13;517
32;Hauts-de-France;02;5;07;654;Romery;82;1;83
32;Hauts-de-France;02;1;05;655;Ronchères;112;3;115
32;Hauts-de-France;02;2;06;656;Roucy;394;11;405
32;Hauts-de-France;02;5;11;657;Rougeries;243;4;247
32;Hauts-de-France;02;3;13;658;Roupy;230;7;237
32;Hauts-de-France;02;3;14;659;Rouvroy;510;12;522
32;Hauts-de-France;02;5;19;660;Rouvroy-sur-Serre;39;2;41
32;Hauts-de-France;02;2;09;661;Royaucourt-et-Chailvet;252;3;255
32;Hauts-de-France;02;1;21;662;Rozet-Saint-Albin;309;11;320
32;Hauts-de-France;02;4;21;663;Rozières-sur-Crise;227;5;232
32;Hauts-de-France;02;1;04;664;Rozoy-Bellevalle;116;3;119
32;Hauts-de-France;02;5;19;666;Rozoy-sur-Serre;1007;15;1022
32;Hauts-de-France;02;4;20;667;Saconin-et-Breuil;228;7;235
32;Hauts-de-France;02;5;11;668;Sains-Richaumont;1043;20;1063
32;Hauts-de-France;02;5;19;670;Saint-Algis;156;0;156
32;Hauts-de-France;02;2;20;671;Saint-Aubin;291;5;296
32;Hauts-de-France;02;4;20;672;Saint-Bandry;267;4;271
32;Hauts-de-France;02;4;20;673;Saint-Christophe-à-Berry;447;5;452
32;Hauts-de-France;02;5;08;674;Saint-Clément;50;0;50
32;Hauts-de-France;02;2;06;676;Saint-Erme-Outre-et-Ramecourt;1726;37;1763
32;Hauts-de-France;02;1;04;677;Saint-Eugène;244;2;246
32;Hauts-de-France;02;1;21;679;Saint-Gengoulph;148;4;152
32;Hauts-de-France;02;2;18;680;Saint-Gobain;2282;38;2320
32;Hauts-de-France;02;5;11;681;Saint-Gobert;267;5;272
32;Hauts-de-France;02;4;05;682;Saint-Mard;112;3;115
32;Hauts-de-France;02;5;07;683;Saint-Martin-Rivière;115;3;118
32;Hauts-de-France;02;5;08;684;Saint-Michel;3417;58;3475
32;Hauts-de-France;02;2;18;685;Saint-Nicolas-aux-Bois;119;1;120
32;Hauts-de-France;02;2;20;686;Saint-Paul-aux-Bois;389;4;393
32;Hauts-de-France;02;4;20;687;Saint-Pierre-Aigle;334;9;343
32;Hauts-de-France;02;5;11;688;Saint-Pierre-lès-Franqueville;53;2;55
32;Hauts-de-France;02;2;11;689;Saint-Pierremont;43;1;44
32;Hauts-de-France;02;3;98;691;Saint-Quentin;53816;1282;55098
32;Hauts-de-France;02;4;21;693;Saint-Rémy-Blanzy;219;3;222
32;Hauts-de-France;02;3;12;694;Saint-Simon;635;8;643
32;Hauts-de-France;02;4;05;695;Saint-Thibaut;78;0;78
32;Hauts-de-France;02;2;06;696;Saint-Thomas;80;4;84
32;Hauts-de-France;02;2;06;675;Sainte-Croix;130;1;131
32;Hauts-de-France;02;5;19;678;Sainte-Geneviève;71;0;71
32;Hauts-de-France;02;2;06;690;Sainte-Preuve;82;1;83
32;Hauts-de-France;02;2;10;697;Samoussy;387;4;391
32;Hauts-de-France;02;4;05;698;Sancy-les-Cheminots;100;2;102
32;Hauts-de-France;02;1;05;699;Saponay;289;5;294
32;Hauts-de-France;02;1;04;701;Saulchery;724;8;732
32;Hauts-de-France;02;3;13;702;Savy;609;22;631
32;Hauts-de-France;02;3;01;703;Seboncourt;1097;12;1109
32;Hauts-de-France;02;2;20;704;Selens;250;4;254
32;Hauts-de-France;02;2;06;705;La Selve;217;6;223
32;Hauts-de-France;02;4;17;706;Septmonts;560;11;571
32;Hauts-de-France;02;4;05;439;Les Septvallons;1180;20;1200
32;Hauts-de-France;02;2;20;707;Septvaux;179;0;179
32;Hauts-de-France;02;3;01;708;Sequehart;209;8;217
32;Hauts-de-France;02;3;01;709;Serain;405;9;414
32;Hauts-de-France;02;3;12;710;Seraucourt-le-Grand;769;17;786
32;Hauts-de-France;02;4;17;711;Serches;309;7;316
32;Hauts-de-France;02;1;05;712;Sergy;151;3;154
32;Hauts-de-France;02;1;05;713;Seringes-et-Nesles;276;4;280
32;Hauts-de-France;02;4;17;714;Sermoise;349;2;351
32;Hauts-de-France;02;2;18;716;Servais;287;6;293
32;Hauts-de-France;02;4;05;715;Serval;52;2;54
32;Hauts-de-France;02;3;12;717;Séry-lès-Mézières;576;11;587
32;Hauts-de-France;02;4;21;718;Silly-la-Poterie;126;2;128
32;Hauts-de-France;02;2;03;719;Sinceny;2040;42;2082
32;Hauts-de-France;02;2;06;720;Sissonne;2055;78;2133
32;Hauts-de-France;02;3;12;721;Sissy;476;2;478
32;Hauts-de-France;02;4;99;722;Soissons;28530;646;29176
32;Hauts-de-France;02;5;19;723;Soize;101;1;102
32;Hauts-de-France;02;1;21;724;Sommelans;61;1;62
32;Hauts-de-France;02;5;19;725;Sommeron;142;9;151
32;Hauts-de-France;02;3;12;726;Sommette-Eaucourt;193;1;194
32;Hauts-de-France;02;2;11;727;Sons-et-Ronchères;240;0;240
32;Hauts-de-France;02;5;19;728;Sorbais;274;4;278
32;Hauts-de-France;02;4;21;729;Soucy;97;1;98
32;Hauts-de-France;02;4;05;730;Soupir;273;6;279
32;Hauts-de-France;02;5;11;731;Le Sourd;168;2;170
32;Hauts-de-France;02;3;12;732;Surfontaine;102;0;102
32;Hauts-de-France;02;4;21;734;Taillefontaine;276;6;282
32;Hauts-de-France;02;4;05;735;Tannières;16;0;16
32;Hauts-de-France;02;4;20;736;Tartiers;166;5;171
32;Hauts-de-France;02;2;11;737;Tavaux-et-Pontséricourt;569;12;581
32;Hauts-de-France;02;2;18;738;Tergnier;13456;186;13642
32;Hauts-de-France;02;4;05;739;Terny-Sorny;330;6;336
32;Hauts-de-France;02;5;19;740;Thenailles;220;7;227
32;Hauts-de-France;02;3;12;741;Thenelles;550;5;555
32;Hauts-de-France;02;2;11;742;Thiernu;102;0;102
32;Hauts-de-France;02;5;19;743;Le Thuel;168;1;169
32;Hauts-de-France;02;1;21;744;Torcy-en-Valois;73;2;75
32;Hauts-de-France;02;2;11;745;Toulis-et-Attencourt;128;2;130
32;Hauts-de-France;02;2;18;746;Travecy;670;9;679
32;Hauts-de-France;02;3;13;747;Trefcon;85;0;85
32;Hauts-de-France;02;1;04;748;Trélou-sur-Marne;948;19;967
32;Hauts-de-France;02;4;21;749;Troësnes;224;7;231
32;Hauts-de-France;02;2;20;750;Trosly-Loire;613;11;624
32;Hauts-de-France;02;2;06;751;Trucy;145;3;148
32;Hauts-de-France;02;3;12;752;Tugny-et-Pont;275;4;279
32;Hauts-de-France;02;5;07;753;Tupigny;335;3;338
32;Hauts-de-France;02;2;03;754;Ugny-le-Gay;182;2;184
32;Hauts-de-France;02;2;09;755;Urcel;585;9;594
32;Hauts-de-France;02;3;12;756;Urvillers;659;11;670
32;Hauts-de-France;02;5;07;757;Vadencourt;540;9;549
32;Hauts-de-France;02;4;05;758;Vailly-sur-Aisne;2003;37;2040
32;Hauts-de-France;02;5;11;759;La Vallée-au-Blé;365;3;368
32;Hauts-de-France;02;5;07;760;La Vallée-Mulâtre;148;3;151
32;Hauts-de-France;02;1;04;053;Vallées en Champagne;570;5;575
32;Hauts-de-France;02;2;06;761;Variscourt;197;4;201
32;Hauts-de-France;02;4;20;762;Vassens;151;5;156
32;Hauts-de-France;02;4;05;763;Vasseny;215;4;219
32;Hauts-de-France;02;2;06;764;Vassogne;87;3;90
32;Hauts-de-France;02;2;09;765;Vaucelles-et-Beffecourt;265;9;274
32;Hauts-de-France;02;4;05;766;Vaudesson;238;6;244
32;Hauts-de-France;02;5;07;769;Vaux-Andigny;923;13;936
32;Hauts-de-France;02;3;13;772;Vaux-en-Vermandois;153;1;154
32;Hauts-de-France;02;2;09;768;Vauxaillon;540;6;546
32;Hauts-de-France;02;4;17;770;Vauxbuin;786;20;806
32;Hauts-de-France;02;4;16;767;Vauxrezis;324;3;327
32;Hauts-de-France;02;4;05;773;Vauxtin;39;0;39
32;Hauts-de-France;02;3;13;774;Vendelles;117;1;118
32;Hauts-de-France;02;3;12;775;Vendeuil;951;12;963
32;Hauts-de-France;02;3;01;776;Vendhuile;556;12;568
32;Hauts-de-France;02;1;04;777;Vendières;160;8;168
32;Hauts-de-France;02;2;06;778;Vendresse-Beaulne;102;1;103
32;Hauts-de-France;02;5;07;779;Vénérolles;223;3;226
32;Hauts-de-France;02;4;16;780;Venizel;1378;17;1395
32;Hauts-de-France;02;1;02;781;Verdilly;461;16;477
32;Hauts-de-France;02;3;13;782;Le Verguier;219;2;221
32;Hauts-de-France;02;3;13;785;Vermand;1092;31;1123
32;Hauts-de-France;02;2;20;786;Verneuil-sous-Coucy;129;3;132
32;Hauts-de-France;02;2;11;787;Verneuil-sur-Serre;254;2;256
32;Hauts-de-France;02;2;18;788;Versigny;468;7;475
32;Hauts-de-France;02;5;19;789;Vervins;2552;108;2660
32;Hauts-de-France;02;2;11;790;Vesles-et-Caumont;231;3;234
32;Hauts-de-France;02;2;10;791;Veslud;242;6;248
32;Hauts-de-France;02;1;04;792;Veuilly-la-Poterie;155;7;162
32;Hauts-de-France;02;4;20;793;Vézaponin;125;1;126
32;Hauts-de-France;02;1;05;794;Vézilly;185;4;189
32;Hauts-de-France;02;4;20;795;Vic-sur-Aisne;1645;31;1676
32;Hauts-de-France;02;1;21;796;Vichel-Nanteuil;87;0;87
32;Hauts-de-France;02;4;05;797;Viel-Arcy;179;1;180
32;Hauts-de-France;02;1;04;798;Viels-Maisons;1234;13;1247
32;Hauts-de-France;02;4;21;799;Vierzy;435;10;445
32;Hauts-de-France;02;1;04;800;Viffort;320;5;325
32;Hauts-de-France;02;5;19;801;Vigneux-Hocquet;268;3;271
32;Hauts-de-France;02;5;19;802;La Ville-aux-Bois-lès-Dizy;207;0;207
32;Hauts-de-France;02;2;06;803;La Ville-aux-Bois-lès-Pontavert;143;5;148
32;Hauts-de-France;02;4;05;817;Ville-Savoye;82;1;83
32;Hauts-de-France;02;4;21;804;Villemontoire;186;3;189
32;Hauts-de-France;02;4;16;805;Villeneuve-Saint-Germain;2490;43;2533
32;Hauts-de-France;02;2;06;360;Villeneuve-sur-Aisne;2704;36;2740
32;Hauts-de-France;02;1;02;806;Villeneuve-sur-Fère;285;6;291
32;Hauts-de-France;02;2;03;807;Villequier-Aumont;646;25;671
32;Hauts-de-France;02;3;01;808;Villeret;300;6;306
32;Hauts-de-France;02;1;05;809;Villers-Agron-Aiguizy;74;3;77
32;Hauts-de-France;02;4;21;810;Villers-Cotterêts;10872;437;11309
32;Hauts-de-France;02;4;21;812;Villers-Hélon;217;6;223
32;Hauts-de-France;02;3;12;813;Villers-le-Sec;267;8;275
32;Hauts-de-France;02;5;07;814;Villers-lès-Guise;169;1;170
32;Hauts-de-France;02;3;12;815;Villers-Saint-Christophe;435;12;447
32;Hauts-de-France;02;1;05;816;Villers-sur-Fère;527;6;533
32;Hauts-de-France;02;1;04;818;Villiers-Saint-Denis;1127;11;1138
32;Hauts-de-France;02;5;19;819;Vincy-Reuil-et-Magny;117;1;118
32;Hauts-de-France;02;2;03;820;Viry-Noureuil;1695;48;1743
32;Hauts-de-France;02;2;09;821;Vivaise;698;21;719
32;Hauts-de-France;02;4;21;822;Vivières;394;12;406
32;Hauts-de-France;02;5;11;823;Voharies;73;0;73
32;Hauts-de-France;02;2;10;824;Vorges;370;8;378
32;Hauts-de-France;02;5;11;826;Voulpaix;372;7;379
32;Hauts-de-France;02;2;11;827;Voyenne;324;2;326
32;Hauts-de-France;02;4;16;828;Vregny;93;0;93
32;Hauts-de-France;02;4;05;829;Vuillery;43;1;44
32;Hauts-de-France;02;5;07;830;Wassigny;959;16;975
32;Hauts-de-France;02;5;08;831;Watigny;379;6;385
32;Hauts-de-France;02;5;11;832;Wiège-Faty;200;5;205
32;Hauts-de-France;02;5;08;833;Wimy;487;7;494
32;Hauts-de-France;02;2;09;834;Wissignicourt;167;6;173
32;Hauts-de-France;02;2;06;565;Œuilly;290;3;293
84;Auvergne-Rhône-Alpes;03;3;18;001;Abrest;2931;47;2978
84;Auvergne-Rhône-Alpes;03;2;16;002;Agonges;309;14;323
84;Auvergne-Rhône-Alpes;03;1;02;003;Ainay-le-Château;994;26;1020
84;Auvergne-Rhône-Alpes;03;3;08;004;Andelaroche;258;7;265
84;Auvergne-Rhône-Alpes;03;1;07;005;Archignat;336;4;340
84;Auvergne-Rhône-Alpes;03;3;08;006;Arfeuilles;648;17;665
84;Auvergne-Rhône-Alpes;03;1;11;007;Arpheuilles-Saint-Priest;356;7;363
84;Auvergne-Rhône-Alpes;03;3;08;008;Arronnes;374;14;388
84;Auvergne-Rhône-Alpes;03;2;13;009;Aubigny;139;29;168
84;Auvergne-Rhône-Alpes;03;1;07;010;Audes;433;14;447
84;Auvergne-Rhône-Alpes;03;2;19;011;Aurouër;413;9;422
84;Auvergne-Rhône-Alpes;03;2;16;012;Autry-Issards;325;6;331
84;Auvergne-Rhône-Alpes;03;2;13;013;Avermes;3966;98;4064
84;Auvergne-Rhône-Alpes;03;3;05;014;Avrilly;135;3;138
84;Auvergne-Rhône-Alpes;03;2;13;015;Bagneux;321;10;331
84;Auvergne-Rhône-Alpes;03;2;06;016;Barberier;143;2;145
84;Auvergne-Rhône-Alpes;03;3;08;017;Barrais-Bussolles;192;6;198
84;Auvergne-Rhône-Alpes;03;2;15;018;Bayet;698;14;712
84;Auvergne-Rhône-Alpes;03;2;05;019;Beaulon;1651;24;1675
84;Auvergne-Rhône-Alpes;03;1;03;020;Beaune-d'Allier;291;7;298
84;Auvergne-Rhône-Alpes;03;3;06;021;Bègues;227;2;229
84;Auvergne-Rhône-Alpes;03;3;06;022;Bellenaves;1020;19;1039
84;Auvergne-Rhône-Alpes;03;3;01;023;Bellerive-sur-Allier;8500;263;8763
84;Auvergne-Rhône-Alpes;03;3;14;024;Bert;243;6;249
84;Auvergne-Rhône-Alpes;03;2;14;025;Bessay-sur-Allier;1335;30;1365
84;Auvergne-Rhône-Alpes;03;2;16;026;Besson;768;18;786
84;Auvergne-Rhône-Alpes;03;1;03;027;Bézenet;948;23;971
84;Auvergne-Rhône-Alpes;03;3;08;028;Billezois;379;9;388
84;Auvergne-Rhône-Alpes;03;3;15;029;Billy;781;12;793
84;Auvergne-Rhône-Alpes;03;3;06;030;Biozat;845;15;860
84;Auvergne-Rhône-Alpes;03;1;07;031;Bizeneuille;294;9;303
84;Auvergne-Rhône-Alpes;03;1;03;032;Blomard;247;3;250
84;Auvergne-Rhône-Alpes;03;3;04;033;Bost;188;4;192
84;Auvergne-Rhône-Alpes;03;3;15;034;Boucé;508;12;520
84;Auvergne-Rhône-Alpes;03;3;05;035;Le Bouchaud;214;4;218
84;Auvergne-Rhône-Alpes;03;2;02;036;Bourbon-l'Archambault;2559;73;2632
84;Auvergne-Rhône-Alpes;03;1;02;037;Braize;257;3;260
84;Auvergne-Rhône-Alpes;03;2;16;038;Bransat;512;7;519
84;Auvergne-Rhône-Alpes;03;2;16;039;Bresnay;383;7;390
84;Auvergne-Rhône-Alpes;03;2;16;040;Bressolles;1113;28;1141
84;Auvergne-Rhône-Alpes;03;1;07;041;Le Brethon;325;12;337
84;Auvergne-Rhône-Alpes;03;3;08;042;Le Breuil;532;17;549
84;Auvergne-Rhône-Alpes;03;3;01;043;Broût-Vernet;1169;75;1244
84;Auvergne-Rhône-Alpes;03;3;01;044;Brugheas;1484;33;1517
84;Auvergne-Rhône-Alpes;03;3;08;045;Busset;910;20;930
84;Auvergne-Rhône-Alpes;03;2;02;046;Buxières-les-Mines;1058;30;1088
84;Auvergne-Rhône-Alpes;03;1;11;047;La Celle;413;10;423
84;Auvergne-Rhône-Alpes;03;1;02;048;Cérilly;1311;24;1335
84;Auvergne-Rhône-Alpes;03;2;16;049;Cesset;416;10;426
84;Auvergne-Rhône-Alpes;03;3;08;050;La Chabanne;186;11;197
84;Auvergne-Rhône-Alpes;03;1;07;051;Chambérat;305;6;311
84;Auvergne-Rhône-Alpes;03;1;03;052;Chamblet;1097;29;1126
84;Auvergne-Rhône-Alpes;03;2;06;053;Chantelle;1077;23;1100
84;Auvergne-Rhône-Alpes;03;2;14;054;Chapeau;232;6;238
84;Auvergne-Rhône-Alpes;03;1;07;055;La Chapelaude;1007;15;1022
84;Auvergne-Rhône-Alpes;03;3;08;056;La Chapelle;370;13;383
84;Auvergne-Rhône-Alpes;03;2;05;057;La Chapelle-aux-Chasses;210;3;213
84;Auvergne-Rhône-Alpes;03;1;03;058;Chappes;229;6;235
84;Auvergne-Rhône-Alpes;03;2;06;059;Chareil-Cintrat;358;7;365
84;Auvergne-Rhône-Alpes;03;3;17;060;Charmeil;983;16;999
84;Auvergne-Rhône-Alpes;03;3;06;061;Charmes;398;6;404
84;Auvergne-Rhône-Alpes;03;2;06;062;Charroux;362;8;370
84;Auvergne-Rhône-Alpes;03;2;05;063;Chassenard;989;21;1010
84;Auvergne-Rhône-Alpes;03;2;02;064;Château-sur-Allier;179;2;181
84;Auvergne-Rhône-Alpes;03;2;16;065;Châtel-de-Neuvre;542;9;551
84;Auvergne-Rhône-Alpes;03;3;08;066;Châtel-Montagne;347;5;352
84;Auvergne-Rhône-Alpes;03;3;14;067;Châtelperron;146;4;150
84;Auvergne-Rhône-Alpes;03;3;08;068;Châtelus;108;1;109
84;Auvergne-Rhône-Alpes;03;2;16;069;Châtillon;314;6;320
84;Auvergne-Rhône-Alpes;03;1;03;070;Chavenon;134;1;135
84;Auvergne-Rhône-Alpes;03;3;14;071;Chavroches;247;3;250
84;Auvergne-Rhône-Alpes;03;1;07;072;Chazemais;495;12;507
84;Auvergne-Rhône-Alpes;03;2;16;073;Chemilly;639;12;651
84;Auvergne-Rhône-Alpes;03;2;05;074;Chevagnes;663;16;679
84;Auvergne-Rhône-Alpes;03;3;06;075;Chezelle;175;2;177
84;Auvergne-Rhône-Alpes;03;2;05;076;Chézy;243;5;248
84;Auvergne-Rhône-Alpes;03;3;06;077;Chirat-l'Église;128;3;131
84;Auvergne-Rhône-Alpes;03;3;06;078;Chouvigny;227;8;235
84;Auvergne-Rhône-Alpes;03;3;14;079;Cindré;301;8;309
84;Auvergne-Rhône-Alpes;03;3;01;080;Cognat-Lyonne;694;10;704
84;Auvergne-Rhône-Alpes;03;1;03;081;Colombier;332;12;344
84;Auvergne-Rhône-Alpes;03;1;03;082;Commentry;6239;188;6427
84;Auvergne-Rhône-Alpes;03;2;16;083;Contigny;592;12;604
84;Auvergne-Rhône-Alpes;03;1;07;084;Cosne-d'Allier;2039;34;2073
84;Auvergne-Rhône-Alpes;03;2;13;085;Coulandon;650;62;712
84;Auvergne-Rhône-Alpes;03;2;05;086;Coulanges;354;3;357
84;Auvergne-Rhône-Alpes;03;2;02;087;Couleuvre;581;7;588
84;Auvergne-Rhône-Alpes;03;1;07;088;Courçais;325;2;327
84;Auvergne-Rhône-Alpes;03;3;06;089;Coutansouze;154;1;155
84;Auvergne-Rhône-Alpes;03;2;02;090;Couzon;299;8;307
84;Auvergne-Rhône-Alpes;03;3;15;091;Créchy;455;9;464
84;Auvergne-Rhône-Alpes;03;2;16;092;Cressanges;626;15;641
84;Auvergne-Rhône-Alpes;03;3;04;093;Creuzier-le-Neuf;1166;26;1192
84;Auvergne-Rhône-Alpes;03;3;04;094;Creuzier-le-Vieux;3304;101;3405
84;Auvergne-Rhône-Alpes;03;3;04;095;Cusset;12661;481;13142
84;Auvergne-Rhône-Alpes;03;2;06;096;Deneuille-lès-Chantelle;81;2;83
84;Auvergne-Rhône-Alpes;03;1;03;097;Deneuille-les-Mines;362;9;371
84;Auvergne-Rhône-Alpes;03;1;10;098;Désertines;4422;86;4508
84;Auvergne-Rhône-Alpes;03;2;16;099;Deux-Chaises;392;9;401
84;Auvergne-Rhône-Alpes;03;2;05;100;Diou;1398;25;1423
84;Auvergne-Rhône-Alpes;03;1;09;101;Domérat;8780;166;8946
84;Auvergne-Rhône-Alpes;03;2;05;102;Dompierre-sur-Besbre;3040;57;3097
84;Auvergne-Rhône-Alpes;03;3;05;103;Le Donjon;1069;27;1096
84;Auvergne-Rhône-Alpes;03;1;03;104;Doyet;1183;31;1214
84;Auvergne-Rhône-Alpes;03;3;08;105;Droiturier;336;7;343
84;Auvergne-Rhône-Alpes;03;1;11;106;Durdat-Larequille;1328;118;1446
84;Auvergne-Rhône-Alpes;03;3;06;107;Ébreuil;1265;29;1294
84;Auvergne-Rhône-Alpes;03;3;06;108;Échassières;385;7;392
84;Auvergne-Rhône-Alpes;03;3;01;109;Escurolles;775;32;807
84;Auvergne-Rhône-Alpes;03;3;01;110;Espinasse-Vozelle;991;27;1018
84;Auvergne-Rhône-Alpes;03;1;07;111;Estivareilles;1103;16;1119
84;Auvergne-Rhône-Alpes;03;2;06;112;Étroussat;655;9;664
84;Auvergne-Rhône-Alpes;03;3;08;113;Ferrières-sur-Sichon;552;17;569
84;Auvergne-Rhône-Alpes;03;2;14;114;La Ferté-Hauterive;296;10;306
84;Auvergne-Rhône-Alpes;03;2;06;115;Fleuriel;335;4;339
84;Auvergne-Rhône-Alpes;03;2;06;116;Fourilles;195;5;200
84;Auvergne-Rhône-Alpes;03;2;02;117;Franchesse;471;12;483
84;Auvergne-Rhône-Alpes;03;3;06;118;Gannat;5832;200;6032
84;Auvergne-Rhône-Alpes;03;2;05;119;Gannay-sur-Loire;409;4;413
84;Auvergne-Rhône-Alpes;03;2;05;120;Garnat-sur-Engièvre;705;12;717
84;Auvergne-Rhône-Alpes;03;2;19;121;Gennetines;670;15;685
84;Auvergne-Rhône-Alpes;03;2;16;122;Gipcy;238;6;244
84;Auvergne-Rhône-Alpes;03;2;14;124;Gouise;219;3;222
84;Auvergne-Rhône-Alpes;03;3;08;125;La Guillermie;127;2;129
84;Auvergne-Rhône-Alpes;03;1;07;158;Haut-Bocage;888;20;908
84;Auvergne-Rhône-Alpes;03;3;01;126;Hauterive;1169;14;1183
84;Auvergne-Rhône-Alpes;03;1;07;127;Hérisson;622;10;632
84;Auvergne-Rhône-Alpes;03;1;07;128;Huriel;2646;56;2702
84;Auvergne-Rhône-Alpes;03;1;03;129;Hyds;320;14;334
84;Auvergne-Rhône-Alpes;03;1;02;130;Isle-et-Bardais;272;6;278
84;Auvergne-Rhône-Alpes;03;3;08;131;Isserpent;534;13;547
84;Auvergne-Rhône-Alpes;03;3;14;132;Jaligny-sur-Besbre;575;15;590
84;Auvergne-Rhône-Alpes;03;3;06;133;Jenzat;508;15;523
84;Auvergne-Rhône-Alpes;03;2;16;134;Laféline;197;3;200
84;Auvergne-Rhône-Alpes;03;3;06;135;Lalizolle;380;9;389
84;Auvergne-Rhône-Alpes;03;1;12;136;Lamaids;222;5;227
84;Auvergne-Rhône-Alpes;03;3;15;137;Langy;272;6;278
84;Auvergne-Rhône-Alpes;03;3;08;138;Lapalisse;3123;78;3201
84;Auvergne-Rhône-Alpes;03;3;08;139;Laprugne;317;11;328
84;Auvergne-Rhône-Alpes;03;1;12;140;Lavault-Sainte-Anne;1165;33;1198
84;Auvergne-Rhône-Alpes;03;3;08;141;Lavoine;146;2;148
84;Auvergne-Rhône-Alpes;03;3;05;142;Lenax;253;5;258
84;Auvergne-Rhône-Alpes;03;1;02;143;Lételon;106;3;109
84;Auvergne-Rhône-Alpes;03;3;14;144;Liernolles;213;8;221
84;Auvergne-Rhône-Alpes;03;1;12;145;Lignerolles;742;13;755
84;Auvergne-Rhône-Alpes;03;2;02;146;Limoise;156;35;191
84;Auvergne-Rhône-Alpes;03;3;05;147;Loddes;164;2;166
84;Auvergne-Rhône-Alpes;03;2;15;148;Loriges;350;9;359
84;Auvergne-Rhône-Alpes;03;2;15;149;Louchy-Montfand;437;16;453
84;Auvergne-Rhône-Alpes;03;1;07;150;Louroux-Bourbonnais;211;5;216
84;Auvergne-Rhône-Alpes;03;1;03;151;Louroux-de-Beaune;165;3;168
84;Auvergne-Rhône-Alpes;03;3;06;152;Louroux-de-Bouble;239;8;247
84;Auvergne-Rhône-Alpes;03;3;05;154;Luneau;291;2;293
84;Auvergne-Rhône-Alpes;03;2;02;155;Lurcy-Lévis;1893;39;1932
84;Auvergne-Rhône-Alpes;03;2;05;156;Lusigny;1698;54;1752
84;Auvergne-Rhône-Alpes;03;3;15;157;Magnet;989;17;1006
84;Auvergne-Rhône-Alpes;03;1;03;159;Malicorne;796;14;810
84;Auvergne-Rhône-Alpes;03;2;15;160;Marcenat;405;4;409
84;Auvergne-Rhône-Alpes;03;1;11;161;Marcillat-en-Combraille;905;30;935
84;Auvergne-Rhône-Alpes;03;2;16;162;Marigny;204;6;210
84;Auvergne-Rhône-Alpes;03;3;08;163;Mariol;797;19;816
84;Auvergne-Rhône-Alpes;03;3;06;164;Le Mayet-d'École;269;3;272
84;Auvergne-Rhône-Alpes;03;3;08;165;Le Mayet-de-Montagne;1383;84;1467
84;Auvergne-Rhône-Alpes;03;3;06;166;Mazerier;301;5;306
84;Auvergne-Rhône-Alpes;03;1;11;167;Mazirat;282;4;286
84;Auvergne-Rhône-Alpes;03;1;02;168;Meaulne-Vitray;889;15;904
84;Auvergne-Rhône-Alpes;03;2;16;169;Meillard;318;6;324
84;Auvergne-Rhône-Alpes;03;2;16;170;Meillers;136;6;142
84;Auvergne-Rhône-Alpes;03;2;14;171;Mercy;261;3;264
84;Auvergne-Rhône-Alpes;03;1;07;172;Mesples;124;2;126
84;Auvergne-Rhône-Alpes;03;2;05;173;Molinet;1150;33;1183
84;Auvergne-Rhône-Alpes;03;3;08;174;Molles;898;26;924
84;Auvergne-Rhône-Alpes;03;3;06;175;Monestier;282;12;294
84;Auvergne-Rhône-Alpes;03;2;16;176;Monétay-sur-Allier;524;10;534
84;Auvergne-Rhône-Alpes;03;2;05;177;Monétay-sur-Loire;264;6;270
84;Auvergne-Rhône-Alpes;03;3;15;179;Montaigu-le-Blin;302;10;312
84;Auvergne-Rhône-Alpes;03;3;05;178;Montaiguët-en-Forez;313;8;321
84;Auvergne-Rhône-Alpes;03;2;14;180;Montbeugny;681;11;692
84;Auvergne-Rhône-Alpes;03;3;05;181;Montcombroux-les-Mines;313;3;316
84;Auvergne-Rhône-Alpes;03;3;06;182;Monteignet-sur-l'Andelot;266;1;267
84;Auvergne-Rhône-Alpes;03;2;16;183;Le Montet;467;4;471
84;Auvergne-Rhône-Alpes;03;2;13;184;Montilly;508;8;516
84;Auvergne-Rhône-Alpes;03;1;97;185;Montluçon;35653;1093;36746
84;Auvergne-Rhône-Alpes;03;1;03;186;Montmarault;1521;23;1544
84;Auvergne-Rhône-Alpes;03;3;15;187;Montoldre;632;9;641
84;Auvergne-Rhône-Alpes;03;2;15;188;Montord;215;1;216
84;Auvergne-Rhône-Alpes;03;1;03;189;Montvicq;720;24;744
84;Auvergne-Rhône-Alpes;03;2;98;190;Moulins;19664;563;20227
84;Auvergne-Rhône-Alpes;03;1;03;191;Murat;295;17;312
84;Auvergne-Rhône-Alpes;03;3;06;192;Nades;153;4;157
84;Auvergne-Rhône-Alpes;03;1;07;193;Nassigny;182;4;186
84;Auvergne-Rhône-Alpes;03;3;06;194;Naves;119;2;121
84;Auvergne-Rhône-Alpes;03;1;11;195;Néris-les-Bains;2553;93;2646
84;Auvergne-Rhône-Alpes;03;3;05;196;Neuilly-en-Donjon;222;3;225
84;Auvergne-Rhône-Alpes;03;2;14;197;Neuilly-le-Réal;1456;33;1489
84;Auvergne-Rhône-Alpes;03;2;02;198;Neure;188;0;188
84;Auvergne-Rhône-Alpes;03;2;13;200;Neuvy;1595;224;1819
84;Auvergne-Rhône-Alpes;03;3;08;201;Nizerolles;314;14;328
84;Auvergne-Rhône-Alpes;03;2;16;202;Noyant-d'Allier;627;16;643
84;Auvergne-Rhône-Alpes;03;2;05;203;Paray-le-Frésil;389;10;399
84;Auvergne-Rhône-Alpes;03;2;15;204;Paray-sous-Briailles;633;9;642
84;Auvergne-Rhône-Alpes;03;3;08;205;Périgny;440;11;451
84;Auvergne-Rhône-Alpes;03;1;11;206;La Petite-Marche;176;6;182
84;Auvergne-Rhône-Alpes;03;2;05;207;Pierrefitte-sur-Loire;509;14;523
84;Auvergne-Rhône-Alpes;03;3;05;208;Le Pin;411;7;418
84;Auvergne-Rhône-Alpes;03;3;06;209;Poëzat;148;3;151
84;Auvergne-Rhône-Alpes;03;2;02;210;Pouzy-Mésangy;402;10;412
84;Auvergne-Rhône-Alpes;03;1;12;211;Prémilhat;2458;49;2507
84;Auvergne-Rhône-Alpes;03;1;12;212;Quinssaines;1487;25;1512
84;Auvergne-Rhône-Alpes;03;1;07;213;Reugny;249;3;252
84;Auvergne-Rhône-Alpes;03;2;16;214;Rocles;380;3;383
84;Auvergne-Rhône-Alpes;03;3;15;215;Rongères;565;13;578
84;Auvergne-Rhône-Alpes;03;1;11;216;Ronnet;174;3;177
84;Auvergne-Rhône-Alpes;03;1;03;217;Saint-Angel;754;35;789
84;Auvergne-Rhône-Alpes;03;2;02;218;Saint-Aubin-le-Monial;266;8;274
84;Auvergne-Rhône-Alpes;03;1;03;219;Saint-Bonnet-de-Four;212;4;216
84;Auvergne-Rhône-Alpes;03;3;06;220;Saint-Bonnet-de-Rochefort;698;14;712
84;Auvergne-Rhône-Alpes;03;1;02;221;Saint-Bonnet-Tronçais;725;9;734
84;Auvergne-Rhône-Alpes;03;1;07;222;Saint-Caprais;90;5;95
84;Auvergne-Rhône-Alpes;03;3;08;223;Saint-Christophe;466;15;481
84;Auvergne-Rhône-Alpes;03;3;08;224;Saint-Clément;300;7;307
84;Auvergne-Rhône-Alpes;03;1;07;225;Saint-Désiré;447;9;456
84;Auvergne-Rhône-Alpes;03;3;05;226;Saint-Didier-en-Donjon;259;4;263
84;Auvergne-Rhône-Alpes;03;3;01;227;Saint-Didier-la-Forêt;379;8;387
84;Auvergne-Rhône-Alpes;03;1;07;228;Saint-Éloy-d'Allier;43;0;43
84;Auvergne-Rhône-Alpes;03;2;19;229;Saint-Ennemond;626;18;644
84;Auvergne-Rhône-Alpes;03;3;08;230;Saint-Étienne-de-Vicq;526;17;543
84;Auvergne-Rhône-Alpes;03;1;11;231;Saint-Fargeol;190;5;195
84;Auvergne-Rhône-Alpes;03;3;15;232;Saint-Félix;315;10;325
84;Auvergne-Rhône-Alpes;03;1;11;233;Saint-Genest;407;7;414
84;Auvergne-Rhône-Alpes;03;2;14;234;Saint-Gérand-de-Vaux;381;11;392
84;Auvergne-Rhône-Alpes;03;3;15;235;Saint-Gérand-le-Puy;993;9;1002
84;Auvergne-Rhône-Alpes;03;2;06;237;Saint-Germain-de-Salles;425;9;434
84;Auvergne-Rhône-Alpes;03;3;17;236;Saint-Germain-des-Fossés;3656;66;3722
84;Auvergne-Rhône-Alpes;03;2;02;238;Saint-Hilaire;543;5;548
84;Auvergne-Rhône-Alpes;03;3;05;239;Saint-Léger-sur-Vouzance;265;10;275
84;Auvergne-Rhône-Alpes;03;3;14;240;Saint-Léon;549;11;560
84;Auvergne-Rhône-Alpes;03;2;02;241;Saint-Léopardin-d'Augy;362;43;405
84;Auvergne-Rhône-Alpes;03;3;15;242;Saint-Loup;568;14;582
84;Auvergne-Rhône-Alpes;03;1;11;244;Saint-Marcel-en-Marcillat;136;2;138
84;Auvergne-Rhône-Alpes;03;1;03;243;Saint-Marcel-en-Murat;124;6;130
84;Auvergne-Rhône-Alpes;03;2;05;245;Saint-Martin-des-Lais;123;1;124
84;Auvergne-Rhône-Alpes;03;1;07;246;Saint-Martinien;602;13;615
84;Auvergne-Rhône-Alpes;03;2;16;247;Saint-Menoux;1045;32;1077
84;Auvergne-Rhône-Alpes;03;3;08;248;Saint-Nicolas-des-Biefs;171;2;173
84;Auvergne-Rhône-Alpes;03;1;07;249;Saint-Palais;164;2;166
84;Auvergne-Rhône-Alpes;03;3;08;250;Saint-Pierre-Laval;357;6;363
84;Auvergne-Rhône-Alpes;03;2;02;251;Saint-Plaisir;379;11;390
84;Auvergne-Rhône-Alpes;03;3;01;252;Saint-Pont;656;15;671
84;Auvergne-Rhône-Alpes;03;2;05;253;Saint-Pourçain-sur-Besbre;418;10;428
84;Auvergne-Rhône-Alpes;03;2;15;254;Saint-Pourçain-sur-Sioule;5160;120;5280
84;Auvergne-Rhône-Alpes;03;3;06;255;Saint-Priest-d'Andelot;145;4;149
84;Auvergne-Rhône-Alpes;03;1;03;256;Saint-Priest-en-Murat;223;7;230
84;Auvergne-Rhône-Alpes;03;3;08;257;Saint-Prix;796;19;815
84;Auvergne-Rhône-Alpes;03;3;17;258;Saint-Rémy-en-Rollat;1706;35;1741
84;Auvergne-Rhône-Alpes;03;1;07;259;Saint-Sauvier;348;3;351
84;Auvergne-Rhône-Alpes;03;2;16;260;Saint-Sornin;225;4;229
84;Auvergne-Rhône-Alpes;03;1;09;262;Saint-Victor;2098;39;2137
84;Auvergne-Rhône-Alpes;03;2;14;263;Saint-Voir;190;7;197
84;Auvergne-Rhône-Alpes;03;3;18;264;Saint-Yorre;2561;53;2614
84;Auvergne-Rhône-Alpes;03;1;11;261;Sainte-Thérence;184;7;191
84;Auvergne-Rhône-Alpes;03;2;05;265;Saligny-sur-Roudon;681;79;760
84;Auvergne-Rhône-Alpes;03;3;15;266;Sanssat;259;5;264
84;Auvergne-Rhône-Alpes;03;2;15;267;Saulcet;693;25;718
84;Auvergne-Rhône-Alpes;03;3;06;268;Saulzet;387;3;390
84;Auvergne-Rhône-Alpes;03;1;07;269;Sauvagny;89;2;91
84;Auvergne-Rhône-Alpes;03;1;03;270;Sazeret;148;5;153
84;Auvergne-Rhône-Alpes;03;3;01;271;Serbannes;820;31;851
84;Auvergne-Rhône-Alpes;03;3;08;272;Servilly;295;6;301
84;Auvergne-Rhône-Alpes;03;3;15;273;Seuillet;508;7;515
84;Auvergne-Rhône-Alpes;03;3;14;274;Sorbier;315;6;321
84;Auvergne-Rhône-Alpes;03;2;16;275;Souvigny;1828;50;1878
84;Auvergne-Rhône-Alpes;03;3;06;276;Sussat;101;6;107
84;Auvergne-Rhône-Alpes;03;3;06;277;Target;254;12;266
84;Auvergne-Rhône-Alpes;03;2;06;278;Taxat-Senat;196;4;200
84;Auvergne-Rhône-Alpes;03;1;12;279;Teillet-Argenty;556;10;566
84;Auvergne-Rhône-Alpes;03;1;11;280;Terjat;196;10;206
84;Auvergne-Rhône-Alpes;03;2;16;281;Le Theil;404;4;408
84;Auvergne-Rhône-Alpes;03;1;02;282;Theneuille;365;14;379
84;Auvergne-Rhône-Alpes;03;2;05;283;Thiel-sur-Acolin;1125;16;1141
84;Auvergne-Rhône-Alpes;03;3;14;284;Thionne;313;10;323
84;Auvergne-Rhône-Alpes;03;1;07;285;Tortezais;175;3;178
84;Auvergne-Rhône-Alpes;03;2;14;286;Toulon-sur-Allier;1135;34;1169
84;Auvergne-Rhône-Alpes;03;2;16;287;Treban;387;9;396
84;Auvergne-Rhône-Alpes;03;1;07;288;Treignat;396;8;404
84;Auvergne-Rhône-Alpes;03;3;14;289;Treteau;519;13;532
84;Auvergne-Rhône-Alpes;03;2;19;290;Trévol;1625;59;1684
84;Auvergne-Rhône-Alpes;03;3;14;291;Trézelles;404;13;417
84;Auvergne-Rhône-Alpes;03;2;16;292;Tronget;897;14;911
84;Auvergne-Rhône-Alpes;03;1;02;293;Urçay;264;10;274
84;Auvergne-Rhône-Alpes;03;2;06;294;Ussel-d'Allier;162;1;163
84;Auvergne-Rhône-Alpes;03;3;06;295;Valignat;77;0;77
84;Auvergne-Rhône-Alpes;03;1;02;296;Valigny;376;12;388
84;Auvergne-Rhône-Alpes;03;1;07;297;Vallon-en-Sully;1564;29;1593
84;Auvergne-Rhône-Alpes;03;3;15;298;Varennes-sur-Allier;3561;72;3633
84;Auvergne-Rhône-Alpes;03;3;14;299;Varennes-sur-Tèche;245;9;254
84;Auvergne-Rhône-Alpes;03;2;05;300;Vaumas;538;12;550
84;Auvergne-Rhône-Alpes;03;1;09;301;Vaux;1121;25;1146
84;Auvergne-Rhône-Alpes;03;3;06;302;Veauce;38;1;39
84;Auvergne-Rhône-Alpes;03;1;07;303;Venas;235;8;243
84;Auvergne-Rhône-Alpes;03;3;01;304;Vendat;2216;58;2274
84;Auvergne-Rhône-Alpes;03;1;03;305;Verneix;603;11;614
84;Auvergne-Rhône-Alpes;03;3;08;306;Le Vernet;1941;57;1998
84;Auvergne-Rhône-Alpes;03;2;16;307;Verneuil-en-Bourbonnais;244;2;246
84;Auvergne-Rhône-Alpes;03;1;03;308;Vernusse;153;6;159
84;Auvergne-Rhône-Alpes;03;2;02;309;Le Veurdre;455;10;465
84;Auvergne-Rhône-Alpes;03;3;99;310;Vichy;24166;357;24523
84;Auvergne-Rhône-Alpes;03;3;06;311;Vicq;331;6;337
84;Auvergne-Rhône-Alpes;03;2;02;312;Vieure;279;6;285
84;Auvergne-Rhône-Alpes;03;1;02;313;Le Vilhain;275;8;283
84;Auvergne-Rhône-Alpes;03;1;11;314;Villebret;1316;36;1352
84;Auvergne-Rhône-Alpes;03;1;03;315;Villefranche-d'Allier;1328;43;1371
84;Auvergne-Rhône-Alpes;03;2;19;316;Villeneuve-sur-Allier;1071;16;1087
84;Auvergne-Rhône-Alpes;03;1;07;317;Viplaix;300;8;308
84;Auvergne-Rhône-Alpes;03;2;06;319;Voussac;480;10;490
84;Auvergne-Rhône-Alpes;03;2;02;320;Ygrande;775;16;791
84;Auvergne-Rhône-Alpes;03;2;19;321;Yzeure;13088;537;13625
93;Provence-Alpes-Côte d'Azur;04;3;05;001;Aiglun;1440;27;1467
93;Provence-Alpes-Côte d'Azur;04;4;15;004;Allemagne-en-Provence;539;28;567
93;Provence-Alpes-Côte d'Azur;04;2;02;005;Allons;143;2;145
93;Provence-Alpes-Côte d'Azur;04;2;02;006;Allos;797;7;804
93;Provence-Alpes-Côte d'Azur;04;2;02;007;Angles;68;0;68
93;Provence-Alpes-Côte d'Azur;04;2;02;008;Annot;1042;37;1079
93;Provence-Alpes-Côte d'Azur;04;3;13;009;Archail;15;0;15
93;Provence-Alpes-Côte d'Azur;04;4;11;012;Aubenas-les-Alpes;98;0;98
93;Provence-Alpes-Côte d'Azur;04;4;03;013;Aubignosc;592;15;607
93;Provence-Alpes-Côte d'Azur;04;4;14;016;Authon;62;0;62
93;Provence-Alpes-Côte d'Azur;04;3;13;017;Auzet;98;5;103
93;Provence-Alpes-Côte d'Azur;04;4;11;018;Banon;970;15;985
93;Provence-Alpes-Côte d'Azur;04;1;01;019;Barcelonnette;2598;202;2800
93;Provence-Alpes-Côte d'Azur;04;3;13;020;Barles;134;2;136
93;Provence-Alpes-Côte d'Azur;04;3;05;021;Barras;142;4;146
93;Provence-Alpes-Côte d'Azur;04;2;12;022;Barrême;432;8;440
93;Provence-Alpes-Côte d'Azur;04;4;13;023;Bayons;183;4;187
93;Provence-Alpes-Côte d'Azur;04;3;13;024;Beaujeu;130;3;133
93;Provence-Alpes-Côte d'Azur;04;2;02;025;Beauvezer;377;7;384
93;Provence-Alpes-Côte d'Azur;04;4;13;026;Bellaffaire;144;5;149
93;Provence-Alpes-Côte d'Azur;04;4;14;027;Bevons;240;54;294
93;Provence-Alpes-Côte d'Azur;04;3;12;028;Beynes;125;9;134
93;Provence-Alpes-Côte d'Azur;04;2;12;030;Blieux;60;0;60
93;Provence-Alpes-Côte d'Azur;04;3;12;031;Bras-d'Asse;568;10;578
93;Provence-Alpes-Côte d'Azur;04;2;02;032;Braux;125;0;125
93;Provence-Alpes-Côte d'Azur;04;4;06;034;La Brillanne;1149;15;1164
93;Provence-Alpes-Côte d'Azur;04;4;15;035;Brunet;278;6;284
93;Provence-Alpes-Côte d'Azur;04;3;13;036;Le Brusquet;958;28;986
93;Provence-Alpes-Côte d'Azur;04;4;13;037;Le Caire;71;2;73
93;Provence-Alpes-Côte d'Azur;04;2;02;039;Castellane;1524;40;1564
93;Provence-Alpes-Côte d'Azur;04;3;04;040;Le Castellard-Mélan;64;1;65
93;Provence-Alpes-Côte d'Azur;04;4;12;041;Le Castellet;293;6;299
93;Provence-Alpes-Côte d'Azur;04;2;02;042;Castellet-lès-Sausses;137;1;138
93;Provence-Alpes-Côte d'Azur;04;4;11;045;Céreste;1199;20;1219
93;Provence-Alpes-Côte d'Azur;04;3;12;046;Le Chaffaut-Saint-Jurson;689;114;803
93;Provence-Alpes-Côte d'Azur;04;3;05;047;Champtercier;844;20;864
93;Provence-Alpes-Côte d'Azur;04;3;03;049;Château-Arnoux-Saint-Auban;5139;109;5248
93;Provence-Alpes-Côte d'Azur;04;4;13;050;Châteaufort;28;0;28
93;Provence-Alpes-Côte d'Azur;04;4;14;051;Châteauneuf-Miravail;69;0;69
93;Provence-Alpes-Côte d'Azur;04;4;03;053;Châteauneuf-Val-Saint-Donat;504;20;524
93;Provence-Alpes-Côte d'Azur;04;3;12;054;Châteauredon;73;1;74
93;Provence-Alpes-Côte d'Azur;04;2;12;055;Chaudon-Norante;183;2;185
93;Provence-Alpes-Côte d'Azur;04;4;13;057;Clamensane;172;3;175
93;Provence-Alpes-Côte d'Azur;04;4;13;058;Claret;269;5;274
93;Provence-Alpes-Côte d'Azur;04;2;12;059;Clumanc;215;1;216
93;Provence-Alpes-Côte d'Azur;04;2;02;061;Colmars;496;5;501
93;Provence-Alpes-Côte d'Azur;04;1;01;062;La Condamine-Châtelard;155;4;159
93;Provence-Alpes-Côte d'Azur;04;4;09;063;Corbières-en-Provence;1184;32;1216
93;Provence-Alpes-Côte d'Azur;04;4;06;065;Cruis;642;5;647
93;Provence-Alpes-Côte d'Azur;04;4;13;066;Curbans;575;12;587
93;Provence-Alpes-Côte d'Azur;04;4;14;067;Curel;55;1;56
93;Provence-Alpes-Côte d'Azur;04;4;11;068;Dauphin;831;13;844
93;Provence-Alpes-Côte d'Azur;04;2;02;069;Demandolx;135;3;138
93;Provence-Alpes-Côte d'Azur;04;3;98;070;Digne-les-Bains;16460;869;17329
93;Provence-Alpes-Côte d'Azur;04;3;13;072;Draix;115;2;117
93;Provence-Alpes-Côte d'Azur;04;1;01;073;Enchastrayes;396;12;408
93;Provence-Alpes-Côte d'Azur;04;3;04;074;Entrages;104;2;106
93;Provence-Alpes-Côte d'Azur;04;4;14;075;Entrepierres;379;12;391
93;Provence-Alpes-Côte d'Azur;04;2;02;076;Entrevaux;852;22;874
93;Provence-Alpes-Côte d'Azur;04;4;12;077;Entrevennes;168;3;171
93;Provence-Alpes-Côte d'Azur;04;3;03;079;L' Escale;1389;35;1424
93;Provence-Alpes-Côte d'Azur;04;4;15;081;Esparron-de-Verdon;398;5;403
93;Provence-Alpes-Côte d'Azur;04;3;12;084;Estoublon;486;7;493
93;Provence-Alpes-Côte d'Azur;04;1;01;086;Faucon-de-Barcelonnette;319;16;335
93;Provence-Alpes-Côte d'Azur;04;4;13;085;Faucon-du-Caire;53;1;54
93;Provence-Alpes-Côte d'Azur;04;4;06;087;Fontienne;128;2;130
93;Provence-Alpes-Côte d'Azur;04;4;06;088;Forcalquier;5018;85;5103
93;Provence-Alpes-Côte d'Azur;04;2;02;090;Le Fugeret;200;2;202
93;Provence-Alpes-Côte d'Azur;04;3;03;091;Ganagobie;96;0;96
93;Provence-Alpes-Côte d'Azur;04;2;02;092;La Garde;89;3;92
93;Provence-Alpes-Côte d'Azur;04;4;13;093;Gigors;60;1;61
93;Provence-Alpes-Côte d'Azur;04;4;15;094;Gréoux-les-Bains;2634;47;2681
93;Provence-Alpes-Côte d'Azur;04;3;04;177;Hautes-Duyes;43;0;43
93;Provence-Alpes-Côte d'Azur;04;4;11;095;L' Hospitalet;90;0;90
93;Provence-Alpes-Côte d'Azur;04;1;01;096;Jausiers;1130;29;1159
93;Provence-Alpes-Côte d'Azur;04;3;13;097;La Javie;404;6;410
93;Provence-Alpes-Côte d'Azur;04;2;02;099;Lambruisse;95;5;100
93;Provence-Alpes-Côte d'Azur;04;4;06;101;Lardiers;126;3;129
93;Provence-Alpes-Côte d'Azur;04;1;01;102;Le Lauzet-Ubaye;186;2;188
93;Provence-Alpes-Côte d'Azur;04;4;06;104;Limans;369;10;379
93;Provence-Alpes-Côte d'Azur;04;4;06;106;Lurs;382;10;392
93;Provence-Alpes-Côte d'Azur;04;3;12;107;Majastres;4;0;4
93;Provence-Alpes-Côte d'Azur;04;3;05;108;Malijai;1975;30;2005
93;Provence-Alpes-Côte d'Azur;04;3;06;109;Mallefougasse-Augès;327;4;331
93;Provence-Alpes-Côte d'Azur;04;3;05;110;Mallemoisson;1046;25;1071
93;Provence-Alpes-Côte d'Azur;04;4;11;111;Mane;1349;26;1375
93;Provence-Alpes-Côte d'Azur;04;4;99;112;Manosque;22333;659;22992
93;Provence-Alpes-Côte d'Azur;04;3;04;113;Marcoux;464;15;479
93;Provence-Alpes-Côte d'Azur;04;2;02;115;Méailles;115;2;117
93;Provence-Alpes-Côte d'Azur;04;3;10;116;Les Mées;3735;43;3778
93;Provence-Alpes-Côte d'Azur;04;4;13;118;Melve;119;2;121
93;Provence-Alpes-Côte d'Azur;04;1;01;161;Méolans-Revel;339;8;347
93;Provence-Alpes-Côte d'Azur;04;3;12;121;Mézel;656;21;677
93;Provence-Alpes-Côte d'Azur;04;3;05;122;Mirabeau;511;10;521
93;Provence-Alpes-Côte d'Azur;04;4;14;123;Mison;1128;33;1161
93;Provence-Alpes-Côte d'Azur;04;4;15;124;Montagnac-Montpezat;424;11;435
93;Provence-Alpes-Côte d'Azur;04;3;13;126;Montclar;414;12;426
93;Provence-Alpes-Côte d'Azur;04;4;03;127;Montfort;332;3;335
93;Provence-Alpes-Côte d'Azur;04;4;07;128;Montfuron;210;0;210
93;Provence-Alpes-Côte d'Azur;04;4;11;129;Montjustin;58;1;59
93;Provence-Alpes-Côte d'Azur;04;4;06;130;Montlaux;195;2;197
93;Provence-Alpes-Côte d'Azur;04;4;11;132;Montsalier;139;1;140
93;Provence-Alpes-Côte d'Azur;04;2;02;133;Moriez;238;1;239
93;Provence-Alpes-Côte d'Azur;04;4;13;134;La Motte-du-Caire;560;5;565
93;Provence-Alpes-Côte d'Azur;04;3;12;135;Moustiers-Sainte-Marie;709;16;725
93;Provence-Alpes-Côte d'Azur;04;2;02;136;La Mure-Argens;325;8;333
93;Provence-Alpes-Côte d'Azur;04;4;13;137;Nibles;42;0;42
93;Provence-Alpes-Côte d'Azur;04;4;06;138;Niozelles;271;6;277
93;Provence-Alpes-Côte d'Azur;04;4;14;139;Noyers-sur-Jabron;524;7;531
93;Provence-Alpes-Côte d'Azur;04;4;14;140;Les Omergues;130;3;133
93;Provence-Alpes-Côte d'Azur;04;4;06;141;Ongles;372;9;381
93;Provence-Alpes-Côte d'Azur;04;4;11;142;Oppedette;52;1;53
93;Provence-Alpes-Côte d'Azur;04;4;10;143;Oraison;5882;73;5955
93;Provence-Alpes-Côte d'Azur;04;2;12;144;La Palud-sur-Verdon;349;3;352
93;Provence-Alpes-Côte d'Azur;04;4;14;145;Peipin;1464;35;1499
93;Provence-Alpes-Côte d'Azur;04;2;02;148;Peyroules;240;9;249
93;Provence-Alpes-Côte d'Azur;04;3;03;149;Peyruis;2858;49;2907
93;Provence-Alpes-Côte d'Azur;04;4;13;150;Piégut;186;4;190
93;Provence-Alpes-Côte d'Azur;04;4;06;151;Pierrerue;493;12;505
93;Provence-Alpes-Côte d'Azur;04;4;07;152;Pierrevert;3816;122;3938
93;Provence-Alpes-Côte d'Azur;04;1;01;154;Pontis;84;3;87
93;Provence-Alpes-Côte d'Azur;04;3;13;155;Prads-Haute-Bléone;182;1;183
93;Provence-Alpes-Côte d'Azur;04;4;12;156;Puimichel;247;1;248
93;Provence-Alpes-Côte d'Azur;04;4;12;157;Puimoisson;723;9;732
93;Provence-Alpes-Côte d'Azur;04;4;15;158;Quinson;417;9;426
93;Provence-Alpes-Côte d'Azur;04;4;11;159;Redortiers;81;5;86
93;Provence-Alpes-Côte d'Azur;04;4;11;160;Reillanne;1675;37;1712
93;Provence-Alpes-Côte d'Azur;04;4;11;162;Revest-des-Brousses;268;6;274
93;Provence-Alpes-Côte d'Azur;04;4;11;163;Revest-du-Bion;562;5;567
93;Provence-Alpes-Côte d'Azur;04;4;06;164;Revest-Saint-Martin;85;1;86
93;Provence-Alpes-Côte d'Azur;04;4;12;166;Riez;1856;26;1882
93;Provence-Alpes-Côte d'Azur;04;3;04;167;La Robine-sur-Galabre;299;6;305
93;Provence-Alpes-Côte d'Azur;04;4;11;169;La Rochegiron;100;3;103
93;Provence-Alpes-Côte d'Azur;04;2;02;170;La Rochette;70;0;70
93;Provence-Alpes-Côte d'Azur;04;2;02;171;Rougon;110;0;110
93;Provence-Alpes-Côte d'Azur;04;4;12;172;Roumoules;746;18;764
93;Provence-Alpes-Côte d'Azur;04;2;02;173;Saint-André-les-Alpes;1008;21;1029
93;Provence-Alpes-Côte d'Azur;04;2;02;174;Saint-Benoît;149;1;150
93;Provence-Alpes-Côte d'Azur;04;4;06;178;Saint-Étienne-les-Orgues;1296;34;1330
93;Provence-Alpes-Côte d'Azur;04;4;14;179;Saint-Geniez;96;2;98
93;Provence-Alpes-Côte d'Azur;04;2;12;180;Saint-Jacques;78;4;82
93;Provence-Alpes-Côte d'Azur;04;3;12;181;Saint-Jeannet;54;1;55
93;Provence-Alpes-Côte d'Azur;04;3;12;182;Saint-Julien-d'Asse;212;2;214
93;Provence-Alpes-Côte d'Azur;04;2;02;183;Saint-Julien-du-Verdon;144;3;147
93;Provence-Alpes-Côte d'Azur;04;3;12;184;Saint-Jurs;138;3;141
93;Provence-Alpes-Côte d'Azur;04;4;15;186;Saint-Laurent-du-Verdon;97;4;101
93;Provence-Alpes-Côte d'Azur;04;2;12;187;Saint-Lions;49;1;50
93;Provence-Alpes-Côte d'Azur;04;4;11;188;Saint-Maime;860;8;868
93;Provence-Alpes-Côte d'Azur;04;4;15;189;Saint-Martin-de-Brômes;590;12;602
93;Provence-Alpes-Côte d'Azur;04;4;08;190;Saint-Martin-les-Eaux;114;3;117
93;Provence-Alpes-Côte d'Azur;04;3;13;191;Saint-Martin-lès-Seyne;14;2;16
93;Provence-Alpes-Côte d'Azur;04;4;11;192;Saint-Michel-l'Observatoire;1238;25;1263
93;Provence-Alpes-Côte d'Azur;04;1;01;193;Saint-Paul-sur-Ubaye;186;7;193
93;Provence-Alpes-Côte d'Azur;04;2;02;194;Saint-Pierre;96;2;98
93;Provence-Alpes-Côte d'Azur;04;1;01;195;Saint-Pons;626;12;638
93;Provence-Alpes-Côte d'Azur;04;4;14;199;Saint-Vincent-sur-Jabron;191;11;202
93;Provence-Alpes-Côte d'Azur;04;4;11;175;Sainte-Croix-à-Lauze;88;1;89
93;Provence-Alpes-Côte d'Azur;04;3;15;176;Sainte-Croix-du-Verdon;119;4;123
93;Provence-Alpes-Côte d'Azur;04;4;09;197;Sainte-Tulle;3408;78;3486
93;Provence-Alpes-Côte d'Azur;04;4;14;200;Salignac;634;21;655
93;Provence-Alpes-Côte d'Azur;04;4;11;201;Saumane;118;3;121
93;Provence-Alpes-Côte d'Azur;04;2;02;202;Sausses;127;2;129
93;Provence-Alpes-Côte d'Azur;04;3;13;203;Selonnet;464;9;473
93;Provence-Alpes-Côte d'Azur;04;2;12;204;Senez;167;4;171
93;Provence-Alpes-Côte d'Azur;04;3;13;205;Seyne;1362;26;1388
93;Provence-Alpes-Côte d'Azur;04;4;06;206;Sigonce;428;11;439
93;Provence-Alpes-Côte d'Azur;04;4;13;207;Sigoyer;107;2;109
93;Provence-Alpes-Côte d'Azur;04;4;11;208;Simiane-la-Rotonde;596;16;612
93;Provence-Alpes-Côte d'Azur;04;4;14;209;Sisteron;7460;237;7697
93;Provence-Alpes-Côte d'Azur;04;2;02;210;Soleilhas;100;4;104
93;Provence-Alpes-Côte d'Azur;04;4;14;211;Sourribes;179;2;181
93;Provence-Alpes-Côte d'Azur;04;2;12;214;Tartonne;135;1;136
93;Provence-Alpes-Côte d'Azur;04;4;13;216;Thèze;236;4;240
93;Provence-Alpes-Côte d'Azur;04;3;04;217;Thoard;723;18;741
93;Provence-Alpes-Côte d'Azur;04;2;02;218;Thorame-Basse;226;3;229
93;Provence-Alpes-Côte d'Azur;04;2;02;219;Thorame-Haute;240;6;246
93;Provence-Alpes-Côte d'Azur;04;1;01;220;Les Thuiles;397;15;412
93;Provence-Alpes-Côte d'Azur;04;4;13;222;Turriers;318;9;327
93;Provence-Alpes-Côte d'Azur;04;1;01;033;Ubaye-Serre-Ponçon;741;18;759
93;Provence-Alpes-Côte d'Azur;04;2;02;224;Ubraye;92;1;93
93;Provence-Alpes-Côte d'Azur;04;1;01;226;Uvernet-Fours;586;14;600
93;Provence-Alpes-Côte d'Azur;04;4;11;227;Vachères;283;7;290
93;Provence-Alpes-Côte d'Azur;04;1;01;120;Val d'Oronaye;121;1;122
93;Provence-Alpes-Côte d'Azur;04;2;02;043;Val-de-Chalvagne;87;3;90
93;Provence-Alpes-Côte d'Azur;04;4;13;228;Valavoire;40;0;40
93;Provence-Alpes-Côte d'Azur;04;4;14;229;Valbelle;278;7;285
93;Provence-Alpes-Côte d'Azur;04;4;15;230;Valensole;3204;59;3263
93;Provence-Alpes-Côte d'Azur;04;4;13;231;Valernes;250;6;256
93;Provence-Alpes-Côte d'Azur;04;4;13;233;Vaumeilh;262;9;271
93;Provence-Alpes-Côte d'Azur;04;4;13;234;Venterol;241;2;243
93;Provence-Alpes-Côte d'Azur;04;3;13;235;Verdaches;59;1;60
93;Provence-Alpes-Côte d'Azur;04;2;02;236;Vergons;111;0;111
93;Provence-Alpes-Côte d'Azur;04;3;13;237;Le Vernet;129;3;132
93;Provence-Alpes-Côte d'Azur;04;2;02;240;Villars-Colmars;246;4;250
93;Provence-Alpes-Côte d'Azur;04;4;11;241;Villemus;189;5;194
93;Provence-Alpes-Côte d'Azur;04;4;10;242;Villeneuve;4196;75;4271
93;Provence-Alpes-Côte d'Azur;04;3;03;244;Volonne;1650;37;1687
93;Provence-Alpes-Côte d'Azur;04;4;08;245;Volx;3171;75;3246
93;Provence-Alpes-Côte d'Azur;05;1;10;001;Abriès-Ristolas;385;8;393
93;Provence-Alpes-Côte d'Azur;05;1;10;003;Aiguilles;429;9;438
93;Provence-Alpes-Côte d'Azur;05;2;12;004;Ancelle;916;15;931
93;Provence-Alpes-Côte d'Azur;05;1;01;006;L' Argentière-la-Bessée;2279;86;2365
93;Provence-Alpes-Côte d'Azur;05;1;10;007;Arvieux;365;4;369
93;Provence-Alpes-Côte d'Azur;05;2;13;008;Aspremont;358;4;362
93;Provence-Alpes-Côte d'Azur;05;2;12;009;Aspres-lès-Corps;104;3;107
93;Provence-Alpes-Côte d'Azur;05;2;13;010;Aspres-sur-Buëch;821;10;831
93;Provence-Alpes-Côte d'Azur;05;2;12;039;Aubessagne;698;12;710
93;Provence-Alpes-Côte d'Azur;05;2;14;011;Avançon;404;9;413
93;Provence-Alpes-Côte d'Azur;05;2;05;012;Baratier;603;10;613
93;Provence-Alpes-Côte d'Azur;05;2;14;013;Barcillonnette;136;5;141
93;Provence-Alpes-Côte d'Azur;05;2;11;014;Barret-sur-Méouge;220;3;223
93;Provence-Alpes-Côte d'Azur;05;2;13;016;La Bâtie-Montsaléon;254;1;255
93;Provence-Alpes-Côte d'Azur;05;2;04;017;La Bâtie-Neuve;2534;51;2585
93;Provence-Alpes-Côte d'Azur;05;2;14;018;La Bâtie-Vieille;342;12;354
93;Provence-Alpes-Côte d'Azur;05;2;13;019;La Beaume;154;3;157
93;Provence-Alpes-Côte d'Azur;05;2;13;021;Le Bersac;148;0;148
93;Provence-Alpes-Côte d'Azur;05;2;04;022;Bréziers;230;3;233
93;Provence-Alpes-Côte d'Azur;05;1;98;023;Briançon;11625;325;11950
93;Provence-Alpes-Côte d'Azur;05;2;12;025;Buissard;208;7;215
93;Provence-Alpes-Côte d'Azur;05;1;10;026;Ceillac;292;3;295
93;Provence-Alpes-Côte d'Azur;05;1;02;027;Cervières;188;4;192
93;Provence-Alpes-Côte d'Azur;05;2;13;028;Chabestan;129;4;133
93;Provence-Alpes-Côte d'Azur;05;2;12;029;Chabottes;825;23;848
93;Provence-Alpes-Côte d'Azur;05;1;01;031;Champcella;188;2;190
93;Provence-Alpes-Côte d'Azur;05;2;12;032;Champoléon;140;3;143
93;Provence-Alpes-Côte d'Azur;05;2;13;033;Chanousse;39;0;39
93;Provence-Alpes-Côte d'Azur;05;2;12;064;La Chapelle-en-Valgaudémar;104;3;107
93;Provence-Alpes-Côte d'Azur;05;1;10;038;Château-Ville-Vieille;345;10;355
93;Provence-Alpes-Côte d'Azur;05;2;15;035;Châteauneuf-d'Oze;28;3;31
93;Provence-Alpes-Côte d'Azur;05;2;05;036;Châteauroux-les-Alpes;1197;32;1229
93;Provence-Alpes-Côte d'Azur;05;2;14;037;Châteauvieux;490;19;509
93;Provence-Alpes-Côte d'Azur;05;2;04;040;Chorges;2973;80;3053
93;Provence-Alpes-Côte d'Azur;05;2;05;044;Crévoux;130;3;133
93;Provence-Alpes-Côte d'Azur;05;2;05;045;Crots;1075;27;1102
93;Provence-Alpes-Côte d'Azur;05;2;15;139;Dévoluy;966;27;993
93;Provence-Alpes-Côte d'Azur;05;2;05;046;Embrun;6155;411;6566
93;Provence-Alpes-Côte d'Azur;05;2;11;047;Éourres;137;4;141
93;Provence-Alpes-Côte d'Azur;05;2;13;048;L' Épine;196;6;202
93;Provence-Alpes-Côte d'Azur;05;2;14;049;Esparron;51;0;51
93;Provence-Alpes-Côte d'Azur;05;2;04;050;Espinasses;796;10;806
93;Provence-Alpes-Côte d'Azur;05;2;13;051;Étoile-Saint-Cyrice;30;2;32
93;Provence-Alpes-Côte d'Azur;05;1;10;052;Eygliers;791;12;803
93;Provence-Alpes-Côte d'Azur;05;2;12;054;La Fare-en-Champsaur;438;3;441
93;Provence-Alpes-Côte d'Azur;05;2;13;055;La Faurie;325;4;329
93;Provence-Alpes-Côte d'Azur;05;2;12;056;Forest-Saint-Julien;328;11;339
93;Provence-Alpes-Côte d'Azur;05;2;14;057;Fouillouse;243;5;248
93;Provence-Alpes-Côte d'Azur;05;1;01;058;Freissinières;210;6;216
93;Provence-Alpes-Côte d'Azur;05;2;14;059;La Freissinouse;849;21;870
93;Provence-Alpes-Côte d'Azur;05;2;15;060;Furmeyer;163;8;171
93;Provence-Alpes-Côte d'Azur;05;2;99;061;Gap;40895;1592;42487
93;Provence-Alpes-Côte d'Azur;05;2;13;053;Garde-Colombe;539;9;548
93;Provence-Alpes-Côte d'Azur;05;2;12;062;Le Glaizil;166;1;167
93;Provence-Alpes-Côte d'Azur;05;1;02;063;La Grave;482;10;492
93;Provence-Alpes-Côte d'Azur;05;1;10;065;Guillestre;2344;83;2427
93;Provence-Alpes-Côte d'Azur;05;2;13;066;La Haute-Beaume;9;0;9
93;Provence-Alpes-Côte d'Azur;05;2;14;068;Jarjayes;450;13;463
93;Provence-Alpes-Côte d'Azur;05;2;11;070;Laragne-Montéglin;3511;57;3568
93;Provence-Alpes-Côte d'Azur;05;2;14;071;Lardier-et-Valença;332;20;352
93;Provence-Alpes-Côte d'Azur;05;2;12;072;Laye;234;7;241
93;Provence-Alpes-Côte d'Azur;05;2;11;073;Lazer;359;15;374
93;Provence-Alpes-Côte d'Azur;05;2;14;074;Lettret;182;0;182
93;Provence-Alpes-Côte d'Azur;05;2;15;075;Manteyer;429;7;436
93;Provence-Alpes-Côte d'Azur;05;2;13;076;Méreuil;84;3;87
93;Provence-Alpes-Côte d'Azur;05;1;10;077;Molines-en-Queyras;300;5;305
93;Provence-Alpes-Côte d'Azur;05;2;11;078;Monêtier-Allemont;283;11;294
93;Provence-Alpes-Côte d'Azur;05;1;02;079;Le Monêtier-les-Bains;1056;23;1079
93;Provence-Alpes-Côte d'Azur;05;1;10;082;Mont-Dauphin;164;2;166
93;Provence-Alpes-Côte d'Azur;05;2;13;080;Montbrand;62;0;62
93;Provence-Alpes-Côte d'Azur;05;2;13;081;Montclus;57;4;61
93;Provence-Alpes-Côte d'Azur;05;2;04;084;Montgardin;464;5;469
93;Provence-Alpes-Côte d'Azur;05;1;03;085;Montgenèvre;456;14;470
93;Provence-Alpes-Côte d'Azur;05;2;13;086;Montjay;104;2;106
93;Provence-Alpes-Côte d'Azur;05;2;15;087;Montmaur;512;15;527
93;Provence-Alpes-Côte d'Azur;05;2;13;089;Montrond;74;1;75
93;Provence-Alpes-Côte d'Azur;05;2;12;090;La Motte-en-Champsaur;217;6;223
93;Provence-Alpes-Côte d'Azur;05;2;13;091;Moydans;44;2;46
93;Provence-Alpes-Côte d'Azur;05;2;14;092;Neffes;748;16;764
93;Provence-Alpes-Côte d'Azur;05;1;03;093;Névache;356;11;367
93;Provence-Alpes-Côte d'Azur;05;2;13;094;Nossage-et-Bénévent;15;1;16
93;Provence-Alpes-Côte d'Azur;05;2;12;095;Le Noyer;292;4;296
93;Provence-Alpes-Côte d'Azur;05;2;12;096;Orcières;690;19;709
93;Provence-Alpes-Côte d'Azur;05;2;13;097;Orpierre;352;34;386
93;Provence-Alpes-Côte d'Azur;05;2;05;098;Les Orres;577;7;584
93;Provence-Alpes-Côte d'Azur;05;2;13;099;Oze;106;1;107
93;Provence-Alpes-Côte d'Azur;05;2;14;100;Pelleautier;715;25;740
93;Provence-Alpes-Côte d'Azur;05;2;13;102;La Piarre;93;2;95
93;Provence-Alpes-Côte d'Azur;05;2;11;103;Le Poët;798;21;819
93;Provence-Alpes-Côte d'Azur;05;2;12;104;Poligny;296;7;303
93;Provence-Alpes-Côte d'Azur;05;2;04;106;Prunières;298;6;304
93;Provence-Alpes-Côte d'Azur;05;1;02;107;Puy-Saint-André;462;25;487
93;Provence-Alpes-Côte d'Azur;05;2;04;108;Puy-Saint-Eusèbe;138;3;141
93;Provence-Alpes-Côte d'Azur;05;1;02;109;Puy-Saint-Pierre;538;20;558
93;Provence-Alpes-Côte d'Azur;05;1;01;110;Puy-Saint-Vincent;288;5;293
93;Provence-Alpes-Côte d'Azur;05;2;04;111;Puy-Sanières;283;9;292
93;Provence-Alpes-Côte d'Azur;05;2;15;112;Rabou;79;0;79
93;Provence-Alpes-Côte d'Azur;05;2;14;113;Rambaud;376;16;392
93;Provence-Alpes-Côte d'Azur;05;2;04;114;Réallon;256;4;260
93;Provence-Alpes-Côte d'Azur;05;2;04;115;Remollon;442;3;445
93;Provence-Alpes-Côte d'Azur;05;1;10;116;Réotier;200;2;202
93;Provence-Alpes-Côte d'Azur;05;2;13;117;Ribeyret;113;0;113
93;Provence-Alpes-Côte d'Azur;05;1;10;119;Risoul;644;14;658
93;Provence-Alpes-Côte d'Azur;05;1;01;122;La Roche-de-Rame;824;27;851
93;Provence-Alpes-Côte d'Azur;05;2;15;123;La Roche-des-Arnauds;1521;37;1558
93;Provence-Alpes-Côte d'Azur;05;2;04;121;Rochebrune;171;2;173
93;Provence-Alpes-Côte d'Azur;05;2;04;124;La Rochette;466;9;475
93;Provence-Alpes-Côte d'Azur;05;2;13;126;Rosans;468;11;479
93;Provence-Alpes-Côte d'Azur;05;2;04;127;Rousset;183;5;188
93;Provence-Alpes-Côte d'Azur;05;2;05;128;Saint-André-d'Embrun;661;22;683
93;Provence-Alpes-Côte d'Azur;05;2;13;129;Saint-André-de-Rosans;151;2;153
93;Provence-Alpes-Côte d'Azur;05;2;04;130;Saint-Apollinaire;141;5;146
93;Provence-Alpes-Côte d'Azur;05;2;13;131;Saint-Auban-d'Oze;90;1;91
93;Provence-Alpes-Côte d'Azur;05;2;12;132;Saint-Bonnet-en-Champsaur;2036;69;2105
93;Provence-Alpes-Côte d'Azur;05;1;02;133;Saint-Chaffrey;1604;49;1653
93;Provence-Alpes-Côte d'Azur;05;1;10;134;Saint-Clément-sur-Durance;309;4;313
93;Provence-Alpes-Côte d'Azur;05;1;10;136;Saint-Crépin;733;16;749
93;Provence-Alpes-Côte d'Azur;05;2;14;140;Saint-Étienne-le-Laus;284;7;291
93;Provence-Alpes-Côte d'Azur;05;2;12;142;Saint-Firmin;458;18;476
93;Provence-Alpes-Côte d'Azur;05;2;12;144;Saint-Jacques-en-Valgodemard;147;2;149
93;Provence-Alpes-Côte d'Azur;05;2;12;145;Saint-Jean-Saint-Nicolas;1041;99;1140
93;Provence-Alpes-Côte d'Azur;05;2;13;146;Saint-Julien-en-Beauchêne;127;1;128
93;Provence-Alpes-Côte d'Azur;05;2;12;147;Saint-Julien-en-Champsaur;360;5;365
93;Provence-Alpes-Côte d'Azur;05;2;12;148;Saint-Laurent-du-Cros;532;18;550
93;Provence-Alpes-Côte d'Azur;05;2;12;149;Saint-Léger-les-Mélèzes;350;11;361
93;Provence-Alpes-Côte d'Azur;05;1;01;151;Saint-Martin-de-Queyrières;1130;34;1164
93;Provence-Alpes-Côte d'Azur;05;2;12;152;Saint-Maurice-en-Valgodemard;127;4;131
93;Provence-Alpes-Côte d'Azur;05;2;12;153;Saint-Michel-de-Chaillol;335;13;348
93;Provence-Alpes-Côte d'Azur;05;2;11;155;Saint-Pierre-Avez;29;1;30
93;Provence-Alpes-Côte d'Azur;05;2;13;154;Saint-Pierre-d'Argençon;156;5;161
93;Provence-Alpes-Côte d'Azur;05;2;05;156;Saint-Sauveur;499;11;510
93;Provence-Alpes-Côte d'Azur;05;1;10;157;Saint-Véran;236;6;242
93;Provence-Alpes-Côte d'Azur;05;2;13;135;Sainte-Colombe;55;0;55
93;Provence-Alpes-Côte d'Azur;05;2;13;158;Le Saix;107;1;108
93;Provence-Alpes-Côte d'Azur;05;2;13;159;Saléon;91;3;94
93;Provence-Alpes-Côte d'Azur;05;2;11;160;Salérans;90;0;90
93;Provence-Alpes-Côte d'Azur;05;1;02;161;La Salle-les-Alpes;982;24;1006
93;Provence-Alpes-Côte d'Azur;05;2;14;162;La Saulce;1555;32;1587
93;Provence-Alpes-Côte d'Azur;05;2;04;163;Le Sauze-du-Lac;146;4;150
93;Provence-Alpes-Côte d'Azur;05;2;04;164;Savines-le-Lac;1058;40;1098
93;Provence-Alpes-Côte d'Azur;05;2;13;165;Savournon;259;7;266
93;Provence-Alpes-Côte d'Azur;05;2;13;166;Serres;1287;27;1314
93;Provence-Alpes-Côte d'Azur;05;2;13;167;Sigottier;92;0;92
93;Provence-Alpes-Côte d'Azur;05;2;14;168;Sigoyer;665;20;685
93;Provence-Alpes-Côte d'Azur;05;2;13;169;Sorbiers;36;1;37
93;Provence-Alpes-Côte d'Azur;05;2;14;170;Tallard;2206;46;2252
93;Provence-Alpes-Côte d'Azur;05;2;04;171;Théus;200;9;209
93;Provence-Alpes-Côte d'Azur;05;2;13;172;Trescléoux;317;6;323
93;Provence-Alpes-Côte d'Azur;05;2;11;173;Upaix;450;5;455
93;Provence-Alpes-Côte d'Azur;05;2;11;118;Val Buëch-Méouge;1349;26;1375
93;Provence-Alpes-Côte d'Azur;05;1;03;174;Val-des-Prés;641;25;666
93;Provence-Alpes-Côte d'Azur;05;2;13;024;Valdoule;216;9;225
93;Provence-Alpes-Côte d'Azur;05;1;01;101;Vallouise-Pelvoux;1210;40;1250
93;Provence-Alpes-Côte d'Azur;05;2;14;176;Valserres;261;3;264
93;Provence-Alpes-Côte d'Azur;05;1;10;177;Vars;525;10;535
93;Provence-Alpes-Côte d'Azur;05;2;11;178;Ventavon;575;37;612
93;Provence-Alpes-Côte d'Azur;05;2;15;179;Veynes;3182;149;3331
93;Provence-Alpes-Côte d'Azur;05;1;01;180;Les Vigneaux;534;14;548
93;Provence-Alpes-Côte d'Azur;05;1;02;181;Villar-d'Arêne;311;14;325
93;Provence-Alpes-Côte d'Azur;05;2;12;182;Villar-Loubière;41;3;44
93;Provence-Alpes-Côte d'Azur;05;1;02;183;Villar-Saint-Pancrace;1472;54;1526
93;Provence-Alpes-Côte d'Azur;05;2;14;184;Vitrolles;204;8;212
93;Provence-Alpes-Côte d'Azur;06;1;26;001;Aiglun;91;0;91
93;Provence-Alpes-Côte d'Azur;06;1;11;002;Amirat;67;0;67
93;Provence-Alpes-Côte d'Azur;06;1;11;003;Andon;620;5;625
93;Provence-Alpes-Côte d'Azur;06;1;94;004;Antibes;72999;1162;74161
93;Provence-Alpes-Côte d'Azur;06;2;26;005;Ascros;169;0;169
93;Provence-Alpes-Côte d'Azur;06;2;24;006;Aspremont;2187;31;2218
93;Provence-Alpes-Côte d'Azur;06;1;13;007;Auribeau-sur-Siagne;3249;63;3312
93;Provence-Alpes-Côte d'Azur;06;2;26;008;Auvare;31;2;33
93;Provence-Alpes-Côte d'Azur;06;2;26;009;Bairols;105;1;106
93;Provence-Alpes-Côte d'Azur;06;1;25;010;Le Bar-sur-Loup;2936;64;3000
93;Provence-Alpes-Côte d'Azur;06;2;04;011;Beaulieu-sur-Mer;3715;28;3743
93;Provence-Alpes-Côte d'Azur;06;2;04;012;Beausoleil;13607;137;13744
93;Provence-Alpes-Côte d'Azur;06;2;24;013;Belvédère;677;11;688
93;Provence-Alpes-Côte d'Azur;06;2;10;014;Bendejun;952;6;958
93;Provence-Alpes-Côte d'Azur;06;2;10;015;Berre-les-Alpes;1253;21;1274
93;Provence-Alpes-Côte d'Azur;06;2;26;016;Beuil;525;4;529
93;Provence-Alpes-Côte d'Azur;06;1;26;017;Bézaudun-les-Alpes;249;5;254
93;Provence-Alpes-Côte d'Azur;06;1;03;018;Biot;9733;351;10084
93;Provence-Alpes-Côte d'Azur;06;2;10;019;Blausasc;1583;19;1602
93;Provence-Alpes-Côte d'Azur;06;2;24;020;La Bollène-Vésubie;575;12;587
93;Provence-Alpes-Côte d'Azur;06;2;26;021;Bonson;737;5;742
93;Provence-Alpes-Côte d'Azur;06;1;26;022;Bouyon;538;4;542
93;Provence-Alpes-Côte d'Azur;06;2;10;023;Breil-sur-Roya;2158;52;2210
93;Provence-Alpes-Côte d'Azur;06;1;11;024;Briançonnet;221;2;223
93;Provence-Alpes-Côte d'Azur;06;2;10;162;La Brigue;700;10;710
93;Provence-Alpes-Côte d'Azur;06;1;17;025;Le Broc;1413;8;1421
93;Provence-Alpes-Côte d'Azur;06;1;11;026;Cabris;1324;26;1350
93;Provence-Alpes-Côte d'Azur;06;1;95;027;Cagnes-sur-Mer;50928;478;51406
93;Provence-Alpes-Côte d'Azur;06;1;11;028;Caille;426;5;431
93;Provence-Alpes-Côte d'Azur;06;1;96;029;Cannes;73868;818;74686
93;Provence-Alpes-Côte d'Azur;06;1;97;030;Le Cannet;41471;393;41864
93;Provence-Alpes-Côte d'Azur;06;2;10;031;Cantaron;1306;11;1317
93;Provence-Alpes-Côte d'Azur;06;2;04;032;Cap-d'Ail;4594;72;4666
93;Provence-Alpes-Côte d'Azur;06;1;17;033;Carros;12329;140;12469
93;Provence-Alpes-Côte d'Azur;06;2;24;034;Castagniers;1616;14;1630
93;Provence-Alpes-Côte d'Azur;06;2;14;035;Castellar;1100;9;1109
93;Provence-Alpes-Côte d'Azur;06;2;14;036;Castillon;367;7;374
93;Provence-Alpes-Côte d'Azur;06;1;25;037;Caussols;287;3;290
93;Provence-Alpes-Côte d'Azur;06;2;26;040;Châteauneuf-d'Entraunes;58;0;58
93;Provence-Alpes-Côte d'Azur;06;1;25;038;Châteauneuf-Grasse;3505;59;3564
93;Provence-Alpes-Côte d'Azur;06;2;10;039;Châteauneuf-Villevieille;922;9;931
93;Provence-Alpes-Côte d'Azur;06;1;25;041;Cipières;396;2;398
93;Provence-Alpes-Côte d'Azur;06;2;24;042;Clans;638;13;651
93;Provence-Alpes-Côte d'Azur;06;2;10;043;Coaraze;831;4;835
93;Provence-Alpes-Côte d'Azur;06;1;27;044;La Colle-sur-Loup;7838;153;7991
93;Provence-Alpes-Côte d'Azur;06;1;11;045;Collongues;78;2;80
93;Provence-Alpes-Côte d'Azur;06;2;24;046;Colomars;3424;41;3465
93;Provence-Alpes-Côte d'Azur;06;1;26;047;Conségudes;99;1;100
93;Provence-Alpes-Côte d'Azur;06;2;10;048;Contes;7424;88;7512
93;Provence-Alpes-Côte d'Azur;06;1;25;049;Courmes;120;1;121
93;Provence-Alpes-Côte d'Azur;06;1;26;050;Coursegoules;531;5;536
93;Provence-Alpes-Côte d'Azur;06;2;26;051;La Croix-sur-Roudoule;97;2;99
93;Provence-Alpes-Côte d'Azur;06;2;26;052;Cuébris;172;2;174
93;Provence-Alpes-Côte d'Azur;06;2;26;053;Daluis;146;2;148
93;Provence-Alpes-Côte d'Azur;06;2;10;054;Drap;4546;37;4583
93;Provence-Alpes-Côte d'Azur;06;2;24;055;Duranus;140;3;143
93;Provence-Alpes-Côte d'Azur;06;2;26;056;Entraunes;138;2;140
93;Provence-Alpes-Côte d'Azur;06;2;10;057;L' Escarène;2520;17;2537
93;Provence-Alpes-Côte d'Azur;06;1;11;058;Escragnolles;609;5;614
93;Provence-Alpes-Côte d'Azur;06;2;04;059;Èze;2239;58;2297
93;Provence-Alpes-Côte d'Azur;06;2;24;060;Falicon;1992;33;2025
93;Provence-Alpes-Côte d'Azur;06;1;26;061;Les Ferres;105;0;105
93;Provence-Alpes-Côte d'Azur;06;2;10;062;Fontan;341;1;342
93;Provence-Alpes-Côte d'Azur;06;1;11;063;Gars;72;0;72
93;Provence-Alpes-Côte d'Azur;06;1;17;064;Gattières;4117;54;4171
93;Provence-Alpes-Côte d'Azur;06;1;06;065;La Gaude;6623;95;6718
93;Provence-Alpes-Côte d'Azur;06;2;26;066;Gilette;1596;11;1607
93;Provence-Alpes-Côte d'Azur;06;2;14;067;Gorbio;1549;14;1563
93;Provence-Alpes-Côte d'Azur;06;1;25;068;Gourdon;381;10;391
93;Provence-Alpes-Côte d'Azur;06;1;98;069;Grasse;50396;946;51342
93;Provence-Alpes-Côte d'Azur;06;1;25;070;Gréolières;586;13;599
93;Provence-Alpes-Côte d'Azur;06;2;26;071;Guillaumes;631;6;637
93;Provence-Alpes-Côte d'Azur;06;2;24;072;Ilonse;193;0;193
93;Provence-Alpes-Côte d'Azur;06;2;24;073;Isola;681;12;693
93;Provence-Alpes-Côte d'Azur;06;2;24;074;Lantosque;1312;10;1322
93;Provence-Alpes-Côte d'Azur;06;2;24;075;Levens;4738;46;4784
93;Provence-Alpes-Côte d'Azur;06;2;26;076;Lieuche;46;3;49
93;Provence-Alpes-Côte d'Azur;06;2;10;077;Lucéram;1284;12;1296
93;Provence-Alpes-Côte d'Azur;06;2;26;078;Malaussène;311;0;311
93;Provence-Alpes-Côte d'Azur;06;1;13;079;Mandelieu-la-Napoule;22452;263;22715
93;Provence-Alpes-Côte d'Azur;06;2;24;080;Marie;105;4;109
93;Provence-Alpes-Côte d'Azur;06;1;11;081;Le Mas;155;0;155
93;Provence-Alpes-Côte d'Azur;06;2;26;082;Massoins;102;1;103
93;Provence-Alpes-Côte d'Azur;06;2;14;083;Menton;28958;503;29461
93;Provence-Alpes-Côte d'Azur;06;1;12;084;Mouans-Sartoux;9701;318;10019
93;Provence-Alpes-Côte d'Azur;06;1;09;085;Mougins;19473;392;19865
93;Provence-Alpes-Côte d'Azur;06;2;10;086;Moulinet;273;4;277
93;Provence-Alpes-Côte d'Azur;06;1;11;087;Les Mujouls;51;1;52
93;Provence-Alpes-Côte d'Azur;06;2;99;088;Nice;340017;2962;342979
93;Provence-Alpes-Côte d'Azur;06;1;25;089;Opio;2214;72;2286
93;Provence-Alpes-Côte d'Azur;06;1;13;090;Pégomas;7972;88;8060
93;Provence-Alpes-Côte d'Azur;06;2;10;091;Peille;2376;19;2395
93;Provence-Alpes-Côte d'Azur;06;2;10;092;Peillon;1457;13;1470
93;Provence-Alpes-Côte d'Azur;06;2;26;093;La Penne;221;1;222
93;Provence-Alpes-Côte d'Azur;06;2;26;094;Péone;787;8;795
93;Provence-Alpes-Côte d'Azur;06;1;11;095;Peymeinade;8151;143;8294
93;Provence-Alpes-Côte d'Azur;06;2;26;096;Pierlas;103;0;103
93;Provence-Alpes-Côte d'Azur;06;2;26;097;Pierrefeu;324;0;324
93;Provence-Alpes-Côte d'Azur;06;2;26;098;Puget-Rostang;129;1;130
93;Provence-Alpes-Côte d'Azur;06;2;26;099;Puget-Théniers;1880;65;1945
93;Provence-Alpes-Côte d'Azur;06;2;26;100;Revest-les-Roches;235;1;236
93;Provence-Alpes-Côte d'Azur;06;2;26;101;Rigaud;211;3;214
93;Provence-Alpes-Côte d'Azur;06;2;24;102;Rimplas;91;5;96
93;Provence-Alpes-Côte d'Azur;06;1;26;107;La Roque-en-Provence;77;1;78
93;Provence-Alpes-Côte d'Azur;06;2;24;103;Roquebillière;1841;49;1890
93;Provence-Alpes-Côte d'Azur;06;2;14;104;Roquebrune-Cap-Martin;12639;187;12826
93;Provence-Alpes-Côte d'Azur;06;1;27;105;Roquefort-les-Pins;6762;180;6942
93;Provence-Alpes-Côte d'Azur;06;2;26;106;Roquestéron;581;6;587
93;Provence-Alpes-Côte d'Azur;06;1;13;108;La Roquette-sur-Siagne;5390;94;5484
93;Provence-Alpes-Côte d'Azur;06;2;24;109;La Roquette-sur-Var;940;4;944
93;Provence-Alpes-Côte d'Azur;06;2;24;110;Roubion;121;4;125
93;Provence-Alpes-Côte d'Azur;06;2;24;111;Roure;173;4;177
93;Provence-Alpes-Côte d'Azur;06;1;25;112;Le Rouret;3999;119;4118
93;Provence-Alpes-Côte d'Azur;06;2;21;114;Saint-André-de-la-Roche;5458;29;5487
93;Provence-Alpes-Côte d'Azur;06;2;26;115;Saint-Antonin;93;0;93
93;Provence-Alpes-Côte d'Azur;06;1;11;116;Saint-Auban;222;3;225
93;Provence-Alpes-Côte d'Azur;06;2;24;117;Saint-Blaise;1019;8;1027
93;Provence-Alpes-Côte d'Azur;06;1;11;118;Saint-Cézaire-sur-Siagne;3908;99;4007
93;Provence-Alpes-Côte d'Azur;06;2;24;119;Saint-Dalmas-le-Selvage;118;2;120
93;Provence-Alpes-Côte d'Azur;06;2;24;120;Saint-Étienne-de-Tinée;1531;160;1691
93;Provence-Alpes-Côte d'Azur;06;2;04;121;Saint-Jean-Cap-Ferrat;1573;8;1581
93;Provence-Alpes-Côte d'Azur;06;1;26;122;Saint-Jeannet;4128;106;4234
93;Provence-Alpes-Côte d'Azur;06;1;06;123;Saint-Laurent-du-Var;28453;203;28656
93;Provence-Alpes-Côte d'Azur;06;2;26;124;Saint-Léger;51;0;51
93;Provence-Alpes-Côte d'Azur;06;2;26;125;Saint-Martin-d'Entraunes;142;2;144
93;Provence-Alpes-Côte d'Azur;06;2;24;126;Saint-Martin-du-Var;3000;20;3020
93;Provence-Alpes-Côte d'Azur;06;2;24;127;Saint-Martin-Vésubie;1411;12;1423
93;Provence-Alpes-Côte d'Azur;06;1;27;128;Saint-Paul-de-Vence;3477;72;3549
93;Provence-Alpes-Côte d'Azur;06;2;24;129;Saint-Sauveur-sur-Tinée;308;82;390
93;Provence-Alpes-Côte d'Azur;06;1;11;130;Saint-Vallier-de-Thiey;3594;103;3697
93;Provence-Alpes-Côte d'Azur;06;2;14;113;Sainte-Agnès;1328;24;1352
93;Provence-Alpes-Côte d'Azur;06;1;26;131;Sallagriffon;49;2;51
93;Provence-Alpes-Côte d'Azur;06;2;10;132;Saorge;459;10;469
93;Provence-Alpes-Côte d'Azur;06;2;26;133;Sauze;70;1;71
93;Provence-Alpes-Côte d'Azur;06;1;11;134;Séranon;526;6;532
93;Provence-Alpes-Côte d'Azur;06;2;26;135;Sigale;198;2;200
93;Provence-Alpes-Côte d'Azur;06;2;10;136;Sospel;3831;70;3901
93;Provence-Alpes-Côte d'Azur;06;1;11;137;Spéracèdes;1264;26;1290
93;Provence-Alpes-Côte d'Azur;06;2;10;163;Tende;2178;49;2227
93;Provence-Alpes-Côte d'Azur;06;1;13;138;Théoule-sur-Mer;1413;14;1427
93;Provence-Alpes-Côte d'Azur;06;2;26;139;Thiéry;106;3;109
93;Provence-Alpes-Côte d'Azur;06;1;11;140;Le Tignet;3146;54;3200
93;Provence-Alpes-Côte d'Azur;06;2;26;141;Toudon;344;1;345
93;Provence-Alpes-Côte d'Azur;06;2;10;142;Touët-de-l'Escarène;282;1;283
93;Provence-Alpes-Côte d'Azur;06;2;26;143;Touët-sur-Var;672;11;683
93;Provence-Alpes-Côte d'Azur;06;2;26;144;La Tour;567;4;571
93;Provence-Alpes-Côte d'Azur;06;2;26;145;Tourette-du-Château;130;1;131
93;Provence-Alpes-Côte d'Azur;06;2;26;146;Tournefort;167;1;168
93;Provence-Alpes-Côte d'Azur;06;2;24;147;Tourrette-Levens;4951;46;4997
93;Provence-Alpes-Côte d'Azur;06;1;25;148;Tourrettes-sur-Loup;3999;79;4078
93;Provence-Alpes-Côte d'Azur;06;2;21;149;La Trinité;10017;60;10077
93;Provence-Alpes-Côte d'Azur;06;2;04;150;La Turbie;3063;55;3118
93;Provence-Alpes-Côte d'Azur;06;2;24;151;Utelle;873;1;874
93;Provence-Alpes-Côte d'Azur;06;1;25;152;Valbonne;13325;525;13850
93;Provence-Alpes-Côte d'Azur;06;2;24;153;Valdeblore;853;254;1107
93;Provence-Alpes-Côte d'Azur;06;1;11;154;Valderoure;452;8;460
93;Provence-Alpes-Côte d'Azur;06;1;01;155;Vallauris;26672;162;26834
93;Provence-Alpes-Côte d'Azur;06;2;24;156;Venanson;159;1;160
93;Provence-Alpes-Côte d'Azur;06;1;26;157;Vence;18465;304;18769
93;Provence-Alpes-Côte d'Azur;06;2;26;158;Villars-sur-Var;761;4;765
93;Provence-Alpes-Côte d'Azur;06;2;04;159;Villefranche-sur-Mer;5091;48;5139
93;Provence-Alpes-Côte d'Azur;06;2;26;160;Villeneuve-d'Entraunes;80;0;80
93;Provence-Alpes-Côte d'Azur;06;1;27;161;Villeneuve-Loubet;15241;184;15425
84;Auvergne-Rhône-Alpes;07;3;06;001;Accons;382;25;407
84;Auvergne-Rhône-Alpes;07;1;04;002;Ailhon;554;18;572
84;Auvergne-Rhône-Alpes;07;1;03;003;Aizac;169;4;173
84;Auvergne-Rhône-Alpes;07;2;10;004;Ajoux;77;2;79
84;Auvergne-Rhône-Alpes;07;2;12;005;Alba-la-Romaine;1444;35;1479
84;Auvergne-Rhône-Alpes;07;3;06;006;Albon-d'Ardèche;159;7;166
84;Auvergne-Rhône-Alpes;07;3;08;007;Alboussière;1004;14;1018
84;Auvergne-Rhône-Alpes;07;2;10;008;Alissas;1479;55;1534
84;Auvergne-Rhône-Alpes;07;3;11;009;Andance;1185;21;1206
84;Auvergne-Rhône-Alpes;07;3;98;010;Annonay;16345;611;16956
84;Auvergne-Rhône-Alpes;07;3;06;012;Arcens;376;9;385
84;Auvergne-Rhône-Alpes;07;3;08;013;Ardoix;1262;11;1273
84;Auvergne-Rhône-Alpes;07;3;08;014;Arlebosc;331;7;338
84;Auvergne-Rhône-Alpes;07;3;11;015;Arras-sur-Rhône;520;22;542
84;Auvergne-Rhône-Alpes;07;1;16;017;Les Assions;740;17;757
84;Auvergne-Rhône-Alpes;07;1;13;018;Astet;42;0;42
84;Auvergne-Rhône-Alpes;07;1;99;019;Aubenas;12172;761;12933
84;Auvergne-Rhône-Alpes;07;2;12;020;Aubignas;469;11;480
84;Auvergne-Rhône-Alpes;07;2;09;022;Baix;1164;25;1189
84;Auvergne-Rhône-Alpes;07;1;15;023;Balazuc;377;4;381
84;Auvergne-Rhône-Alpes;07;1;16;024;Banne;666;24;690
84;Auvergne-Rhône-Alpes;07;1;13;025;Barnas;207;2;209
84;Auvergne-Rhône-Alpes;07;1;13;026;Le Béage;255;8;263
84;Auvergne-Rhône-Alpes;07;2;17;027;Beauchastel;1822;29;1851
84;Auvergne-Rhône-Alpes;07;1;16;028;Beaulieu;498;15;513
84;Auvergne-Rhône-Alpes;07;1;16;029;Beaumont;244;3;247
84;Auvergne-Rhône-Alpes;07;2;06;030;Beauvène;210;5;215
84;Auvergne-Rhône-Alpes;07;3;06;165;Belsentes;550;18;568
84;Auvergne-Rhône-Alpes;07;1;16;031;Berrias-et-Casteljau;762;18;780
84;Auvergne-Rhône-Alpes;07;1;12;032;Berzème;174;1;175
84;Auvergne-Rhône-Alpes;07;1;15;033;Bessas;216;4;220
84;Auvergne-Rhône-Alpes;07;2;05;034;Bidon;241;2;243
84;Auvergne-Rhône-Alpes;07;3;17;035;Boffres;633;20;653
84;Auvergne-Rhône-Alpes;07;3;11;036;Bogy;434;11;445
84;Auvergne-Rhône-Alpes;07;1;06;037;Borée;151;3;154
84;Auvergne-Rhône-Alpes;07;1;13;038;Borne;51;0;51
84;Auvergne-Rhône-Alpes;07;3;14;040;Boucieu-le-Roi;269;5;274
84;Auvergne-Rhône-Alpes;07;3;01;041;Boulieu-lès-Annonay;2300;65;2365
84;Auvergne-Rhône-Alpes;07;2;05;042;Bourg-Saint-Andéol;7116;162;7278
84;Auvergne-Rhône-Alpes;07;3;08;039;Bozas;245;9;254
84;Auvergne-Rhône-Alpes;07;3;11;044;Brossainc;279;5;284
84;Auvergne-Rhône-Alpes;07;1;13;045;Burzet;439;6;445
84;Auvergne-Rhône-Alpes;07;1;13;047;Cellier-du-Luc;77;0;77
84;Auvergne-Rhône-Alpes;07;2;06;048;Chalencon;311;7;318
84;Auvergne-Rhône-Alpes;07;3;06;049;Le Chambon;46;3;49
84;Auvergne-Rhône-Alpes;07;1;16;050;Chambonas;905;15;920
84;Auvergne-Rhône-Alpes;07;3;11;051;Champagne;598;20;618
84;Auvergne-Rhône-Alpes;07;3;08;052;Champis;623;9;632
84;Auvergne-Rhône-Alpes;07;1;16;053;Chandolas;506;4;510
84;Auvergne-Rhône-Alpes;07;3;06;054;Chanéac;256;9;265
84;Auvergne-Rhône-Alpes;07;3;17;055;Charmes-sur-Rhône;2930;73;3003
84;Auvergne-Rhône-Alpes;07;3;11;056;Charnas;931;7;938
84;Auvergne-Rhône-Alpes;07;1;15;058;Chassiers;1022;34;1056
84;Auvergne-Rhône-Alpes;07;3;07;059;Châteaubourg;244;7;251
84;Auvergne-Rhône-Alpes;07;2;17;060;Châteauneuf-de-Vernoux;249;5;254
84;Auvergne-Rhône-Alpes;07;1;15;061;Chauzon;386;12;398
84;Auvergne-Rhône-Alpes;07;1;15;062;Chazeaux;139;3;142
84;Auvergne-Rhône-Alpes;07;3;14;063;Cheminas;402;9;411
84;Auvergne-Rhône-Alpes;07;3;06;064;Le Cheylard;2952;156;3108
84;Auvergne-Rhône-Alpes;07;1;13;065;Chirols;241;3;244
84;Auvergne-Rhône-Alpes;07;2;10;066;Chomérac;3030;175;3205
84;Auvergne-Rhône-Alpes;07;3;11;067;Colombier-le-Cardinal;292;4;296
84;Auvergne-Rhône-Alpes;07;3;14;068;Colombier-le-Jeune;573;6;579
84;Auvergne-Rhône-Alpes;07;3;08;069;Colombier-le-Vieux;661;20;681
84;Auvergne-Rhône-Alpes;07;3;07;070;Cornas;2237;47;2284
84;Auvergne-Rhône-Alpes;07;1;13;071;Coucouron;802;13;815
84;Auvergne-Rhône-Alpes;07;2;10;072;Coux;1642;42;1684
84;Auvergne-Rhône-Alpes;07;3;08;073;Le Crestet;519;11;530
84;Auvergne-Rhône-Alpes;07;2;10;074;Creysseilles;147;2;149
84;Auvergne-Rhône-Alpes;07;1;13;075;Cros-de-Géorand;159;4;163
84;Auvergne-Rhône-Alpes;07;2;09;076;Cruas;3008;66;3074
84;Auvergne-Rhône-Alpes;07;1;12;077;Darbres;248;3;251
84;Auvergne-Rhône-Alpes;07;3;01;078;Davézieux;3162;87;3249
84;Auvergne-Rhône-Alpes;07;3;08;079;Désaignes;1111;20;1131
84;Auvergne-Rhône-Alpes;07;3;06;080;Devesset;295;7;302
84;Auvergne-Rhône-Alpes;07;1;16;081;Dompnac;62;1;63
84;Auvergne-Rhône-Alpes;07;3;06;082;Dornas;207;12;219
84;Auvergne-Rhône-Alpes;07;2;06;083;Dunière-sur-Eyrieux;431;11;442
84;Auvergne-Rhône-Alpes;07;3;11;084;Eclassan;1025;39;1064
84;Auvergne-Rhône-Alpes;07;3;08;085;Empurany;598;14;612
84;Auvergne-Rhône-Alpes;07;3;14;086;Étables;906;18;924
84;Auvergne-Rhône-Alpes;07;1;13;087;Fabras;410;5;415
84;Auvergne-Rhône-Alpes;07;1;16;088;Faugères;100;2;102
84;Auvergne-Rhône-Alpes;07;3;11;089;Félines;1652;46;1698
84;Auvergne-Rhône-Alpes;07;2;10;090;Flaviac;1223;17;1240
84;Auvergne-Rhône-Alpes;07;1;04;091;Fons;329;12;341
84;Auvergne-Rhône-Alpes;07;2;10;092;Freyssenet;47;1;48
84;Auvergne-Rhône-Alpes;07;1;03;093;Genestelle;276;7;283
84;Auvergne-Rhône-Alpes;07;2;17;094;Gilhac-et-Bruzac;170;3;173
84;Auvergne-Rhône-Alpes;07;3;08;095;Gilhoc-sur-Ormèze;455;3;458
84;Auvergne-Rhône-Alpes;07;2;06;096;Gluiras;369;3;372
84;Auvergne-Rhône-Alpes;07;3;14;097;Glun;696;19;715
84;Auvergne-Rhône-Alpes;07;2;10;098;Gourdon;88;4;92
84;Auvergne-Rhône-Alpes;07;2;05;099;Gras;635;19;654
84;Auvergne-Rhône-Alpes;07;1;16;100;Gravières;474;11;485
84;Auvergne-Rhône-Alpes;07;1;15;101;Grospierres;885;22;907
84;Auvergne-Rhône-Alpes;07;3;07;102;Guilherand-Granges;10961;243;11204
84;Auvergne-Rhône-Alpes;07;3;06;104;Issamoulenc;91;3;94
84;Auvergne-Rhône-Alpes;07;1;13;105;Issanlas;102;3;105
84;Auvergne-Rhône-Alpes;07;1;13;106;Issarlès;145;2;147
84;Auvergne-Rhône-Alpes;07;1;13;107;Jaujac;1228;22;1250
84;Auvergne-Rhône-Alpes;07;3;06;108;Jaunac;127;9;136
84;Auvergne-Rhône-Alpes;07;1;15;109;Joannas;302;7;309
84;Auvergne-Rhône-Alpes;07;1;16;110;Joyeuse;1721;29;1750
84;Auvergne-Rhône-Alpes;07;1;03;111;Juvinas;172;4;176
84;Auvergne-Rhône-Alpes;07;1;15;113;Labastide-de-Virac;301;7;308
84;Auvergne-Rhône-Alpes;07;1;03;112;Labastide-sur-Bésorgues;258;6;264
84;Auvergne-Rhône-Alpes;07;3;08;114;Labatie-d'Andaure;206;2;208
84;Auvergne-Rhône-Alpes;07;1;15;115;Labeaume;677;11;688
84;Auvergne-Rhône-Alpes;07;1;03;116;Labégude;1393;19;1412
84;Auvergne-Rhône-Alpes;07;1;16;117;Lablachère;2143;35;2178
84;Auvergne-Rhône-Alpes;07;1;16;118;Laboule;137;6;143
84;Auvergne-Rhône-Alpes;07;1;13;119;Le Lac-d'Issarlès;286;6;292
84;Auvergne-Rhône-Alpes;07;1;03;120;Lachamp-Raphaël;63;0;63
84;Auvergne-Rhône-Alpes;07;1;13;121;Lachapelle-Graillouse;199;0;199
84;Auvergne-Rhône-Alpes;07;1;04;122;Lachapelle-sous-Aubenas;1604;44;1648
84;Auvergne-Rhône-Alpes;07;3;06;123;Lachapelle-sous-Chanéac;172;3;175
84;Auvergne-Rhône-Alpes;07;3;08;124;Lafarre;39;1;40
84;Auvergne-Rhône-Alpes;07;1;15;126;Lagorce;1160;23;1183
84;Auvergne-Rhône-Alpes;07;1;13;127;Lalevade-d'Ardèche;1107;15;1122
84;Auvergne-Rhône-Alpes;07;3;08;128;Lalouvesc;386;5;391
84;Auvergne-Rhône-Alpes;07;3;08;129;Lamastre;2318;68;2386
84;Auvergne-Rhône-Alpes;07;1;13;130;Lanarce;200;2;202
84;Auvergne-Rhône-Alpes;07;1;04;131;Lanas;430;35;465
84;Auvergne-Rhône-Alpes;07;1;15;132;Largentière;1629;68;1697
84;Auvergne-Rhône-Alpes;07;2;05;133;Larnas;238;3;241
84;Auvergne-Rhône-Alpes;07;1;15;134;Laurac-en-Vivarais;995;25;1020
84;Auvergne-Rhône-Alpes;07;1;13;136;Laveyrune;107;1;108
84;Auvergne-Rhône-Alpes;07;1;13;137;Lavillatte;57;0;57
84;Auvergne-Rhône-Alpes;07;1;12;138;Lavilledieu;2122;42;2164
84;Auvergne-Rhône-Alpes;07;1;03;139;Laviolle;109;2;111
84;Auvergne-Rhône-Alpes;07;3;14;140;Lemps;785;24;809
84;Auvergne-Rhône-Alpes;07;1;04;141;Lentillères;231;7;238
84;Auvergne-Rhône-Alpes;07;1;13;142;Lespéron;320;7;327
84;Auvergne-Rhône-Alpes;07;3;11;143;Limony;758;18;776
84;Auvergne-Rhône-Alpes;07;1;16;144;Loubaresse;41;2;43
84;Auvergne-Rhône-Alpes;07;1;12;145;Lussas;1159;25;1184
84;Auvergne-Rhône-Alpes;07;2;10;146;Lyas;601;15;616
84;Auvergne-Rhône-Alpes;07;1;16;147;Malarce-sur-la-Thines;244;5;249
84;Auvergne-Rhône-Alpes;07;1;16;148;Malbosc;145;8;153
84;Auvergne-Rhône-Alpes;07;2;06;149;Marcols-les-Eaux;296;5;301
84;Auvergne-Rhône-Alpes;07;3;06;150;Mariac;572;20;592
84;Auvergne-Rhône-Alpes;07;3;06;151;Mars;264;7;271
84;Auvergne-Rhône-Alpes;07;3;14;152;Mauves;1177;26;1203
84;Auvergne-Rhône-Alpes;07;1;13;153;Mayres;262;5;267
84;Auvergne-Rhône-Alpes;07;1;13;154;Mazan-l'Abbaye;122;1;123
84;Auvergne-Rhône-Alpes;07;1;04;155;Mercuer;1210;47;1257
84;Auvergne-Rhône-Alpes;07;1;13;156;Meyras;938;29;967
84;Auvergne-Rhône-Alpes;07;2;09;157;Meysse;1319;15;1334
84;Auvergne-Rhône-Alpes;07;1;03;158;Mézilhac;95;0;95
84;Auvergne-Rhône-Alpes;07;1;12;159;Mirabel;654;13;667
84;Auvergne-Rhône-Alpes;07;3;02;160;Monestier;61;1;62
84;Auvergne-Rhône-Alpes;07;1;13;161;Montpezat-sous-Bauzon;797;23;820
84;Auvergne-Rhône-Alpes;07;1;15;162;Montréal;572;19;591
84;Auvergne-Rhône-Alpes;07;1;16;163;Montselgues;82;7;89
84;Auvergne-Rhône-Alpes;07;3;08;166;Nozières;258;5;263
84;Auvergne-Rhône-Alpes;07;2;06;167;Les Ollières-sur-Eyrieux;990;19;1009
84;Auvergne-Rhône-Alpes;07;1;15;168;Orgnac-l'Aven;585;17;602
84;Auvergne-Rhône-Alpes;07;3;11;169;Ozon;398;2;400
84;Auvergne-Rhône-Alpes;07;3;08;170;Pailharès;244;6;250
84;Auvergne-Rhône-Alpes;07;1;16;171;Payzac;536;6;542
84;Auvergne-Rhône-Alpes;07;3;11;172;Peaugres;2148;48;2196
84;Auvergne-Rhône-Alpes;07;1;13;173;Péreyres;49;0;49
84;Auvergne-Rhône-Alpes;07;3;11;174;Peyraud;495;6;501
84;Auvergne-Rhône-Alpes;07;1;13;175;Le Plagnal;77;1;78
84;Auvergne-Rhône-Alpes;07;1;16;176;Planzolles;135;2;137
84;Auvergne-Rhône-Alpes;07;3;14;177;Plats;854;14;868
84;Auvergne-Rhône-Alpes;07;1;13;178;Pont-de-Labeaume;571;14;585
84;Auvergne-Rhône-Alpes;07;2;10;179;Pourchères;131;2;133
84;Auvergne-Rhône-Alpes;07;2;09;181;Le Pouzin;2879;39;2918
84;Auvergne-Rhône-Alpes;07;1;13;182;Prades;1213;31;1244
84;Auvergne-Rhône-Alpes;07;1;15;183;Pradons;470;10;480
84;Auvergne-Rhône-Alpes;07;2;10;184;Pranles;491;13;504
84;Auvergne-Rhône-Alpes;07;3;08;185;Préaux;690;15;705
84;Auvergne-Rhône-Alpes;07;2;10;186;Privas;8266;340;8606
84;Auvergne-Rhône-Alpes;07;1;15;187;Prunet;132;4;136
84;Auvergne-Rhône-Alpes;07;3;08;188;Quintenas;1630;36;1666
84;Auvergne-Rhône-Alpes;07;1;16;189;Ribes;295;4;299
84;Auvergne-Rhône-Alpes;07;1;15;190;Rochecolombe;211;5;216
84;Auvergne-Rhône-Alpes;07;2;09;191;Rochemaure;2281;49;2330
84;Auvergne-Rhône-Alpes;07;3;06;192;Rochepaule;259;8;267
84;Auvergne-Rhône-Alpes;07;1;15;193;Rocher;270;4;274
84;Auvergne-Rhône-Alpes;07;2;10;194;Rochessauve;450;10;460
84;Auvergne-Rhône-Alpes;07;1;06;195;La Rochette;59;2;61
84;Auvergne-Rhône-Alpes;07;1;16;196;Rocles;249;4;253
84;Auvergne-Rhône-Alpes;07;3;02;197;Roiffieux;2785;85;2870
84;Auvergne-Rhône-Alpes;07;2;09;198;Rompon;1083;29;1112
84;Auvergne-Rhône-Alpes;07;1;16;199;Rosières;1190;39;1229
84;Auvergne-Rhône-Alpes;07;1;13;200;Le Roux;53;1;54
84;Auvergne-Rhône-Alpes;07;1;15;201;Ruoms;2253;28;2281
84;Auvergne-Rhône-Alpes;07;1;16;202;Sablières;164;4;168
84;Auvergne-Rhône-Alpes;07;1;13;203;Sagnes-et-Goudoulet;117;0;117
84;Auvergne-Rhône-Alpes;07;3;06;204;Saint-Agrève;2353;63;2416
84;Auvergne-Rhône-Alpes;07;1;15;207;Saint-Alban-Auriolles;1091;16;1107
84;Auvergne-Rhône-Alpes;07;3;08;205;Saint-Alban-d'Ay;1397;23;1420
84;Auvergne-Rhône-Alpes;07;1;13;206;Saint-Alban-en-Montagne;93;1;94
84;Auvergne-Rhône-Alpes;07;1;12;208;Saint-Andéol-de-Berg;123;3;126
84;Auvergne-Rhône-Alpes;07;3;06;209;Saint-Andéol-de-Fourchades;53;2;55
84;Auvergne-Rhône-Alpes;07;1;03;210;Saint-Andéol-de-Vals;526;11;537
84;Auvergne-Rhône-Alpes;07;1;16;211;Saint-André-de-Cruzières;464;14;478
84;Auvergne-Rhône-Alpes;07;3;06;212;Saint-André-en-Vivarais;213;3;216
84;Auvergne-Rhône-Alpes;07;1;16;213;Saint-André-Lachamp;154;1;155
84;Auvergne-Rhône-Alpes;07;2;17;214;Saint-Apollinaire-de-Rias;201;2;203
84;Auvergne-Rhône-Alpes;07;3;08;216;Saint-Barthélemy-Grozon;506;25;531
84;Auvergne-Rhône-Alpes;07;3;06;215;Saint-Barthélemy-le-Meil;195;6;201
84;Auvergne-Rhône-Alpes;07;3;14;217;Saint-Barthélemy-le-Plain;825;20;845
84;Auvergne-Rhône-Alpes;07;3;08;218;Saint-Basile;353;10;363
84;Auvergne-Rhône-Alpes;07;2;09;219;Saint-Bauzile;308;6;314
84;Auvergne-Rhône-Alpes;07;3;06;220;Saint-Christol;103;0;103
84;Auvergne-Rhône-Alpes;07;2;17;221;Saint-Cierge-la-Serre;249;4;253
84;Auvergne-Rhône-Alpes;07;3;06;222;Saint-Cierge-sous-le-Cheylard;203;5;208
84;Auvergne-Rhône-Alpes;07;1;13;223;Saint-Cirgues-de-Prades;140;5;145
84;Auvergne-Rhône-Alpes;07;1;13;224;Saint-Cirgues-en-Montagne;210;16;226
84;Auvergne-Rhône-Alpes;07;3;01;225;Saint-Clair;1119;42;1161
84;Auvergne-Rhône-Alpes;07;3;06;226;Saint-Clément;86;0;86
84;Auvergne-Rhône-Alpes;07;3;01;227;Saint-Cyr;1372;46;1418
84;Auvergne-Rhône-Alpes;07;3;11;228;Saint-Désirat;877;25;902
84;Auvergne-Rhône-Alpes;07;1;04;229;Saint-Didier-sous-Aubenas;961;26;987
84;Auvergne-Rhône-Alpes;07;1;04;230;Saint-Étienne-de-Boulogne;404;14;418
84;Auvergne-Rhône-Alpes;07;1;04;231;Saint-Étienne-de-Fontbellon;2717;81;2798
84;Auvergne-Rhône-Alpes;07;1;13;232;Saint-Étienne-de-Lugdarès;419;8;427
84;Auvergne-Rhône-Alpes;07;2;06;233;Saint-Étienne-de-Serre;221;5;226
84;Auvergne-Rhône-Alpes;07;3;11;234;Saint-Étienne-de-Valoux;294;3;297
84;Auvergne-Rhône-Alpes;07;3;08;236;Saint-Félicien;1191;20;1211
84;Auvergne-Rhône-Alpes;07;2;17;237;Saint-Fortunat-sur-Eyrieux;775;14;789
84;Auvergne-Rhône-Alpes;07;1;16;238;Saint-Genest-de-Beauzon;318;7;325
84;Auvergne-Rhône-Alpes;07;3;06;239;Saint-Genest-Lachamp;104;2;106
84;Auvergne-Rhône-Alpes;07;3;17;240;Saint-Georges-les-Bains;2282;42;2324
84;Auvergne-Rhône-Alpes;07;1;12;241;Saint-Germain;710;17;727
84;Auvergne-Rhône-Alpes;07;1;12;242;Saint-Gineis-en-Coiron;115;4;119
84;Auvergne-Rhône-Alpes;07;3;11;243;Saint-Jacques-d'Atticieux;309;6;315
84;Auvergne-Rhône-Alpes;07;2;17;244;Saint-Jean-Chambre;265;5;270
84;Auvergne-Rhône-Alpes;07;3;14;245;Saint-Jean-de-Muzols;2458;66;2524
84;Auvergne-Rhône-Alpes;07;1;12;247;Saint-Jean-le-Centenier;776;13;789
84;Auvergne-Rhône-Alpes;07;3;06;248;Saint-Jean-Roure;258;11;269
84;Auvergne-Rhône-Alpes;07;3;06;249;Saint-Jeure-d'Andaure;102;2;104
84;Auvergne-Rhône-Alpes;07;3;08;250;Saint-Jeure-d'Ay;479;9;488
84;Auvergne-Rhône-Alpes;07;1;03;251;Saint-Joseph-des-Bancs;174;3;177
84;Auvergne-Rhône-Alpes;07;3;06;103;Saint-Julien-d'Intres;329;3;332
84;Auvergne-Rhône-Alpes;07;2;06;253;Saint-Julien-du-Gua;190;3;193
84;Auvergne-Rhône-Alpes;07;1;03;254;Saint-Julien-du-Serre;879;19;898
84;Auvergne-Rhône-Alpes;07;2;09;255;Saint-Julien-en-Saint-Alban;1514;25;1539
84;Auvergne-Rhône-Alpes;07;2;17;257;Saint-Julien-le-Roux;109;3;112
84;Auvergne-Rhône-Alpes;07;3;02;258;Saint-Julien-Vocance;227;2;229
84;Auvergne-Rhône-Alpes;07;2;05;259;Saint-Just-d'Ardèche;1684;37;1721
84;Auvergne-Rhône-Alpes;07;2;09;260;Saint-Lager-Bressac;922;16;938
84;Auvergne-Rhône-Alpes;07;2;17;261;Saint-Laurent-du-Pape;1566;39;1605
84;Auvergne-Rhône-Alpes;07;1;13;262;Saint-Laurent-les-Bains-Laval-d'Aurelle;177;2;179
84;Auvergne-Rhône-Alpes;07;1;12;263;Saint-Laurent-sous-Coiron;100;4;104
84;Auvergne-Rhône-Alpes;07;2;05;264;Saint-Marcel-d'Ardèche;2375;68;2443
84;Auvergne-Rhône-Alpes;07;3;01;265;Saint-Marcel-lès-Annonay;1422;36;1458
84;Auvergne-Rhône-Alpes;07;1;06;267;Saint-Martial;251;4;255
84;Auvergne-Rhône-Alpes;07;2;05;268;Saint-Martin-d'Ardèche;979;12;991
84;Auvergne-Rhône-Alpes;07;3;06;269;Saint-Martin-de-Valamas;1115;38;1153
84;Auvergne-Rhône-Alpes;07;2;09;270;Saint-Martin-sur-Lavezon;432;12;444
84;Auvergne-Rhône-Alpes;07;1;15;272;Saint-Maurice-d'Ardèche;306;12;318
84;Auvergne-Rhône-Alpes;07;1;12;273;Saint-Maurice-d'Ibie;221;4;225
84;Auvergne-Rhône-Alpes;07;2;06;274;Saint-Maurice-en-Chalencon;220;6;226
84;Auvergne-Rhône-Alpes;07;1;16;275;Saint-Mélany;111;3;114
84;Auvergne-Rhône-Alpes;07;3;06;276;Saint-Michel-d'Aurance;274;21;295
84;Auvergne-Rhône-Alpes;07;1;04;277;Saint-Michel-de-Boulogne;156;5;161
84;Auvergne-Rhône-Alpes;07;2;06;278;Saint-Michel-de-Chabrillanoux;354;12;366
84;Auvergne-Rhône-Alpes;07;2;05;279;Saint-Montan;1897;45;1942
84;Auvergne-Rhône-Alpes;07;1;16;280;Saint-Paul-le-Jeune;970;20;990
84;Auvergne-Rhône-Alpes;07;3;07;281;Saint-Péray;7692;239;7931
84;Auvergne-Rhône-Alpes;07;1;13;282;Saint-Pierre-de-Colombier;411;25;436
84;Auvergne-Rhône-Alpes;07;2;09;283;Saint-Pierre-la-Roche;59;2;61
84;Auvergne-Rhône-Alpes;07;1;16;284;Saint-Pierre-Saint-Jean;145;4;149
84;Auvergne-Rhône-Alpes;07;3;08;285;Saint-Pierre-sur-Doux;107;1;108
84;Auvergne-Rhône-Alpes;07;3;06;286;Saint-Pierreville;544;11;555
84;Auvergne-Rhône-Alpes;07;1;12;287;Saint-Pons;293;17;310
84;Auvergne-Rhône-Alpes;07;2;10;288;Saint-Priest;1200;50;1250
84;Auvergne-Rhône-Alpes;07;1;04;289;Saint-Privat;1735;52;1787
84;Auvergne-Rhône-Alpes;07;3;08;290;Saint-Prix;276;7;283
84;Auvergne-Rhône-Alpes;07;1;15;291;Saint-Remèze;871;19;890
84;Auvergne-Rhône-Alpes;07;3;08;292;Saint-Romain-d'Ay;1214;36;1250
84;Auvergne-Rhône-Alpes;07;3;07;293;Saint-Romain-de-Lerps;873;18;891
84;Auvergne-Rhône-Alpes;07;1;16;294;Saint-Sauveur-de-Cruzières;531;14;545
84;Auvergne-Rhône-Alpes;07;2;06;295;Saint-Sauveur-de-Montagut;1111;29;1140
84;Auvergne-Rhône-Alpes;07;1;04;296;Saint-Sernin;1663;44;1707
84;Auvergne-Rhône-Alpes;07;3;08;297;Saint-Sylvestre;508;7;515
84;Auvergne-Rhône-Alpes;07;3;08;299;Saint-Symphorien-de-Mahun;120;4;124
84;Auvergne-Rhône-Alpes;07;2;09;298;Saint-Symphorien-sous-Chomérac;757;30;787
84;Auvergne-Rhône-Alpes;07;2;12;300;Saint-Thomé;445;15;460
84;Auvergne-Rhône-Alpes;07;3;08;301;Saint-Victor;949;12;961
84;Auvergne-Rhône-Alpes;07;2;09;302;Saint-Vincent-de-Barrès;837;22;859
84;Auvergne-Rhône-Alpes;07;2;06;303;Saint-Vincent-de-Durfort;225;5;230
84;Auvergne-Rhône-Alpes;07;1;13;235;Sainte-Eulalie;215;4;219
84;Auvergne-Rhône-Alpes;07;1;16;266;Sainte-Marguerite-Lafigère;107;2;109
84;Auvergne-Rhône-Alpes;07;1;15;304;Salavas;682;11;693
84;Auvergne-Rhône-Alpes;07;1;16;305;Les Salelles;366;9;375
84;Auvergne-Rhône-Alpes;07;1;15;306;Sampzon;228;7;235
84;Auvergne-Rhône-Alpes;07;1;15;307;Sanilhac;446;9;455
84;Auvergne-Rhône-Alpes;07;3;11;308;Sarras;2199;35;2234
84;Auvergne-Rhône-Alpes;07;3;08;309;Satillieu;1546;31;1577
84;Auvergne-Rhône-Alpes;07;3;01;310;Savas;900;24;924
84;Auvergne-Rhône-Alpes;07;1;12;311;Sceautres;144;7;151
84;Auvergne-Rhône-Alpes;07;3;14;312;Sécheras;554;4;558
84;Auvergne-Rhône-Alpes;07;3;11;313;Serrières;1146;17;1163
84;Auvergne-Rhône-Alpes;07;2;17;314;Silhac;368;12;380
84;Auvergne-Rhône-Alpes;07;1;13;315;La Souche;370;10;380
84;Auvergne-Rhône-Alpes;07;3;17;316;Soyons;2238;47;2285
84;Auvergne-Rhône-Alpes;07;3;02;317;Talencieux;1067;31;1098
84;Auvergne-Rhône-Alpes;07;1;15;318;Tauriers;192;5;197
84;Auvergne-Rhône-Alpes;07;2;12;319;Le Teil;8677;219;8896
84;Auvergne-Rhône-Alpes;07;3;02;321;Thorrenc;233;6;239
84;Auvergne-Rhône-Alpes;07;1;13;322;Thueyts;1203;25;1228
84;Auvergne-Rhône-Alpes;07;3;17;323;Toulaud;1700;52;1752
84;Auvergne-Rhône-Alpes;07;3;14;324;Tournon-sur-Rhône;10307;515;10822
84;Auvergne-Rhône-Alpes;07;1;03;325;Ucel;2043;72;2115
84;Auvergne-Rhône-Alpes;07;1;13;326;Usclades-et-Rieutord;115;0;115
84;Auvergne-Rhône-Alpes;07;1;15;327;Uzer;414;12;426
84;Auvergne-Rhône-Alpes;07;1;15;328;Vagnas;544;8;552
84;Auvergne-Rhône-Alpes;07;1;16;329;Valgorge;436;7;443
84;Auvergne-Rhône-Alpes;07;1;03;011;Vallées-d'Antraigues-Asperjoc;947;12;959
84;Auvergne-Rhône-Alpes;07;1;15;330;Vallon-Pont-d'Arc;2382;40;2422
84;Auvergne-Rhône-Alpes;07;1;03;331;Vals-les-Bains;3582;71;3653
84;Auvergne-Rhône-Alpes;07;2;12;332;Valvignères;466;13;479
84;Auvergne-Rhône-Alpes;07;3;02;333;Vanosc;936;13;949
84;Auvergne-Rhône-Alpes;07;1;16;334;Les Vans;2672;62;2734
84;Auvergne-Rhône-Alpes;07;3;08;335;Vaudevant;205;2;207
84;Auvergne-Rhône-Alpes;07;1;16;336;Vernon;232;7;239
84;Auvergne-Rhône-Alpes;07;3;02;337;Vernosc-lès-Annonay;2647;42;2689
84;Auvergne-Rhône-Alpes;07;2;17;338;Vernoux-en-Vivarais;1958;31;1989
84;Auvergne-Rhône-Alpes;07;1;04;339;Vesseaux;1928;56;1984
84;Auvergne-Rhône-Alpes;07;2;10;340;Veyras;1527;49;1576
84;Auvergne-Rhône-Alpes;07;1;12;341;Villeneuve-de-Berg;2944;129;3073
84;Auvergne-Rhône-Alpes;07;3;02;342;Villevocance;1171;28;1199
84;Auvergne-Rhône-Alpes;07;1;04;343;Vinezac;1371;39;1410
84;Auvergne-Rhône-Alpes;07;3;11;344;Vinzieux;453;3;456
84;Auvergne-Rhône-Alpes;07;3;14;345;Vion;939;23;962
84;Auvergne-Rhône-Alpes;07;2;05;346;Viviers;3730;57;3787
84;Auvergne-Rhône-Alpes;07;3;02;347;Vocance;610;3;613
84;Auvergne-Rhône-Alpes;07;1;15;348;Vogüé;1087;27;1114
84;Auvergne-Rhône-Alpes;07;2;17;349;La Voulte-sur-Rhône;4987;59;5046
44;Grand Est;08;2;11;001;Acy-Romance;446;3;449
44;Grand Est;08;1;18;003;Aiglemont;1634;34;1668
44;Grand Est;08;2;08;004;Aire;220;4;224
44;Grand Est;08;2;08;005;Alincourt;150;2;152
44;Grand Est;08;4;01;006;Alland'Huy-et-Sausseuil;245;4;249
44;Grand Est;08;2;11;008;Amagne;725;6;731
44;Grand Est;08;2;11;010;Ambly-Fleury;134;5;139
44;Grand Est;08;1;12;011;Anchamps;217;4;221
44;Grand Est;08;3;19;013;Angecourt;392;4;396
44;Grand Est;08;2;08;014;Annelles;141;6;147
44;Grand Est;08;1;17;015;Antheny;99;5;104
44;Grand Est;08;1;17;016;Aouste;207;2;209
44;Grand Est;08;4;01;017;Apremont;117;3;120
44;Grand Est;08;4;01;018;Ardeuil-et-Montfauxelles;68;1;69
44;Grand Est;08;2;11;021;Arnicourt;157;3;160
44;Grand Est;08;1;05;022;Arreux;324;12;336
44;Grand Est;08;3;19;023;Artaise-le-Vivier;66;1;67
44;Grand Est;08;2;08;024;Asfeld;1116;16;1132
44;Grand Est;08;4;01;025;Attigny;1128;24;1152
44;Grand Est;08;1;17;026;Aubigny-les-Pothées;315;6;321
44;Grand Est;08;2;17;027;Auboncourt-Vauzelles;100;3;103
44;Grand Est;08;1;09;028;Aubrives;910;19;929
44;Grand Est;08;3;03;029;Auflance;86;3;89
44;Grand Est;08;1;13;030;Auge;60;0;60
44;Grand Est;08;4;01;031;Aure;48;4;52
44;Grand Est;08;2;08;032;Aussonce;215;3;218
44;Grand Est;08;4;19;033;Authe;90;4;94
44;Grand Est;08;3;03;034;Autrecourt-et-Pourron;342;6;348
44;Grand Est;08;4;19;035;Autruche;69;4;73
44;Grand Est;08;4;01;036;Autry;117;8;125
44;Grand Est;08;1;13;037;Auvillers-les-Forges;877;10;887
44;Grand Est;08;2;08;038;Avançon;313;6;319
44;Grand Est;08;2;08;039;Avaux;466;13;479
44;Grand Est;08;1;10;040;Les Ayvelles;897;12;909
44;Grand Est;08;1;10;041;Baâlons;207;8;215
44;Grand Est;08;4;19;116;Bairon et ses environs;1041;17;1058
44;Grand Est;08;3;16;043;Balan;1618;30;1648
44;Grand Est;08;2;08;044;Balham;152;1;153
44;Grand Est;08;4;19;045;Ballay;289;7;296
44;Grand Est;08;2;08;046;Banogne-Recouvrance;157;4;161
44;Grand Est;08;4;19;049;Bar-lès-Buzancy;125;3;128
44;Grand Est;08;1;17;047;Barbaise;101;0;101
44;Grand Est;08;2;11;048;Barby;415;4;419
44;Grand Est;08;4;19;052;Bayonville;99;5;104
44;Grand Est;08;3;16;053;Bazeilles;2394;218;2612
44;Grand Est;08;3;03;055;Beaumont-en-Argonne;430;9;439
44;Grand Est;08;4;01;056;Beffu-et-le-Morthomme;48;0;48
44;Grand Est;08;4;19;057;Belleville-et-Châtillon-sur-Bar;272;50;322
44;Grand Est;08;1;04;058;Belval;222;6;228
44;Grand Est;08;4;19;059;Belval-Bois-des-Dames;33;1;34
44;Grand Est;08;2;08;060;Bergnicourt;285;1;286
44;Grand Est;08;4;19;061;La Berlière;40;1;41
44;Grand Est;08;2;11;062;Bertoncourt;127;8;135
44;Grand Est;08;3;19;063;La Besace;141;0;141
44;Grand Est;08;2;11;064;Biermes;307;5;312
44;Grand Est;08;3;03;065;Bièvres;49;1;50
44;Grand Est;08;2;08;066;Bignicourt;68;1;69
44;Grand Est;08;3;03;067;Blagny;1190;19;1209
44;Grand Est;08;1;17;069;Blanchefosse-et-Bay;151;1;152
44;Grand Est;08;2;08;070;Blanzy-la-Salonnaise;344;6;350
44;Grand Est;08;1;13;071;Blombay;139;2;141
44;Grand Est;08;1;02;081;Bogny-sur-Meuse;5100;74;5174
44;Grand Est;08;1;17;073;Bossus-lès-Rumigny;103;1;104
44;Grand Est;08;4;01;074;Bouconville;53;3;56
44;Grand Est;08;4;19;075;Boult-aux-Bois;138;3;141
44;Grand Est;08;1;10;076;Boulzicourt;958;19;977
44;Grand Est;08;4;01;077;Bourcq;52;1;53
44;Grand Est;08;1;13;078;Bourg-Fidèle;862;15;877
44;Grand Est;08;1;10;080;Bouvellemont;121;0;121
44;Grand Est;08;4;01;082;Brécy-Brières;76;2;78
44;Grand Est;08;3;03;083;Brévilly;367;7;374
44;Grand Est;08;2;08;084;Brienne-sur-Aisne;258;2;260
44;Grand Est;08;4;19;085;Brieulles-sur-Bar;217;7;224
44;Grand Est;08;4;19;086;Briquenay;98;7;105
44;Grand Est;08;1;13;087;Brognon;148;2;150
44;Grand Est;08;3;19;088;Bulson;134;4;138
44;Grand Est;08;4;19;089;Buzancy;348;9;357
44;Grand Est;08;3;03;090;Carignan;2885;45;2930
44;Grand Est;08;4;01;092;Cauroy;189;8;197
44;Grand Est;08;1;17;094;Cernion;58;3;61
44;Grand Est;08;1;10;095;Chagny;184;6;190
44;Grand Est;08;1;10;096;Chalandry-Elaire;669;14;683
44;Grand Est;08;4;01;097;Challerange;447;7;454
44;Grand Est;08;1;10;099;Champigneul-sur-Vence;122;4;126
44;Grand Est;08;4;01;098;Champigneulle;59;1;60
44;Grand Est;08;1;17;100;Champlin;71;3;74
44;Grand Est;08;3;15;101;La Chapelle;178;4;182
44;Grand Est;08;2;17;102;Chappes;101;0;101
44;Grand Est;08;4;01;103;Charbogne;225;8;233
44;Grand Est;08;4;01;104;Chardeny;55;1;56
44;Grand Est;08;1;98;105;Charleville-Mézières;46428;1143;47571
44;Grand Est;08;1;09;106;Charnois;77;0;77
44;Grand Est;08;2;08;107;Château-Porcien;1367;17;1384
44;Grand Est;08;4;01;109;Chatel-Chéhéry;146;3;149
44;Grand Est;08;2;08;111;Le Châtelet-sur-Retourne;794;10;804
44;Grand Est;08;1;13;110;Le Châtelet-sur-Sormonne;160;2;162
44;Grand Est;08;2;17;113;Chaumont-Porcien;485;10;495
44;Grand Est;08;3;89;115;Chémery-Chéhéry;578;13;591
44;Grand Est;08;2;17;117;Chesnois-Auboncourt;169;0;169
44;Grand Est;08;3;14;119;Cheveuges;430;7;437
44;Grand Est;08;4;01;120;Chevières;45;2;47
44;Grand Est;08;1;13;121;Chilly;143;5;148
44;Grand Est;08;1;09;122;Chooz;745;17;762
44;Grand Est;08;4;01;123;Chuffilly-Roche;75;1;76
44;Grand Est;08;1;17;124;Clavy-Warby;348;9;357
44;Grand Est;08;1;04;125;Cliron;377;9;386
44;Grand Est;08;4;01;128;Condé-lès-Autry;67;2;69
44;Grand Est;08;2;08;126;Condé-lès-Herpy;217;4;221
44;Grand Est;08;4;01;130;Contreuve;80;3;83
44;Grand Est;08;4;01;131;Cornay;63;3;66
44;Grand Est;08;2;11;132;Corny-Machéroménil;193;2;195
44;Grand Est;08;2;11;133;Coucy;505;6;511
44;Grand Est;08;4;01;134;Coulommes-et-Marqueny;83;1;84
44;Grand Est;08;4;19;135;La Croix-aux-Bois;149;3;152
44;Grand Est;08;3;16;136;Daigny;349;8;357
44;Grand Est;08;1;05;137;Damouzy;447;12;459
44;Grand Est;08;3;03;138;Les Deux-Villes;254;3;257
44;Grand Est;08;1;02;139;Deville;1041;10;1051
44;Grand Est;08;1;10;140;Dom-le-Mesnil;1087;19;1106
44;Grand Est;08;1;17;141;Dommery;181;4;185
44;Grand Est;08;3;14;142;Donchery;2087;28;2115
44;Grand Est;08;2;17;143;Doumely-Bégny;76;0;76
44;Grand Est;08;2;11;144;Doux;100;0;100
44;Grand Est;08;3;03;145;Douzy;2167;61;2228
44;Grand Est;08;2;17;146;Draize;103;0;103
44;Grand Est;08;4;01;147;Dricourt;84;9;93
44;Grand Est;08;2;08;148;L' Écaille;275;7;282
44;Grand Est;08;1;17;149;L' Échelle;137;5;142
44;Grand Est;08;2;08;150;Écly;176;5;181
44;Grand Est;08;4;01;151;Écordal;324;8;332
44;Grand Est;08;3;03;153;Escombres-et-le-Chesnois;349;5;354
44;Grand Est;08;1;17;154;Estrebay;74;3;77
44;Grand Est;08;1;13;155;Étalle;103;5;108
44;Grand Est;08;1;13;156;Éteignières;516;3;519
44;Grand Est;08;1;10;158;Étrépigny;291;8;299
44;Grand Est;08;3;03;159;Euilly-et-Lombut;114;4;118
44;Grand Est;08;1;10;160;Évigny;190;4;194
44;Grand Est;08;4;01;161;Exermont;42;1;43
44;Grand Est;08;1;04;162;Fagnon;342;6;348
44;Grand Est;08;2;17;163;Faissault;251;4;255
44;Grand Est;08;4;01;164;Falaise;331;8;339
44;Grand Est;08;2;17;165;Faux;57;1;58
44;Grand Est;08;1;12;166;Fépin;265;2;267
44;Grand Est;08;1;17;167;La Férée;83;2;85
44;Grand Est;08;3;03;168;La Ferté-sur-Chiers;172;4;176
44;Grand Est;08;1;17;169;Flaignes-Havys;121;1;122
44;Grand Est;08;3;15;170;Fleigneux;202;7;209
44;Grand Est;08;4;01;171;Fléville;97;4;101
44;Grand Est;08;1;13;172;Fligny;185;1;186
44;Grand Est;08;1;10;173;Flize;1723;52;1775
44;Grand Est;08;3;15;174;Floing;2349;56;2405
44;Grand Est;08;1;09;175;Foisches;204;7;211
44;Grand Est;08;4;19;176;Fossé;54;1;55
44;Grand Est;08;2;17;178;Fraillicourt;189;5;194
44;Grand Est;08;3;16;179;Francheval;609;13;622
44;Grand Est;08;1;07;180;La Francheville;1685;45;1730
44;Grand Est;08;1;17;182;Le Fréty;58;0;58
44;Grand Est;08;1;09;183;Fromelennes;1038;22;1060
44;Grand Est;08;3;03;184;Fromy;82;2;84
44;Grand Est;08;1;12;185;Fumay;3481;60;3541
44;Grand Est;08;4;19;186;Germont;48;0;48
44;Grand Est;08;1;18;187;Gernelle;313;8;321
44;Grand Est;08;1;18;188;Gespunsart;1057;22;1079
44;Grand Est;08;1;17;189;Girondelle;153;2;155
44;Grand Est;08;1;09;190;Givet;6749;159;6908
44;Grand Est;08;3;15;191;Givonne;1043;34;1077
44;Grand Est;08;2;17;192;Givron;86;1;87
44;Grand Est;08;4;01;193;Givry;272;6;278
44;Grand Est;08;3;15;194;Glaire;884;13;897
44;Grand Est;08;2;08;195;Gomont;326;3;329
44;Grand Est;08;2;17;196;Grandchamp;97;0;97
44;Grand Est;08;4;19;019;Les Grandes-Armoises;61;0;61
44;Grand Est;08;4;01;197;Grandham;39;1;40
44;Grand Est;08;4;01;198;Grandpré;540;17;557
44;Grand Est;08;1;18;199;La Grandville;795;17;812
44;Grand Est;08;4;01;200;Grivy-Loisy;184;6;190
44;Grand Est;08;1;17;201;Gruyères;99;2;101
44;Grand Est;08;1;13;202;Gué-d'Hossus;526;3;529
44;Grand Est;08;1;10;203;Guignicourt-sur-Vence;302;6;308
44;Grand Est;08;4;01;204;Guincourt;90;2;92
44;Grand Est;08;2;17;205;Hagnicourt;80;3;83
44;Grand Est;08;1;13;206;Ham-les-Moines;372;5;377
44;Grand Est;08;1;09;207;Ham-sur-Meuse;238;2;240
44;Grand Est;08;1;17;208;Hannappes;141;0;141
44;Grand Est;08;1;10;209;Hannogne-Saint-Martin;465;5;470
44;Grand Est;08;2;08;210;Hannogne-Saint-Rémy;113;4;117
44;Grand Est;08;3;19;211;Haraucourt;731;4;735
44;Grand Est;08;1;13;212;Harcy;507;10;517
44;Grand Est;08;1;12;214;Hargnies;484;3;487
44;Grand Est;08;4;19;215;Harricourt;40;2;42
44;Grand Est;08;1;04;216;Haudrecy;305;13;318
44;Grand Est;08;1;02;217;Haulmé;91;1;92
44;Grand Est;08;1;02;218;Les Hautes-Rivières;1482;25;1507
44;Grand Est;08;2;08;219;Hauteville;108;1;109
44;Grand Est;08;4;01;220;Hauviné;327;8;335
44;Grand Est;08;1;12;222;Haybes;1885;57;1942
44;Grand Est;08;3;03;223;Herbeuval;121;2;123
44;Grand Est;08;2;08;225;Herpy-l'Arlésienne;199;5;204
44;Grand Est;08;1;09;226;Hierges;195;5;200
44;Grand Est;08;1;10;228;La Horgne;194;9;203
44;Grand Est;08;2;08;229;Houdilcourt;133;7;140
44;Grand Est;08;1;05;230;Houldizy;374;5;379
44;Grand Est;08;3;15;232;Illy;411;9;420
44;Grand Est;08;4;19;233;Imécourt;49;1;50
44;Grand Est;08;2;08;234;Inaumont;99;0;99
44;Grand Est;08;1;18;235;Issancourt-et-Rumel;384;12;396
44;Grand Est;08;1;17;236;Jandun;285;10;295
44;Grand Est;08;1;02;237;Joigny-sur-Meuse;678;19;697
44;Grand Est;08;4;01;238;Jonval;98;1;99
44;Grand Est;08;2;08;239;Juniville;1226;28;1254
44;Grand Est;08;2;17;240;Justine-Herbigny;175;1;176
44;Grand Est;08;1;02;242;Laifour;449;8;457
44;Grand Est;08;1;17;243;Lalobbe;169;4;173
44;Grand Est;08;4;01;244;Lametz;72;3;75
44;Grand Est;08;4;19;246;Landres-et-Saint-Georges;79;1;80
44;Grand Est;08;1;09;247;Landrichamps;131;2;133
44;Grand Est;08;4;01;245;Lançon;33;3;36
44;Grand Est;08;1;17;248;Launois-sur-Vence;699;9;708
44;Grand Est;08;1;13;249;Laval-Morency;243;10;253
44;Grand Est;08;4;01;250;Leffincourt;189;6;195
44;Grand Est;08;1;17;251;Lépron-les-Vallées;78;2;80
44;Grand Est;08;3;03;252;Létanne;129;3;132
44;Grand Est;08;1;17;254;Liart;605;10;615
44;Grand Est;08;3;03;255;Linay;250;3;253
44;Grand Est;08;4;01;256;Liry;88;1;89
44;Grand Est;08;1;17;257;Logny-Bogny;168;3;171
44;Grand Est;08;4;01;259;Longwé;73;2;75
44;Grand Est;08;1;13;260;Lonny;648;11;659
44;Grand Est;08;2;17;262;Lucquy;580;34;614
44;Grand Est;08;1;18;263;Lumes;1142;25;1167
44;Grand Est;08;4;01;264;Machault;505;11;516
44;Grand Est;08;3;19;268;Maisoncelle-et-Villers;69;4;73
44;Grand Est;08;3;03;269;Malandry;82;1;83
44;Grand Est;08;4;01;271;Manre;100;6;106
44;Grand Est;08;1;17;272;Maranwez;61;0;61
44;Grand Est;08;1;17;273;Marby;62;1;63
44;Grand Est;08;4;01;274;Marcq;100;1;101
44;Grand Est;08;3;03;275;Margny;192;4;196
44;Grand Est;08;3;03;276;Margut;770;15;785
44;Grand Est;08;1;17;277;Marlemont;140;4;144
44;Grand Est;08;4;01;278;Marquigny;84;0;84
44;Grand Est;08;4;01;279;Mars-sous-Bourcq;55;2;57
44;Grand Est;08;4;01;280;Marvaux-Vieux;73;2;75
44;Grand Est;08;3;03;281;Matton-et-Clémency;469;9;478
44;Grand Est;08;1;13;282;Maubert-Fontaine;1031;71;1102
44;Grand Est;08;1;10;283;Mazerny;125;1;126
44;Grand Est;08;1;02;284;Les Mazures;903;23;926
44;Grand Est;08;2;08;286;Ménil-Annelles;108;5;113
44;Grand Est;08;2;08;287;Ménil-Lépinois;136;2;138
44;Grand Est;08;2;17;288;Mesmont;95;1;96
44;Grand Est;08;3;03;289;Messincourt;612;8;620
44;Grand Est;08;3;03;291;Mogues;216;4;220
44;Grand Est;08;3;03;293;Moiry;148;0;148
44;Grand Est;08;3;16;294;La Moncelle;141;2;143
44;Grand Est;08;1;10;295;Mondigny;171;4;175
44;Grand Est;08;3;19;300;Le Mont-Dieu;16;0;16
44;Grand Est;08;2;11;306;Mont-Laurent;62;1;63
44;Grand Est;08;4;01;308;Mont-Saint-Martin;83;0;83
44;Grand Est;08;4;01;309;Mont-Saint-Remy;56;1;57
44;Grand Est;08;4;01;296;Montcheutin;128;8;136
44;Grand Est;08;1;02;297;Montcornet;297;8;305
44;Grand Est;08;1;06;298;Montcy-Notre-Dame;1600;44;1644
44;Grand Est;08;4;19;301;Montgon;66;4;70
44;Grand Est;08;1;02;302;Monthermé;2335;85;2420
44;Grand Est;08;4;01;303;Monthois;374;10;384
44;Grand Est;08;1;12;304;Montigny-sur-Meuse;80;2;82
44;Grand Est;08;1;10;305;Montigny-sur-Vence;243;5;248
44;Grand Est;08;2;17;307;Montmeillant;83;1;84
44;Grand Est;08;4;01;310;Mouron;73;5;78
44;Grand Est;08;3;03;311;Mouzon;2305;40;2345
44;Grand Est;08;1;13;312;Murtin-et-Bogny;182;7;189
44;Grand Est;08;2;11;313;Nanteuil-sur-Aisne;135;4;139
44;Grand Est;08;2;08;314;Neuflize;783;23;806
44;Grand Est;08;1;17;315;Neufmaison;69;2;71
44;Grand Est;08;1;18;316;Neufmanil;1020;16;1036
44;Grand Est;08;3;19;317;La Neuville-à-Maire;123;4;127
44;Grand Est;08;1;13;318;La Neuville-aux-Joûtes;361;8;369
44;Grand Est;08;4;01;321;Neuville-Day;158;2;160
44;Grand Est;08;2;08;320;La Neuville-en-Tourne-à-Fuy;578;10;588
44;Grand Est;08;1;13;322;Neuville-lès-This;376;14;390
44;Grand Est;08;2;17;323;La Neuville-lès-Wasigny;160;1;161
44;Grand Est;08;1;13;319;Neuville-lez-Beaulieu;335;8;343
44;Grand Est;08;2;17;324;Neuvizy;117;2;119
44;Grand Est;08;4;19;325;Noirval;27;1;28
44;Grand Est;08;4;19;326;Nouart;141;2;143
44;Grand Est;08;1;10;327;Nouvion-sur-Meuse;2250;36;2286
44;Grand Est;08;1;05;328;Nouzonville;5836;110;5946
44;Grand Est;08;2;17;329;Novion-Porcien;488;10;498
44;Grand Est;08;2;11;330;Novy-Chevrières;735;9;744
44;Grand Est;08;3;14;331;Noyers-Pont-Maugis;684;14;698
44;Grand Est;08;4;19;332;Oches;44;4;48
44;Grand Est;08;4;01;333;Olizy-Primat;234;9;243
44;Grand Est;08;1;10;334;Omicourt;40;2;42
44;Grand Est;08;1;10;335;Omont;84;1;85
44;Grand Est;08;3;03;336;Osnes;230;3;233
44;Grand Est;08;4;01;338;Pauvres;188;3;191
44;Grand Est;08;2;08;339;Perthes;309;8;317
44;Grand Est;08;4;19;020;Les Petites-Armoises;63;0;63
44;Grand Est;08;2;08;340;Poilcourt-Sydney;181;4;185
44;Grand Est;08;1;10;341;Poix-Terron;819;41;860
44;Grand Est;08;3;16;342;Pouru-aux-Bois;266;5;271
44;Grand Est;08;3;16;343;Pouru-Saint-Remy;1163;25;1188
44;Grand Est;08;1;17;344;Prez;136;2;138
44;Grand Est;08;1;04;346;Prix-lès-Mézières;1340;31;1371
44;Grand Est;08;3;03;347;Puilly-et-Charbeaux;227;5;232
44;Grand Est;08;2;17;348;Puiseux;116;3;119
44;Grand Est;08;3;03;349;Pure;604;6;610
44;Grand Est;08;4;19;350;Quatre-Champs;218;3;221
44;Grand Est;08;4;01;351;Quilly;82;0;82
44;Grand Est;08;1;17;352;Raillicourt;202;4;206
44;Grand Est;08;1;09;353;Rancennes;719;23;742
44;Grand Est;08;3;19;354;Raucourt-et-Flaba;841;13;854
44;Grand Est;08;1;13;355;Regniowez;391;7;398
44;Grand Est;08;2;17;356;Remaucourt;173;1;174
44;Grand Est;08;3;19;357;Remilly-Aillicourt;780;15;795
44;Grand Est;08;1;13;358;Remilly-les-Pothées;254;4;258
44;Grand Est;08;2;17;360;Renneville;203;5;208
44;Grand Est;08;1;02;361;Renwez;1688;44;1732
44;Grand Est;08;2;11;362;Rethel;7592;303;7895
44;Grand Est;08;1;12;363;Revin;6239;140;6379
44;Grand Est;08;4;01;364;Rilly-sur-Aisne;141;3;144
44;Grand Est;08;1;13;365;Rimogne;1383;22;1405
44;Grand Est;08;2;17;366;Rocquigny;686;10;696
44;Grand Est;08;1;13;367;Rocroi;2330;29;2359
44;Grand Est;08;2;08;368;Roizy;219;3;222
44;Grand Est;08;2;17;369;La Romagne;130;2;132
44;Grand Est;08;1;17;370;Rouvroy-sur-Audry;583;5;588
44;Grand Est;08;2;17;372;Rubigny;67;0;67
44;Grand Est;08;1;17;373;Rumigny;328;4;332
44;Grand Est;08;4;01;374;La Sabotterie;112;3;115
44;Grand Est;08;3;03;375;Sachy;182;6;188
44;Grand Est;08;3;03;376;Sailly;253;3;256
44;Grand Est;08;3;14;377;Saint-Aignan;149;2;151
44;Grand Est;08;4;01;378;Saint-Clément-à-Arnes;107;1;108
44;Grand Est;08;4;01;379;Saint-Étienne-à-Arnes;242;2;244
44;Grand Est;08;2;08;380;Saint-Fergeux;210;4;214
44;Grand Est;08;2;08;381;Saint-Germainmont;842;12;854
44;Grand Est;08;2;17;382;Saint-Jean-aux-Bois;107;3;110
44;Grand Est;08;4;01;383;Saint-Juvin;104;4;108
44;Grand Est;08;4;01;384;Saint-Lambert-et-Mont-de-Jeux;145;4;149
44;Grand Est;08;1;18;385;Saint-Laurent;1104;171;1275
44;Grand Est;08;2;08;386;Saint-Loup-en-Champagne;323;7;330
44;Grand Est;08;4;01;387;Saint-Loup-Terrier;179;6;185
44;Grand Est;08;1;10;388;Saint-Marceau;346;11;357
44;Grand Est;08;1;13;389;Saint-Marcel;358;7;365
44;Grand Est;08;3;15;391;Saint-Menges;972;16;988
44;Grand Est;08;4;01;392;Saint-Morel;210;7;217
44;Grand Est;08;4;01;393;Saint-Pierre-à-Arnes;67;2;69
44;Grand Est;08;1;10;395;Saint-Pierre-sur-Vence;121;5;126
44;Grand Est;08;4;19;394;Saint-Pierremont;73;3;76
44;Grand Est;08;2;08;396;Saint-Quentin-le-Petit;120;0;120
44;Grand Est;08;2;08;397;Saint-Remy-le-Petit;42;2;44
44;Grand Est;08;4;01;390;Sainte-Marie;80;4;84
44;Grand Est;08;4;01;398;Sainte-Vaubourg;87;2;89
44;Grand Est;08;1;10;400;Sapogne-et-Feuchères;516;10;526
44;Grand Est;08;3;03;399;Sapogne-sur-Marche;138;3;141
44;Grand Est;08;4;01;401;Saulces-Champenoises;243;1;244
44;Grand Est;08;2;17;402;Saulces-Monclin;811;10;821
44;Grand Est;08;2;11;403;Sault-lès-Rethel;1915;18;1933
44;Grand Est;08;2;08;404;Sault-Saint-Remy;204;3;207
44;Grand Est;08;4;19;405;Sauville;245;8;253
44;Grand Est;08;4;01;406;Savigny-sur-Aisne;375;12;387
44;Grand Est;08;4;01;407;Séchault;61;0;61
44;Grand Est;08;1;05;408;Sécheval;554;10;564
44;Grand Est;08;3;99;409;Sedan;16428;349;16777
44;Grand Est;08;4;01;410;Semide;190;19;209
44;Grand Est;08;4;01;411;Semuy;90;0;90
44;Grand Est;08;4;01;412;Senuc;167;2;169
44;Grand Est;08;2;08;413;Seraincourt;279;3;282
44;Grand Est;08;2;17;415;Sery;357;7;364
44;Grand Est;08;2;11;416;Seuil;158;6;164
44;Grand Est;08;1;13;417;Sévigny-la-Forêt;276;8;284
44;Grand Est;08;2;08;418;Sévigny-Waleppe;227;3;230
44;Grand Est;08;1;17;419;Signy-l'Abbaye;1363;28;1391
44;Grand Est;08;1;13;420;Signy-le-Petit;1243;23;1266
44;Grand Est;08;3;03;421;Signy-Montlibert;92;0;92
44;Grand Est;08;1;10;422;Singly;135;3;138
44;Grand Est;08;4;19;424;Sommauthe;114;0;114
44;Grand Est;08;4;01;425;Sommerance;37;2;39
44;Grand Est;08;2;08;426;Son;99;0;99
44;Grand Est;08;2;11;427;Sorbon;196;2;198
44;Grand Est;08;2;17;428;Sorcy-Bauthémont;151;4;155
44;Grand Est;08;1;13;429;Sormonne;544;14;558
44;Grand Est;08;3;19;430;Stonne;41;2;43
44;Grand Est;08;4;01;431;Sugny;100;3;103
44;Grand Est;08;1;13;432;Sury;108;4;112
44;Grand Est;08;4;01;433;Suzanne;64;2;66
44;Grand Est;08;4;19;434;Sy;51;1;52
44;Grand Est;08;2;08;435;Tagnon;884;13;897
44;Grand Est;08;1;13;436;Taillette;402;7;409
44;Grand Est;08;4;19;437;Tailly;174;6;180
44;Grand Est;08;2;08;438;Taizy;105;2;107
44;Grand Est;08;4;19;439;Tannay;156;4;160
44;Grand Est;08;1;13;440;Tarzy;154;2;156
44;Grand Est;08;3;03;444;Tétaigne;131;3;134
44;Grand Est;08;3;14;445;Thelonne;406;2;408
44;Grand Est;08;4;19;446;Thénorgues;84;0;84
44;Grand Est;08;1;02;448;Thilay;1061;12;1073
44;Grand Est;08;1;17;449;Thin-le-Moutier;623;10;633
44;Grand Est;08;1;13;450;This;227;6;233
44;Grand Est;08;2;08;451;Le Thour;402;9;411
44;Grand Est;08;2;11;452;Thugny-Trugny;266;0;266
44;Grand Est;08;4;19;453;Toges;101;3;104
44;Grand Est;08;1;10;454;Touligny;85;2;87
44;Grand Est;08;4;01;455;Tourcelles-Chaumont;92;1;93
44;Grand Est;08;1;02;456;Tournavaux;241;4;245
44;Grand Est;08;1;04;457;Tournes;1076;27;1103
44;Grand Est;08;4;01;458;Tourteron;179;4;183
44;Grand Est;08;3;03;459;Tremblois-lès-Carignan;168;1;169
44;Grand Est;08;1;13;460;Tremblois-lès-Rocroi;156;0;156
44;Grand Est;08;4;19;461;Vandy;207;1;208
44;Grand Est;08;4;01;462;Vaux-Champagne;129;4;133
44;Grand Est;08;4;19;463;Vaux-en-Dieulet;54;1;55
44;Grand Est;08;4;01;464;Vaux-lès-Mouron;81;3;84
44;Grand Est;08;3;03;466;Vaux-lès-Mouzon;73;2;75
44;Grand Est;08;2;17;465;Vaux-lès-Rubigny;47;3;50
44;Grand Est;08;2;17;467;Vaux-Montreuil;108;0;108
44;Grand Est;08;1;17;468;Vaux-Villaine;195;1;196
44;Grand Est;08;1;10;469;Vendresse;494;12;506
44;Grand Est;08;4;19;470;Verpel;67;3;70
44;Grand Est;08;4;19;471;Verrières;27;2;29
44;Grand Est;08;2;17;472;Viel-Saint-Remy;301;2;303
44;Grand Est;08;2;08;473;Vieux-lès-Asfeld;314;7;321
44;Grand Est;08;1;18;483;Ville-sur-Lumes;520;16;536
44;Grand Est;08;2;08;484;Ville-sur-Retourne;83;1;84
44;Grand Est;08;2;08;476;Villers-devant-le-Thour;419;6;425
44;Grand Est;08;3;03;477;Villers-devant-Mouzon;101;0;101
44;Grand Est;08;1;10;478;Villers-le-Tilleul;237;3;240
44;Grand Est;08;2;17;479;Villers-le-Tourneur;194;2;196
44;Grand Est;08;1;18;480;Villers-Semeuse;3604;69;3673
44;Grand Est;08;3;14;481;Villers-sur-Bar;247;5;252
44;Grand Est;08;1;10;482;Villers-sur-le-Mont;110;4;114
44;Grand Est;08;3;03;485;Villy;215;2;217
44;Grand Est;08;1;09;486;Vireux-Molhain;1498;32;1530
44;Grand Est;08;1;09;487;Vireux-Wallerand;1962;57;2019
44;Grand Est;08;1;18;488;Vivier-au-Court;2954;90;3044
44;Grand Est;08;4;01;489;Voncq;217;6;223
44;Grand Est;08;4;88;490;Vouziers;4340;149;4489
44;Grand Est;08;3;14;491;Vrigne aux Bois;3623;78;3701
44;Grand Est;08;1;10;492;Vrigne-Meuse;300;1;301
44;Grand Est;08;3;14;494;Wadelincourt;473;5;478
44;Grand Est;08;2;17;496;Wagnon;128;1;129
44;Grand Est;08;1;04;497;Warcq;1275;25;1300
44;Grand Est;08;1;10;498;Warnécourt;372;16;388
44;Grand Est;08;2;17;499;Wasigny;331;3;334
44;Grand Est;08;2;17;500;Wignicourt;58;1;59
44;Grand Est;08;3;03;501;Williers;42;3;45
44;Grand Est;08;3;03;502;Yoncq;101;3;104
44;Grand Est;08;1;10;503;Yvernaumont;139;5;144
76;Occitanie;09;3;03;001;Aigues-Juntes;67;0;67
76;Occitanie;09;2;06;002;Aigues-Vives;666;13;679
76;Occitanie;09;2;09;003;L' Aiguillon;429;10;439
76;Occitanie;09;1;01;004;Albiès;123;7;130
76;Occitanie;09;3;03;005;Aleu;130;2;132
76;Occitanie;09;1;12;006;Alliat;51;1;52
76;Occitanie;09;3;03;007;Allières;71;1;72
76;Occitanie;09;3;03;008;Alos;117;2;119
76;Occitanie;09;3;03;009;Alzen;260;11;271
76;Occitanie;09;3;04;011;Antras;65;1;66
76;Occitanie;09;1;01;012;Appy;25;0;25
76;Occitanie;09;1;13;013;Arabaux;76;2;78
76;Occitanie;09;3;04;014;Argein;194;7;201
76;Occitanie;09;1;12;015;Arignac;707;8;715
76;Occitanie;09;1;12;016;Arnave;207;7;214
76;Occitanie;09;3;04;017;Arrien-en-Bethmale;111;2;113
76;Occitanie;09;3;04;018;Arrout;85;4;89
76;Occitanie;09;3;02;019;Artigat;564;10;574
76;Occitanie;09;1;01;020;Artigues;56;1;57
76;Occitanie;09;1;07;021;Artix;141;3;144
76;Occitanie;09;2;08;022;Arvigna;223;0;223
76;Occitanie;09;1;01;023;Ascou;121;1;122
76;Occitanie;09;1;01;024;Aston;220;2;222
76;Occitanie;09;3;04;025;Aucazein;59;2;61
76;Occitanie;09;3;04;026;Audressein;139;3;142
76;Occitanie;09;3;04;027;Augirein;76;4;80
76;Occitanie;09;1;01;296;Aulos-Sinsat;166;3;169
76;Occitanie;09;3;03;029;Aulus-les-Bains;158;6;164
76;Occitanie;09;1;12;030;Auzat;488;11;499
76;Occitanie;09;1;01;032;Ax-les-Thermes;1267;65;1332
76;Occitanie;09;1;01;031;Axiat;41;1;42
76;Occitanie;09;3;11;033;Bagert;38;1;39
76;Occitanie;09;3;04;034;Balacet;26;2;28
76;Occitanie;09;3;04;035;Balaguères;197;2;199
76;Occitanie;09;3;11;037;Barjac;42;0;42
76;Occitanie;09;3;02;038;La Bastide-de-Besplas;380;7;387
76;Occitanie;09;2;06;039;La Bastide-de-Bousignac;338;14;352
76;Occitanie;09;2;10;040;La Bastide-de-Lordat;286;7;293
76;Occitanie;09;3;03;042;La Bastide-de-Sérou;957;18;975
76;Occitanie;09;3;11;041;La Bastide-du-Salat;182;6;188
76;Occitanie;09;2;06;043;La Bastide-sur-l'Hers;678;13;691
76;Occitanie;09;1;13;044;Baulou;168;3;171
76;Occitanie;09;1;12;045;Bédeilhac-et-Aynat;192;3;195
76;Occitanie;09;3;11;046;Bédeille;70;3;73
76;Occitanie;09;2;09;047;Bélesta;1064;18;1082
76;Occitanie;09;2;06;048;Belloc;76;1;77
76;Occitanie;09;1;13;049;Bénac;182;5;187
76;Occitanie;09;2;07;050;Benagues;514;9;523
76;Occitanie;09;2;09;051;Bénaix;147;4;151
76;Occitanie;09;2;06;052;Besset;164;8;172
76;Occitanie;09;1;01;053;Bestiac;19;3;22
76;Occitanie;09;3;11;054;Betchat;333;5;338
76;Occitanie;09;3;04;055;Bethmale;95;0;95
76;Occitanie;09;2;07;056;Bézac;357;5;362
76;Occitanie;09;3;03;057;Biert;316;5;321
76;Occitanie;09;1;12;058;Bompas;195;5;200
76;Occitanie;09;3;04;059;Bonac-Irazein;119;4;123
76;Occitanie;09;2;10;060;Bonnac;733;10;743
76;Occitanie;09;3;02;061;Les Bordes-sur-Arize;518;7;525
76;Occitanie;09;3;04;062;Bordes-Uchentein;174;2;176
76;Occitanie;09;1;13;063;Le Bosc;97;2;99
76;Occitanie;09;1;01;064;Bouan;38;0;38
76;Occitanie;09;3;03;065;Boussenac;214;4;218
76;Occitanie;09;1;13;066;Brassac;632;10;642
76;Occitanie;09;2;10;067;Brie;219;4;223
76;Occitanie;09;1;13;068;Burret;39;1;40
76;Occitanie;09;3;04;069;Buzan;29;0;29
76;Occitanie;09;1;01;070;Les Cabannes;333;9;342
76;Occitanie;09;3;03;071;Cadarcet;224;7;231
76;Occitanie;09;1;13;072;Calzan;32;0;32
76;Occitanie;09;3;02;073;Camarade;182;0;182
76;Occitanie;09;2;06;074;Camon;143;1;144
76;Occitanie;09;3;02;075;Campagne-sur-Arize;272;8;280
76;Occitanie;09;2;10;076;Canté;205;7;212
76;Occitanie;09;1;12;077;Capoulet-et-Junac;168;1;169
76;Occitanie;09;1;01;078;Carcanières;76;2;78
76;Occitanie;09;3;02;079;Carla-Bayle;780;14;794
76;Occitanie;09;2;09;080;Carla-de-Roquefort;169;2;171
76;Occitanie;09;2;08;081;Le Carlaret;277;11;288
76;Occitanie;09;3;03;082;Castelnau-Durban;449;7;456
76;Occitanie;09;3;02;083;Castéras;24;0;24
76;Occitanie;09;3;02;084;Castex;94;1;95
76;Occitanie;09;3;04;085;Castillon-en-Couserans;400;5;405
76;Occitanie;09;3;11;086;Caumont;326;5;331
76;Occitanie;09;1;01;087;Caussou;54;0;54
76;Occitanie;09;1;01;088;Caychax;14;0;14
76;Occitanie;09;2;06;089;Cazals-des-Baylès;56;2;58
76;Occitanie;09;1;13;090;Cazaux;39;5;44
76;Occitanie;09;3;11;091;Cazavet;223;3;226
76;Occitanie;09;1;12;092;Cazenave-Serres-et-Allens;51;3;54
76;Occitanie;09;1;12;093;Celles;148;0;148
76;Occitanie;09;3;11;094;Cérizols;142;9;151
76;Occitanie;09;3;04;095;Cescau;141;1;142
76;Occitanie;09;1;01;096;Château-Verdun;43;3;46
76;Occitanie;09;3;03;097;Clermont;114;0;114
76;Occitanie;09;3;11;098;Contrazy;69;2;71
76;Occitanie;09;1;05;099;Cos;393;19;412
76;Occitanie;09;3;03;100;Couflens;86;1;87
76;Occitanie;09;1;13;101;Coussa;265;3;268
76;Occitanie;09;2;06;102;Coutens;172;2;174
76;Occitanie;09;1;13;103;Crampagna;840;18;858
76;Occitanie;09;1;13;104;Dalou;772;20;792
76;Occitanie;09;3;02;105;Daumazan-sur-Arize;719;12;731
76;Occitanie;09;2;09;106;Dreuilhe;355;16;371
76;Occitanie;09;2;06;107;Dun;586;14;600
76;Occitanie;09;3;03;108;Durban-sur-Arize;185;2;187
76;Occitanie;09;3;02;109;Durfort;146;1;147
76;Occitanie;09;3;03;110;Encourtiech;90;4;94
76;Occitanie;09;3;04;111;Engomer;297;4;301
76;Occitanie;09;3;03;113;Ercé;539;3;542
76;Occitanie;09;3;03;114;Erp;121;2;123
76;Occitanie;09;2;06;115;Esclagne;146;3;149
76;Occitanie;09;2;07;116;Escosse;417;10;427
76;Occitanie;09;2;10;117;Esplas;103;6;109
76;Occitanie;09;3;03;118;Esplas-de-Sérou;182;4;186
76;Occitanie;09;3;04;119;Eycheil;550;6;556
76;Occitanie;09;3;11;120;Fabas;351;4;355
76;Occitanie;09;1;05;121;Ferrières-sur-Ariège;771;99;870
76;Occitanie;09;1;05;122;Foix;9532;331;9863
76;Occitanie;09;3;02;123;Fornex;113;1;114
76;Occitanie;09;3;02;124;Le Fossat;1037;13;1050
76;Occitanie;09;2;09;125;Fougax-et-Barrineuf;436;5;441
76;Occitanie;09;1;09;126;Freychenet;90;2;92
76;Occitanie;09;3;02;127;Gabre;123;4;127
76;Occitanie;09;3;11;128;Gajan;309;10;319
76;Occitanie;09;3;04;129;Galey;117;0;117
76;Occitanie;09;1;05;130;Ganac;718;9;727
76;Occitanie;09;1;01;131;Garanou;159;0;159
76;Occitanie;09;2;10;132;Gaudiès;243;4;247
76;Occitanie;09;1;12;133;Génat;21;1;22
76;Occitanie;09;1;12;134;Gestiès;28;1;29
76;Occitanie;09;1;12;136;Gourbit;76;3;79
76;Occitanie;09;1;13;137;Gudas;183;4;187
76;Occitanie;09;1;13;138;L' Herm;201;19;220
76;Occitanie;09;1;01;139;L' Hospitalet-près-l'Andorre;95;0;95
76;Occitanie;09;1;01;140;Ignaux;113;2;115
76;Occitanie;09;2;09;142;Ilhat;111;2;113
76;Occitanie;09;3;04;141;Illartein;73;0;73
76;Occitanie;09;1;12;143;Illier-et-Laramade;25;0;25
76;Occitanie;09;2;08;145;Les Issards;236;5;241
76;Occitanie;09;2;10;146;Justiniac;55;0;55
76;Occitanie;09;2;10;147;Labatut;176;1;177
76;Occitanie;09;3;11;148;Lacave;145;6;151
76;Occitanie;09;3;03;149;Lacourt;196;5;201
76;Occitanie;09;2;06;150;Lagarde;194;6;200
76;Occitanie;09;3;02;151;Lanoux;50;1;51
76;Occitanie;09;1;12;152;Lapège;29;0;29
76;Occitanie;09;2;06;153;Lapenne;127;4;131
76;Occitanie;09;3;03;154;Larbont;57;2;59
76;Occitanie;09;1;01;155;Larcat;44;0;44
76;Occitanie;09;1;01;156;Larnat;21;0;21
76;Occitanie;09;2;06;157;Laroque-d'Olmes;2433;53;2486
76;Occitanie;09;3;11;158;Lasserre;247;7;254
76;Occitanie;09;1;01;159;Lassur;87;2;89
76;Occitanie;09;2;09;160;Lavelanet;6137;168;6305
76;Occitanie;09;2;06;161;Léran;591;23;614
76;Occitanie;09;1;12;162;Lercoul;22;0;22
76;Occitanie;09;2;07;163;Lescousse;75;2;77
76;Occitanie;09;3;03;164;Lescure;499;21;520
76;Occitanie;09;2;09;165;Lesparrou;232;1;233
76;Occitanie;09;2;09;166;Leychert;99;6;105
76;Occitanie;09;3;02;167;Lézat-sur-Lèze;2323;30;2353
76;Occitanie;09;2;09;168;Lieurac;190;5;195
76;Occitanie;09;2;06;169;Limbrassac;133;3;136
76;Occitanie;09;2;10;170;Lissac;246;6;252
76;Occitanie;09;1;01;171;Lordat;68;0;68
76;Occitanie;09;3;11;289;Lorp-Sentaraille;1467;34;1501
76;Occitanie;09;3;02;172;Loubaut;28;0;28
76;Occitanie;09;1;13;173;Loubens;274;5;279
76;Occitanie;09;1;13;174;Loubières;337;13;350
76;Occitanie;09;2;08;175;Ludiès;90;4;94
76;Occitanie;09;1;01;176;Luzenac;538;15;553
76;Occitanie;09;2;07;177;Madière;211;5;216
76;Occitanie;09;2;06;178;Malegoude;46;4;50
76;Occitanie;09;1;13;179;Malléon;73;1;74
76;Occitanie;09;2;06;180;Manses;126;1;127
76;Occitanie;09;3;02;181;Le Mas-d'Azil;1166;11;1177
76;Occitanie;09;3;03;182;Massat;659;8;667
76;Occitanie;09;3;11;183;Mauvezin-de-Prat;102;1;103
76;Occitanie;09;3;11;184;Mauvezin-de-Sainte-Croix;36;0;36
76;Occitanie;09;2;10;185;Mazères;3877;62;3939
76;Occitanie;09;3;02;186;Méras;111;0;111
76;Occitanie;09;3;11;187;Mercenac;363;14;377
76;Occitanie;09;1;12;188;Mercus-Garrabet;1199;24;1223
76;Occitanie;09;1;01;189;Mérens-les-Vals;168;4;172
76;Occitanie;09;3;11;190;Mérigon;115;0;115
76;Occitanie;09;1;12;192;Miglos;117;3;120
76;Occitanie;09;1;01;193;Mijanès;59;0;59
76;Occitanie;09;2;06;194;Mirepoix;3158;141;3299
76;Occitanie;09;3;02;195;Monesple;27;0;27
76;Occitanie;09;3;03;196;Montagagne;76;0;76
76;Occitanie;09;1;01;197;Montaillou;17;1;18
76;Occitanie;09;3;11;198;Montardit;190;4;194
76;Occitanie;09;2;10;199;Montaut;715;19;734
76;Occitanie;09;2;06;200;Montbel;110;2;112
76;Occitanie;09;3;04;201;Montégut-en-Couserans;76;1;77
76;Occitanie;09;1;13;202;Montégut-Plantaurel;335;9;344
76;Occitanie;09;3;03;203;Montels;158;9;167
76;Occitanie;09;3;11;204;Montesquieu-Avantès;245;5;250
76;Occitanie;09;3;02;205;Montfa;82;2;84
76;Occitanie;09;2;09;206;Montferrier;495;13;508
76;Occitanie;09;1;05;207;Montgaillard;1463;30;1493
76;Occitanie;09;3;11;208;Montgauch;122;0;122
76;Occitanie;09;3;11;209;Montjoie-en-Couserans;1082;32;1114
76;Occitanie;09;1;12;210;Montoulieu;410;7;417
76;Occitanie;09;2;09;211;Montségur;119;1;120
76;Occitanie;09;3;03;212;Montseron;94;0;94
76;Occitanie;09;2;06;213;Moulin-Neuf;238;2;240
76;Occitanie;09;3;04;214;Moulis;761;12;773
76;Occitanie;09;2;09;215;Nalzen;136;4;140
76;Occitanie;09;3;03;216;Nescus;62;1;63
76;Occitanie;09;1;12;217;Niaux;165;2;167
76;Occitanie;09;1;01;218;Orgeix;87;1;88
76;Occitanie;09;3;04;219;Orgibet;187;5;192
76;Occitanie;09;1;01;220;Orlu;160;3;163
76;Occitanie;09;1;01;221;Ornolac-Ussat-les-Bains;236;1;237
76;Occitanie;09;1;12;222;Orus;25;0;25
76;Occitanie;09;3;03;223;Oust;545;7;552
76;Occitanie;09;3;02;224;Pailhès;472;8;480
76;Occitanie;09;2;99;225;Pamiers;15675;470;16145
76;Occitanie;09;1;01;226;Pech;37;0;37
76;Occitanie;09;2;09;227;Péreille;210;5;215
76;Occitanie;09;1;01;228;Perles-et-Castelet;223;3;226
76;Occitanie;09;2;06;229;Le Peyrat;473;8;481
76;Occitanie;09;1;01;230;Le Pla;55;1;56
76;Occitanie;09;3;03;231;Le Port;154;1;155
76;Occitanie;09;1;01;232;Prades;33;0;33
76;Occitanie;09;2;06;233;Pradettes;50;0;50
76;Occitanie;09;1;13;234;Pradières;115;0;115
76;Occitanie;09;3;11;235;Prat-Bonrepaux;917;18;935
76;Occitanie;09;1;12;236;Prayols;371;17;388
76;Occitanie;09;1;01;237;Le Puch;29;0;29
76;Occitanie;09;2;08;238;Les Pujols;805;17;822
76;Occitanie;09;1;01;239;Quérigut;133;4;137
76;Occitanie;09;1;12;240;Quié;302;3;305
76;Occitanie;09;1;12;241;Rabat-les-Trois-Seigneurs;356;5;361
76;Occitanie;09;2;09;242;Raissac;48;1;49
76;Occitanie;09;2;06;243;Régat;85;3;88
76;Occitanie;09;2;06;244;Rieucros;702;8;710
76;Occitanie;09;1;07;245;Rieux-de-Pelleport;1304;27;1331
76;Occitanie;09;3;03;246;Rimont;530;21;551
76;Occitanie;09;3;03;247;Rivèrenert;170;9;179
76;Occitanie;09;2;09;249;Roquefixade;149;4;153
76;Occitanie;09;2;09;250;Roquefort-les-Cascades;91;2;93
76;Occitanie;09;2;06;251;Roumengoux;166;8;174
76;Occitanie;09;1;01;252;Rouze;85;1;86
76;Occitanie;09;3;02;253;Sabarat;361;5;366
76;Occitanie;09;2;08;254;Saint-Amadou;241;7;248
76;Occitanie;09;2;07;255;Saint-Amans;46;2;48
76;Occitanie;09;1;07;256;Saint-Bauzeil;57;0;57
76;Occitanie;09;1;13;258;Saint-Félix-de-Rieutord;460;9;469
76;Occitanie;09;2;06;259;Saint-Félix-de-Tournegat;142;4;146
76;Occitanie;09;3;04;261;Saint-Girons;6383;398;6781
76;Occitanie;09;2;09;262;Saint-Jean-d'Aigues-Vives;387;6;393
76;Occitanie;09;1;13;264;Saint-Jean-de-Verges;1249;28;1277
76;Occitanie;09;3;04;263;Saint-Jean-du-Castillonnais;23;1;24
76;Occitanie;09;2;07;265;Saint-Jean-du-Falga;2934;68;3002
76;Occitanie;09;2;06;266;Saint-Julien-de-Gras-Capou;54;1;55
76;Occitanie;09;3;04;267;Saint-Lary;131;2;133
76;Occitanie;09;3;11;268;Saint-Lizier;1418;34;1452
76;Occitanie;09;2;07;270;Saint-Martin-d'Oydes;226;4;230
76;Occitanie;09;1;13;269;Saint-Martin-de-Caralp;357;9;366
76;Occitanie;09;2;07;271;Saint-Michel;72;4;76
76;Occitanie;09;1;12;272;Saint-Paul-de-Jarrat;1313;27;1340
76;Occitanie;09;1;05;273;Saint-Pierre-de-Rivière;644;22;666
76;Occitanie;09;2;06;274;Saint-Quentin-la-Tour;337;6;343
76;Occitanie;09;2;10;275;Saint-Quirc;368;7;375
76;Occitanie;09;2;07;276;Saint-Victor-Rouzaud;231;9;240
76;Occitanie;09;3;02;277;Saint-Ybars;667;12;679
76;Occitanie;09;3;11;257;Sainte-Croix-Volvestre;626;16;642
76;Occitanie;09;2;06;260;Sainte-Foi;26;0;26
76;Occitanie;09;3;02;342;Sainte-Suzanne;238;3;241
76;Occitanie;09;3;04;279;Salsein;44;0;44
76;Occitanie;09;1;12;280;Saurat;636;10;646
76;Occitanie;09;2;09;281;Sautel;109;2;111
76;Occitanie;09;2;10;282;Saverdun;4844;171;5015
76;Occitanie;09;1;01;283;Savignac-les-Ormeaux;371;14;385
76;Occitanie;09;1;13;284;Ségura;184;2;186
76;Occitanie;09;3;03;285;Seix;702;14;716
76;Occitanie;09;1;01;287;Senconac;12;0;12
76;Occitanie;09;3;04;290;Sentein;150;3;153
76;Occitanie;09;3;03;291;Sentenac-d'Oust;108;3;111
76;Occitanie;09;3;03;292;Sentenac-de-Sérou;52;0;52
76;Occitanie;09;1;13;293;Serres-sur-Arget;687;11;698
76;Occitanie;09;3;02;294;Sieuras;96;1;97
76;Occitanie;09;1;12;295;Siguer;98;0;98
76;Occitanie;09;3;04;297;Sor;29;0;29
76;Occitanie;09;1;01;298;Sorgeat;82;2;84
76;Occitanie;09;3;03;299;Soueix-Rogalle;418;9;427
76;Occitanie;09;1;09;300;Soula;177;7;184
76;Occitanie;09;3;03;301;Soulan;373;3;376
76;Occitanie;09;1;12;303;Surba;325;8;333
76;Occitanie;09;3;03;304;Suzan;16;1;17
76;Occitanie;09;2;06;305;Tabre;368;8;376
76;Occitanie;09;1;12;306;Tarascon-sur-Ariège;3044;32;3076
76;Occitanie;09;3;11;307;Taurignan-Castet;165;2;167
76;Occitanie;09;3;11;308;Taurignan-Vieux;206;8;214
76;Occitanie;09;2;06;309;Teilhet;154;2;156
76;Occitanie;09;3;02;310;Thouars-sur-Arize;52;3;55
76;Occitanie;09;1;01;311;Tignac;25;2;27
76;Occitanie;09;2;08;312;La Tour-du-Crieu;3167;74;3241
76;Occitanie;09;3;11;313;Tourtouse;146;7;153
76;Occitanie;09;2;06;314;Tourtrol;298;8;306
76;Occitanie;09;2;10;315;Trémoulet;125;0;125
76;Occitanie;09;2;06;316;Troye-d'Ariège;86;2;88
76;Occitanie;09;1;01;318;Unac;120;2;122
76;Occitanie;09;2;07;319;Unzent;117;4;121
76;Occitanie;09;1;01;320;Urs;33;1;34
76;Occitanie;09;1;01;321;Ussat;322;4;326
76;Occitanie;09;3;03;322;Ustou;301;11;312
76;Occitanie;09;1;12;334;Val-de-Sos;627;64;691
76;Occitanie;09;2;06;323;Vals;98;1;99
76;Occitanie;09;1;13;324;Varilhes;3424;55;3479
76;Occitanie;09;1;01;325;Vaychis;22;1;23
76;Occitanie;09;1;01;326;Vèbre;125;2;127
76;Occitanie;09;1;13;327;Ventenac;235;2;237
76;Occitanie;09;1;01;328;Verdun;221;9;230
76;Occitanie;09;1;13;329;Vernajoul;654;21;675
76;Occitanie;09;1;01;330;Vernaux;28;1;29
76;Occitanie;09;2;10;331;Le Vernet;708;3;711
76;Occitanie;09;1;13;332;Verniolle;2288;65;2353
76;Occitanie;09;3;04;335;Villeneuve;36;0;36
76;Occitanie;09;2;09;336;Villeneuve-d'Olmes;989;18;1007
76;Occitanie;09;3;02;338;Villeneuve-du-Latou;158;4;162
76;Occitanie;09;2;10;339;Villeneuve-du-Paréage;765;14;779
76;Occitanie;09;1;13;340;Vira;160;5;165
76;Occitanie;09;2;06;341;Viviès;124;0;124
44;Grand Est;10;1;03;002;Ailleville;251;6;257
44;Grand Est;10;3;01;003;Aix-Villemaur-Pâlis;3554;38;3592
44;Grand Est;10;3;02;004;Allibaudières;209;2;211
44;Grand Est;10;1;17;005;Amance;274;13;287
44;Grand Est;10;3;02;006;Arcis-sur-Aube;2870;80;2950
44;Grand Est;10;1;03;007;Arconville;105;2;107
44;Grand Est;10;1;17;008;Argançon;108;1;109
44;Grand Est;10;3;08;009;Arrelles;86;2;88
44;Grand Est;10;1;05;010;Arrembécourt;50;2;52
44;Grand Est;10;1;03;011;Arrentières;214;1;215
44;Grand Est;10;1;03;012;Arsonval;322;5;327
44;Grand Est;10;3;08;013;Assenay;146;2;148
44;Grand Est;10;3;05;014;Assencières;171;3;174
44;Grand Est;10;3;02;015;Aubeterre;357;7;364
44;Grand Est;10;1;05;017;Aulnay;129;3;132
44;Grand Est;10;3;01;018;Auxon;1005;10;1015
44;Grand Est;10;2;11;020;Avant-lès-Marcilly;508;11;519
44;Grand Est;10;3;02;021;Avant-lès-Ramerupt;157;4;161
44;Grand Est;10;3;08;022;Avirey-Lingey;206;9;215
44;Grand Est;10;2;11;023;Avon-la-Pèze;193;7;200
44;Grand Est;10;3;08;024;Avreuil;165;3;168
44;Grand Est;10;3;08;025;Bagneux-la-Fosse;168;8;176
44;Grand Est;10;1;05;026;Bailly-le-Franc;37;0;37
44;Grand Est;10;1;05;027;Balignicourt;61;5;66
44;Grand Est;10;3;08;028;Balnot-la-Grange;120;0;120
44;Grand Est;10;3;08;029;Balnot-sur-Laignes;155;1;156
44;Grand Est;10;1;03;033;Bar-sur-Aube;4902;173;5075
44;Grand Est;10;3;04;034;Bar-sur-Seine;3018;184;3202
44;Grand Est;10;3;11;030;Barberey-Saint-Sulpice;1449;20;1469
44;Grand Est;10;2;07;031;Barbuise;465;8;473
44;Grand Est;10;1;03;032;Baroville;306;9;315
44;Grand Est;10;1;03;035;Bayel;758;10;768
44;Grand Est;10;3;01;037;Bercenay-en-Othe;477;12;489
44;Grand Est;10;2;11;038;Bercenay-le-Hayer;191;2;193
44;Grand Est;10;1;03;039;Bergères;123;1;124
44;Grand Est;10;3;08;040;Bernon;164;7;171
44;Grand Est;10;3;04;041;Bertignolles;52;1;53
44;Grand Est;10;3;01;042;Bérulle;234;5;239
44;Grand Est;10;2;06;043;Bessy;140;2;142
44;Grand Est;10;1;05;044;Bétignicourt;33;0;33
44;Grand Est;10;1;17;045;Beurey;195;9;204
44;Grand Est;10;1;05;046;Blaincourt-sur-Aube;109;1;110
44;Grand Est;10;1;05;047;Blignicourt;40;1;41
44;Grand Est;10;1;03;048;Bligny;160;7;167
44;Grand Est;10;3;08;049;Les Bordes-Aumont;543;8;551
44;Grand Est;10;1;17;050;Bossancourt;206;3;209
44;Grand Est;10;3;08;051;Bouilly;1074;48;1122
44;Grand Est;10;2;06;052;Boulages;221;4;225
44;Grand Est;10;3;17;053;Bouranton;572;10;582
44;Grand Est;10;2;11;054;Bourdenay;117;1;118
44;Grand Est;10;3;04;055;Bourguignons;283;12;295
44;Grand Est;10;3;05;056;Bouy-Luxembourg;228;1;229
44;Grand Est;10;2;07;057;Bouy-sur-Orvin;56;1;57
44;Grand Est;10;3;08;058;Bragelogne-Beauvoir;243;9;252
44;Grand Est;10;1;05;059;Braux;108;4;112
44;Grand Est;10;3;17;060;Bréviandes;2826;54;2880
44;Grand Est;10;3;05;061;Brévonnes;686;11;697
44;Grand Est;10;3;04;062;Briel-sur-Barse;206;2;208
44;Grand Est;10;1;05;063;Brienne-la-Vieille;423;13;436
44;Grand Est;10;1;05;064;Brienne-le-Château;2826;26;2852
44;Grand Est;10;3;02;065;Brillecourt;89;1;90
44;Grand Est;10;3;01;066;Bucey-en-Othe;430;10;440
44;Grand Est;10;3;17;067;Buchères;1688;33;1721
44;Grand Est;10;3;04;068;Buxeuil;130;6;136
44;Grand Est;10;3;04;069;Buxières-sur-Arce;121;0;121
44;Grand Est;10;3;04;070;Celles-sur-Ource;505;15;520
44;Grand Est;10;3;04;071;Chacenay;49;2;51
44;Grand Est;10;1;03;072;La Chaise;37;0;37
44;Grand Est;10;1;05;073;Chalette-sur-Voire;133;2;135
44;Grand Est;10;3;01;074;Chamoy;508;7;515
44;Grand Est;10;1;17;078;Champ-sur-Barse;27;0;27
44;Grand Est;10;2;06;075;Champfleury;102;5;107
44;Grand Est;10;1;03;076;Champignol-lez-Mondeville;276;7;283
44;Grand Est;10;3;02;077;Champigny-sur-Aube;106;2;108
44;Grand Est;10;3;08;079;Channes;123;1;124
44;Grand Est;10;3;08;080;Chaource;1081;14;1095
44;Grand Est;10;3;14;081;La Chapelle-Saint-Luc;12319;77;12396
44;Grand Est;10;2;06;082;Chapelle-Vallon;243;4;247
44;Grand Est;10;3;04;083;Chappes;322;4;326
44;Grand Est;10;3;02;084;Charmont-sous-Barbuise;1017;26;1043
44;Grand Est;10;2;11;085;Charmoy;70;0;70
44;Grand Est;10;2;06;086;Charny-le-Bachot;258;8;266
44;Grand Est;10;3;08;087;Chaserey;54;1;55
44;Grand Est;10;2;06;089;Châtres;699;13;712
44;Grand Est;10;2;06;090;Chauchigny;246;2;248
44;Grand Est;10;3;02;091;Chaudrey;144;3;147
44;Grand Est;10;3;04;092;Chauffour-lès-Bailly;122;0;122
44;Grand Est;10;1;03;093;Chaumesnil;103;2;105
44;Grand Est;10;1;05;094;Chavanges;591;12;603
44;Grand Est;10;3;02;095;Le Chêne;293;5;298
44;Grand Est;10;3;01;096;Chennegy;438;8;446
44;Grand Est;10;3;04;097;Chervey;164;4;168
44;Grand Est;10;3;08;098;Chesley;325;9;334
44;Grand Est;10;3;01;099;Chessy-les-Prés;501;8;509
44;Grand Est;10;3;17;100;Clérey;1100;21;1121
44;Grand Est;10;3;02;101;Coclois;178;3;181
44;Grand Est;10;1;03;102;Colombé-la-Fosse;192;4;196
44;Grand Est;10;1;03;103;Colombé-le-Sec;149;1;150
44;Grand Est;10;3;08;104;Cormost;307;2;309
44;Grand Est;10;1;05;105;Courcelles-sur-Voire;27;1;28
44;Grand Est;10;2;07;106;Courceroy;127;1;128
44;Grand Est;10;3;01;107;Coursan-en-Othe;105;0;105
44;Grand Est;10;3;01;108;Courtaoult;83;0;83
44;Grand Est;10;3;04;109;Courtenot;231;8;239
44;Grand Est;10;3;17;110;Courteranges;570;9;579
44;Grand Est;10;3;04;111;Courteron;105;5;110
44;Grand Est;10;3;08;112;Coussegrey;190;2;192
44;Grand Est;10;1;03;113;Couvignon;202;6;208
44;Grand Est;10;2;09;114;Crancey;719;14;733
44;Grand Est;10;3;06;115;Creney-près-Troyes;1845;31;1876
44;Grand Est;10;3;08;116;Crésantignes;312;5;317
44;Grand Est;10;1;03;117;Crespy-le-Neuf;153;7;160
44;Grand Est;10;3;01;118;Les Croûtes;97;4;101
44;Grand Est;10;3;04;119;Cunfin;177;4;181
44;Grand Est;10;3;08;120;Cussangy;239;7;246
44;Grand Est;10;3;02;121;Dampierre;301;7;308
44;Grand Est;10;3;01;122;Davrey;237;3;240
44;Grand Est;10;1;05;123;Dienville;881;16;897
44;Grand Est;10;2;11;124;Dierrey-Saint-Julien;261;13;274
44;Grand Est;10;3;11;125;Dierrey-Saint-Pierre;298;5;303
44;Grand Est;10;1;17;126;Dolancourt;136;4;140
44;Grand Est;10;3;02;127;Dommartin-le-Coq;62;0;62
44;Grand Est;10;1;05;128;Donnement;77;1;78
44;Grand Est;10;3;05;129;Dosches;295;9;304
44;Grand Est;10;3;02;130;Dosnon;106;6;112
44;Grand Est;10;2;06;131;Droupt-Saint-Basle;355;4;359
44;Grand Est;10;2;06;132;Droupt-Sainte-Marie;236;5;241
44;Grand Est;10;3;01;133;Eaux-Puiseaux;255;10;265
44;Grand Est;10;2;11;134;Échemines;94;6;100
44;Grand Est;10;1;03;135;Éclance;101;3;104
44;Grand Est;10;3;04;136;Éguilly-sous-Bois;117;2;119
44;Grand Est;10;1;03;137;Engente;36;0;36
44;Grand Est;10;1;05;138;Épagne;136;2;138
44;Grand Est;10;1;03;139;Épothémont;179;1;180
44;Grand Est;10;3;01;140;Ervy-le-Châtel;1193;9;1202
44;Grand Est;10;3;04;141;Essoyes;715;9;724
44;Grand Est;10;3;01;142;Estissac;1855;19;1874
44;Grand Est;10;3;08;143;Étourvy;173;5;178
44;Grand Est;10;2;06;144;Étrelles-sur-Aube;155;3;158
44;Grand Est;10;2;11;145;Faux-Villecerf;221;2;223
44;Grand Est;10;2;11;146;Fay-lès-Marcilly;87;3;90
44;Grand Est;10;3;08;147;Fays-la-Chapelle;130;4;134
44;Grand Est;10;2;07;148;Ferreux-Quincey;399;10;409
44;Grand Est;10;3;02;149;Feuges;332;4;336
44;Grand Est;10;1;03;150;Fontaine;258;6;264
44;Grand Est;10;2;06;151;Fontaine-les-Grès;876;9;885
44;Grand Est;10;2;07;153;Fontaine-Mâcon;652;15;667
44;Grand Est;10;2;07;154;Fontenay-de-Bossery;72;1;73
44;Grand Est;10;3;04;155;Fontette;206;9;215
44;Grand Est;10;3;01;156;Fontvannes;717;8;725
44;Grand Est;10;2;11;157;La Fosse-Corduan;218;6;224
44;Grand Est;10;3;04;158;Fouchères;531;16;547
44;Grand Est;10;3;04;159;Fralignes;87;1;88
44;Grand Est;10;1;03;160;Fravaux;47;1;48
44;Grand Est;10;1;03;161;Fresnay;47;3;50
44;Grand Est;10;3;17;162;Fresnoy-le-Château;279;6;285
44;Grand Est;10;1;03;163;Fuligny;45;2;47
44;Grand Est;10;2;09;164;Gélannes;736;11;747
44;Grand Est;10;3;05;165;Géraudot;337;6;343
44;Grand Est;10;2;06;166;Les Grandes-Chapelles;393;6;399
44;Grand Est;10;3;02;167;Grandville;95;1;96
44;Grand Est;10;3;08;168;Les Granges;75;0;75
44;Grand Est;10;2;07;169;Gumery;233;8;241
44;Grand Est;10;3;04;170;Gyé-sur-Seine;492;8;500
44;Grand Est;10;1;05;171;Hampigny;238;9;247
44;Grand Est;10;3;02;172;Herbisse;166;1;167
44;Grand Est;10;3;02;174;Isle-Aubigny;179;3;182
44;Grand Est;10;3;17;173;Isle-Aumont;472;8;480
44;Grand Est;10;1;05;175;Jasseines;177;3;180
44;Grand Est;10;1;03;176;Jaucourt;166;7;173
44;Grand Est;10;3;08;177;Javernant;150;7;157
44;Grand Est;10;1;17;178;Jessains;275;9;284
44;Grand Est;10;3;08;179;Jeugny;490;10;500
44;Grand Est;10;1;05;180;Joncreuil;92;4;96
44;Grand Est;10;3;04;181;Jully-sur-Sarce;238;10;248
44;Grand Est;10;1;03;182;Juvancourt;122;1;123
44;Grand Est;10;1;05;183;Juvanzé;35;1;36
44;Grand Est;10;1;03;184;Juzanvigny;127;1;128
44;Grand Est;10;3;08;185;Lagesse;205;3;208
44;Grand Est;10;3;08;186;Laines-aux-Bois;523;15;538
44;Grand Est;10;3;04;187;Landreville;441;11;452
44;Grand Est;10;3;08;188;Lantages;230;7;237
44;Grand Est;10;1;05;189;Lassicourt;63;0;63
44;Grand Est;10;3;17;190;Laubressel;539;5;544
44;Grand Est;10;3;06;191;Lavau;943;10;953
44;Grand Est;10;1;05;192;Lentilles;125;1;126
44;Grand Est;10;1;05;193;Lesmont;306;7;313
44;Grand Est;10;1;03;194;Lévigny;96;2;98
44;Grand Est;10;3;02;195;Lhuître;298;4;302
44;Grand Est;10;3;08;196;Lignières;212;1;213
44;Grand Est;10;1;03;197;Lignol-le-Château;199;9;208
44;Grand Est;10;3;08;198;Lirey;104;3;107
44;Grand Est;10;3;04;199;Loches-sur-Ource;353;8;361
44;Grand Est;10;1;17;200;La Loge-aux-Chèvres;84;0;84
44;Grand Est;10;3;08;201;La Loge-Pomblin;68;0;68
44;Grand Est;10;3;08;202;Les Loges-Margueron;201;64;265
44;Grand Est;10;1;03;203;Longchamp-sur-Aujon;420;6;426
44;Grand Est;10;3;08;204;Longeville-sur-Mogne;158;0;158
44;Grand Est;10;1;17;205;Longpré-le-Sec;85;2;87
44;Grand Est;10;3;02;206;Longsols;125;1;126
44;Grand Est;10;2;06;207;Longueville-sur-Aube;123;3;126
44;Grand Est;10;2;07;208;La Louptière-Thénard;289;8;297
44;Grand Est;10;3;17;209;Lusigny-sur-Barse;2167;55;2222
44;Grand Est;10;3;02;210;Luyères;452;6;458
44;Grand Est;10;3;11;211;Macey;964;16;980
44;Grand Est;10;3;08;212;Machy;115;4;119
44;Grand Est;10;3;04;213;Magnant;162;5;167
44;Grand Est;10;1;05;214;Magnicourt;82;1;83
44;Grand Est;10;1;17;215;Magny-Fouchard;267;4;271
44;Grand Est;10;3;02;216;Mailly-le-Camp;1579;37;1616
44;Grand Est;10;1;17;217;Maison-des-Champs;33;0;33
44;Grand Est;10;3;08;218;Maisons-lès-Chaource;158;3;161
44;Grand Est;10;1;03;219;Maisons-lès-Soulaines;63;3;66
44;Grand Est;10;2;09;220;Maizières-la-Grande-Paroisse;1492;45;1537
44;Grand Est;10;1;05;221;Maizières-lès-Brienne;164;0;164
44;Grand Est;10;3;01;222;Maraye-en-Othe;446;3;449
44;Grand Est;10;2;11;223;Marcilly-le-Hayer;725;9;734
44;Grand Est;10;2;11;224;Marigny-le-Châtel;1752;33;1785
44;Grand Est;10;2;07;225;Marnay-sur-Seine;229;6;235
44;Grand Est;10;3;04;226;Marolles-lès-Bailly;106;2;108
44;Grand Est;10;3;01;227;Marolles-sous-Lignières;333;5;338
44;Grand Est;10;1;05;228;Mathaux;200;2;202
44;Grand Est;10;3;08;229;Maupas;105;2;107
44;Grand Est;10;3;06;230;Mergey;690;11;701
44;Grand Est;10;2;07;231;Le Mériot;614;10;624
44;Grand Est;10;3;04;232;Merrey-sur-Arce;321;4;325
44;Grand Est;10;2;06;233;Méry-sur-Seine;1526;49;1575
44;Grand Est;10;2;06;234;Mesgrigny;292;1;293
44;Grand Est;10;3;02;235;Mesnil-la-Comtesse;45;0;45
44;Grand Est;10;3;02;236;Mesnil-Lettre;58;1;59
44;Grand Est;10;2;11;237;Mesnil-Saint-Loup;600;29;629
44;Grand Est;10;3;17;238;Mesnil-Saint-Père;496;6;502
44;Grand Est;10;3;05;239;Mesnil-Sellières;584;10;594
44;Grand Est;10;3;01;240;Messon;466;11;477
44;Grand Est;10;3;08;241;Metz-Robert;61;0;61
44;Grand Est;10;1;03;242;Meurville;173;3;176
44;Grand Est;10;1;05;243;Molins-sur-Aube;108;5;113
44;Grand Est;10;3;17;245;Montaulin;807;25;832
44;Grand Est;10;3;08;246;Montceaux-lès-Vaudes;256;16;272
44;Grand Est;10;3;01;247;Montfey;134;3;137
44;Grand Est;10;3;11;248;Montgueux;399;11;410
44;Grand Est;10;1;03;250;Montier-en-l'Isle;235;6;241
44;Grand Est;10;3;17;249;Montiéramey;403;7;410
44;Grand Est;10;3;01;251;Montigny-les-Monts;250;5;255
44;Grand Est;10;1;17;252;Montmartin-le-Haut;53;2;55
44;Grand Est;10;1;05;253;Montmorency-Beaufort;137;1;138
44;Grand Est;10;2;07;254;Montpothier;331;9;340
44;Grand Est;10;3;17;255;Montreuil-sur-Barse;298;13;311
44;Grand Est;10;3;02;256;Montsuzain;409;4;413
44;Grand Est;10;3;02;257;Morembert;31;0;31
44;Grand Est;10;1;03;258;Morvilliers;300;7;307
44;Grand Est;10;2;07;259;La Motte-Tilly;372;3;375
44;Grand Est;10;3;17;260;Moussey;638;16;654
44;Grand Est;10;3;04;261;Mussy-sur-Seine;1019;15;1034
44;Grand Est;10;3;04;262;Neuville-sur-Seine;454;10;464
44;Grand Est;10;3;01;263;Neuville-sur-Vanne;423;5;428
44;Grand Est;10;3;04;264;Noé-les-Mallets;117;1;118
44;Grand Est;10;3;13;265;Les Noës-près-Troyes;3282;33;3315
44;Grand Est;10;3;01;266;Nogent-en-Othe;46;3;49
44;Grand Est;10;3;02;267;Nogent-sur-Aube;322;4;326
44;Grand Est;10;2;07;268;Nogent-sur-Seine;5980;117;6097
44;Grand Est;10;3;02;269;Nozay;148;5;153
44;Grand Est;10;3;05;270;Onjon;250;6;256
44;Grand Est;10;2;11;271;Origny-le-Sec;606;11;617
44;Grand Est;10;3;02;272;Ormes;181;3;184
44;Grand Est;10;3;02;273;Ortillon;24;0;24
44;Grand Est;10;2;11;274;Orvilliers-Saint-Julien;311;4;315
44;Grand Est;10;2;11;275;Ossey-les-Trois-Maisons;592;7;599
44;Grand Est;10;3;01;276;Paisy-Cosdon;338;6;344
44;Grand Est;10;3;08;278;Pargues;138;2;140
44;Grand Est;10;1;05;279;Pars-lès-Chavanges;66;4;70
44;Grand Est;10;2;09;280;Pars-lès-Romilly;824;9;833
44;Grand Est;10;3;11;281;Le Pavillon-Sainte-Julie;291;8;299
44;Grand Est;10;3;11;282;Payns;1363;19;1382
44;Grand Est;10;1;05;283;Pel-et-Der;133;2;135
44;Grand Est;10;2;07;284;Périgny-la-Rose;140;3;143
44;Grand Est;10;1;05;285;Perthes-lès-Brienne;81;3;84
44;Grand Est;10;1;03;286;Petit-Mesnil;216;7;223
44;Grand Est;10;3;05;287;Piney;1484;16;1500
44;Grand Est;10;3;04;288;Plaines-Saint-Lange;261;1;262
44;Grand Est;10;2;06;289;Plancy-l'Abbaye;973;17;990
44;Grand Est;10;3;01;290;Planty;242;6;248
44;Grand Est;10;2;07;291;Plessis-Barbuise;202;4;206
44;Grand Est;10;3;02;293;Poivres;159;2;161
44;Grand Est;10;3;04;294;Poligny;64;2;66
44;Grand Est;10;3;04;295;Polisot;326;5;331
44;Grand Est;10;3;04;296;Polisy;193;9;202
44;Grand Est;10;3;15;297;Pont-Sainte-Marie;5166;129;5295
44;Grand Est;10;2;07;298;Pont-sur-Seine;1161;20;1181
44;Grand Est;10;3;02;299;Pouan-les-Vallées;539;17;556
44;Grand Est;10;3;02;300;Pougy;290;2;292
44;Grand Est;10;2;11;301;Pouy-sur-Vannes;156;4;160
44;Grand Est;10;3;08;302;Praslin;90;2;92
44;Grand Est;10;1;05;303;Précy-Notre-Dame;82;2;84
44;Grand Est;10;1;05;304;Précy-Saint-Martin;187;2;189
44;Grand Est;10;2;06;305;Prémierfait;88;3;91
44;Grand Est;10;1;03;306;Proverville;239;6;245
44;Grand Est;10;3;01;307;Prugny;375;11;386
44;Grand Est;10;2;11;308;Prunay-Belleville;217;8;225
44;Grand Est;10;3;08;309;Prusy;94;1;95
44;Grand Est;10;1;17;310;Puits-et-Nuisement;214;5;219
44;Grand Est;10;3;01;312;Racines;167;6;173
44;Grand Est;10;1;05;313;Radonvilliers;376;2;378
44;Grand Est;10;3;02;314;Ramerupt;408;5;413
44;Grand Est;10;1;05;315;Rances;44;2;46
44;Grand Est;10;2;06;316;Rhèges;232;4;236
44;Grand Est;10;3;08;317;Les Riceys;1243;24;1267
44;Grand Est;10;2;11;318;Rigny-la-Nonneuse;171;1;172
44;Grand Est;10;3;01;319;Rigny-le-Ferron;352;6;358
44;Grand Est;10;2;06;320;Rilly-Sainte-Syre;233;5;238
44;Grand Est;10;3;10;321;La Rivière-de-Corps;3396;107;3503
44;Grand Est;10;2;09;323;Romilly-sur-Seine;14451;305;14756
44;Grand Est;10;3;08;324;Roncenay;159;2;161
44;Grand Est;10;3;10;325;Rosières-près-Troyes;4165;342;4507
44;Grand Est;10;1;05;326;Rosnay-l'Hôpital;181;9;190
44;Grand Est;10;1;03;327;La Rothière;109;1;110
44;Grand Est;10;3;05;328;Rouilly-Sacey;386;4;390
44;Grand Est;10;3;17;329;Rouilly-Saint-Loup;517;46;563
44;Grand Est;10;1;03;330;Rouvres-les-Vignes;106;2;108
44;Grand Est;10;3;04;331;Rumilly-lès-Vaudes;542;10;552
44;Grand Est;10;3;17;332;Ruvigny;494;11;505
44;Grand Est;10;3;10;333;Saint-André-les-Vergers;12311;188;12499
44;Grand Est;10;2;07;334;Saint-Aubin;588;8;596
44;Grand Est;10;3;01;335;Saint-Benoist-sur-Vanne;237;6;243
44;Grand Est;10;3;06;336;Saint-Benoît-sur-Seine;400;5;405
44;Grand Est;10;1;05;337;Saint-Christophe-Dodinicourt;34;1;35
44;Grand Est;10;3;02;338;Saint-Étienne-sous-Barbuise;167;3;170
44;Grand Est;10;2;11;339;Saint-Flavy;283;6;289
44;Grand Est;10;3;10;340;Saint-Germain;2304;50;2354
44;Grand Est;10;2;09;341;Saint-Hilaire-sous-Romilly;351;9;360
44;Grand Est;10;3;08;342;Saint-Jean-de-Bonneval;396;8;404
44;Grand Est;10;3;15;343;Saint-Julien-les-Villas;6811;140;6951
44;Grand Est;10;3;17;344;Saint-Léger-près-Troyes;880;14;894
44;Grand Est;10;1;05;345;Saint-Léger-sous-Brienne;386;11;397
44;Grand Est;10;1;05;346;Saint-Léger-sous-Margerie;59;6;65
44;Grand Est;10;2;11;347;Saint-Loup-de-Buffigny;210;6;216
44;Grand Est;10;2;11;348;Saint-Lupien;236;0;236
44;Grand Est;10;3;11;349;Saint-Lyé;2915;62;2977
44;Grand Est;10;3;01;350;Saint-Mards-en-Othe;640;10;650
44;Grand Est;10;2;11;351;Saint-Martin-de-Bossenay;368;5;373
44;Grand Est;10;2;06;353;Saint-Mesmin;843;10;853
44;Grand Est;10;3;02;354;Saint-Nabord-sur-Aube;139;5;144
44;Grand Est;10;2;07;355;Saint-Nicolas-la-Chapelle;66;0;66
44;Grand Est;10;2;06;356;Saint-Oulph;287;8;295
44;Grand Est;10;3;15;357;Saint-Parres-aux-Tertres;3126;52;3178
44;Grand Est;10;3;04;358;Saint-Parres-lès-Vaudes;1004;14;1018
44;Grand Est;10;3;01;359;Saint-Phal;523;11;534
44;Grand Est;10;3;08;360;Saint-Pouange;914;221;1135
44;Grand Est;10;3;02;361;Saint-Remy-sous-Barbuise;231;5;236
44;Grand Est;10;3;17;363;Saint-Thibault;555;7;562
44;Grand Est;10;3;04;364;Saint-Usage;76;2;78
44;Grand Est;10;3;06;352;Sainte-Maure;1655;301;1956
44;Grand Est;10;3;13;362;Sainte-Savine;10573;438;11011
44;Grand Est;10;2;06;365;Salon;120;1;121
44;Grand Est;10;1;03;366;Saulcy;68;1;69
44;Grand Est;10;2;07;367;La Saulsotte;704;3;707
44;Grand Est;10;2;06;368;Savières;1005;11;1016
44;Grand Est;10;3;02;369;Semoine;199;6;205
44;Grand Est;10;2;07;370;Soligny-les-Étangs;239;6;245
44;Grand Est;10;3;08;371;Sommeval;311;5;316
44;Grand Est;10;1;03;372;Soulaines-Dhuys;413;6;419
44;Grand Est;10;3;08;373;Souligny;400;21;421
44;Grand Est;10;1;03;374;Spoy;177;1;178
44;Grand Est;10;3;17;375;Thennelières;338;10;348
44;Grand Est;10;3;04;376;Thieffrain;154;3;157
44;Grand Est;10;1;03;377;Thil;114;9;123
44;Grand Est;10;1;03;378;Thors;71;3;74
44;Grand Est;10;3;02;379;Torcy-le-Grand;443;10;453
44;Grand Est;10;3;02;380;Torcy-le-Petit;82;4;86
44;Grand Est;10;3;10;381;Torvilliers;969;17;986
44;Grand Est;10;2;07;382;Traînel;1062;13;1075
44;Grand Est;10;2;11;383;Trancault;186;3;189
44;Grand Est;10;1;17;384;Trannes;243;5;248
44;Grand Est;10;3;02;386;Trouans;228;7;235
44;Grand Est;10;3;99;387;Troyes;61652;1176;62828
44;Grand Est;10;3;08;388;Turgy;45;1;46
44;Grand Est;10;1;05;389;Unienville;125;4;129
44;Grand Est;10;1;03;390;Urville;130;2;132
44;Grand Est;10;3;06;391;Vailly;287;10;297
44;Grand Est;10;3;05;019;Val-d'Auzon;381;5;386
44;Grand Est;10;2;06;392;Vallant-Saint-Georges;384;9;393
44;Grand Est;10;1;05;393;Vallentigny;183;3;186
44;Grand Est;10;3;08;394;Vallières;150;1;151
44;Grand Est;10;3;08;395;Vanlay;304;2;306
44;Grand Est;10;3;01;396;Vauchassis;503;5;508
44;Grand Est;10;1;17;397;Vauchonvilliers;158;2;160
44;Grand Est;10;3;02;398;Vaucogne;74;4;78
44;Grand Est;10;3;04;399;Vaudes;716;8;724
44;Grand Est;10;3;02;400;Vaupoisson;120;5;125
44;Grand Est;10;1;17;401;Vendeuvre-sur-Barse;2317;38;2355
44;Grand Est;10;3;08;402;La Vendue-Mignot;250;5;255
44;Grand Est;10;1;03;403;Vernonvilliers;58;1;59
44;Grand Est;10;3;04;404;Verpillières-sur-Ource;109;2;111
44;Grand Est;10;3;02;405;Verricourt;53;0;53
44;Grand Est;10;3;17;406;Verrières;1870;35;1905
44;Grand Est;10;2;06;408;Viâpres-le-Petit;126;5;131
44;Grand Est;10;3;06;409;Villacerf;589;4;593
44;Grand Est;10;2;11;410;Villadin;112;4;116
44;Grand Est;10;1;03;411;La Ville-aux-Bois;30;0;30
44;Grand Est;10;1;03;426;Ville-sous-la-Ferté;1066;13;1079
44;Grand Est;10;3;04;427;Ville-sur-Arce;212;12;224
44;Grand Est;10;1;03;428;Ville-sur-Terre;103;2;105
44;Grand Est;10;3;06;412;Villechétif;927;13;940
44;Grand Est;10;3;11;414;Villeloup;121;5;126
44;Grand Est;10;3;08;416;Villemereuil;247;9;256
44;Grand Est;10;3;01;417;Villemoiron-en-Othe;198;8;206
44;Grand Est;10;3;04;418;Villemorien;207;6;213
44;Grand Est;10;3;04;419;Villemoyenne;776;8;784
44;Grand Est;10;2;07;420;Villenauxe-la-Grande;2721;31;2752
44;Grand Est;10;2;07;421;La Villeneuve-au-Châtelot;146;4;150
44;Grand Est;10;3;01;422;Villeneuve-au-Chemin;185;2;187
44;Grand Est;10;1;17;423;La Villeneuve-au-Chêne;424;12;436
44;Grand Est;10;1;05;424;Villeret;63;2;65
44;Grand Est;10;3;08;425;Villery;275;3;278
44;Grand Est;10;3;02;429;Villette-sur-Aube;258;3;261
44;Grand Est;10;3;02;430;Villiers-Herbisse;87;3;90
44;Grand Est;10;3;08;431;Villiers-le-Bois;96;1;97
44;Grand Est;10;3;08;432;Villiers-sous-Praslin;71;0;71
44;Grand Est;10;3;04;433;Villy-en-Trodes;246;8;254
44;Grand Est;10;3;08;434;Villy-le-Bois;55;0;55
44;Grand Est;10;3;08;435;Villy-le-Maréchal;188;4;192
44;Grand Est;10;3;02;436;Vinets;170;6;176
44;Grand Est;10;3;04;437;Virey-sous-Bar;621;9;630
44;Grand Est;10;3;04;438;Vitry-le-Croisé;234;5;239
44;Grand Est;10;3;04;439;Viviers-sur-Artaut;128;4;132
44;Grand Est;10;1;03;440;Voigny;158;6;164
44;Grand Est;10;3;01;441;Vosnon;233;2;235
44;Grand Est;10;3;02;442;Voué;681;8;689
44;Grand Est;10;3;08;443;Vougrey;48;3;51
44;Grand Est;10;3;01;444;Vulaines;225;3;228
44;Grand Est;10;1;05;445;Yèvres-le-Petit;57;9;66
76;Occitanie;11;1;15;001;Aigues-Vives;584;7;591
76;Occitanie;11;1;05;002;Airoux;163;2;165
76;Occitanie;11;2;09;003;Ajac;187;3;190
76;Occitanie;11;2;01;004;Alaigne;326;9;335
76;Occitanie;11;1;04;005;Alairac;1330;33;1363
76;Occitanie;11;3;07;006;Albas;77;2;79
76;Occitanie;11;3;07;007;Albières;118;4;122
76;Occitanie;11;2;09;008;Alet-les-Bains;406;3;409
76;Occitanie;11;1;10;009;Alzonne;1522;21;1543
76;Occitanie;11;2;14;010;Antugnac;268;6;274
76;Occitanie;11;1;19;011;Aragon;433;12;445
76;Occitanie;11;3;16;012;Argeliers;2139;31;2170
76;Occitanie;11;3;08;013;Argens-Minervois;347;6;353
76;Occitanie;11;3;06;014;Armissan;1520;30;1550
76;Occitanie;11;2;14;015;Arques;254;3;257
76;Occitanie;11;1;18;016;Arquettes-en-Val;79;2;81
76;Occitanie;11;2;14;017;Artigues;73;5;78
76;Occitanie;11;1;10;018;Arzens;1238;18;1256
76;Occitanie;11;2;14;019;Aunat;67;0;67
76;Occitanie;11;3;07;020;Auriac;43;0;43
76;Occitanie;11;2;14;021;Axat;547;11;558
76;Occitanie;11;1;15;022;Azille;1144;23;1167
76;Occitanie;11;1;18;023;Badens;785;15;800
76;Occitanie;11;3;12;024;Bages;803;16;819
76;Occitanie;11;1;15;025;Bagnoles;308;3;311
76;Occitanie;11;1;01;026;Baraigne;174;3;177
76;Occitanie;11;1;18;027;Barbaira;750;19;769
76;Occitanie;11;2;14;028;Belcaire;394;11;405
76;Occitanie;11;2;09;029;Belcastel-et-Buc;58;2;60
76;Occitanie;11;1;01;030;Belflou;121;6;127
76;Occitanie;11;2;14;031;Belfort-sur-Rebenty;26;1;27
76;Occitanie;11;2;01;032;Bellegarde-du-Razès;238;2;240
76;Occitanie;11;1;01;033;Belpech;1273;12;1285
76;Occitanie;11;2;01;034;Belvèze-du-Razès;868;8;876
76;Occitanie;11;2;14;035;Belvianes-et-Cavirac;255;6;261
76;Occitanie;11;2;14;036;Belvis;160;3;163
76;Occitanie;11;1;18;037;Berriac;954;10;964
76;Occitanie;11;2;14;038;Bessède-de-Sault;47;0;47
76;Occitanie;11;2;09;039;La Bezole;44;1;45
76;Occitanie;11;3;11;040;Bizanet;1685;28;1713
76;Occitanie;11;3;16;041;Bize-Minervois;1185;16;1201
76;Occitanie;11;1;18;042;Blomac;227;6;233
76;Occitanie;11;1;18;043;Bouilhonnac;227;6;233
76;Occitanie;11;3;07;044;Bouisse;100;0;100
76;Occitanie;11;2;09;045;Bouriège;127;1;128
76;Occitanie;11;2;09;046;Bourigeole;51;0;51
76;Occitanie;11;2;14;047;Le Bousquet;44;1;45
76;Occitanie;11;3;07;048;Boutenac;721;16;737
76;Occitanie;11;1;01;049;Bram;3204;82;3286
76;Occitanie;11;1;01;051;Brézilhac;174;4;178
76;Occitanie;11;1;10;052;Brousses-et-Villaret;344;5;349
76;Occitanie;11;2;01;053;Brugairolles;273;5;278
76;Occitanie;11;1;10;054;Les Brunels;273;11;284
76;Occitanie;11;2;14;055;Bugarach;228;4;232
76;Occitanie;11;1;15;056;Cabrespine;176;4;180
76;Occitanie;11;1;01;057;Cahuzac;32;0;32
76;Occitanie;11;2;01;058;Cailhau;266;9;275
76;Occitanie;11;2;01;059;Cailhavel;132;1;133
76;Occitanie;11;2;14;060;Cailla;48;1;49
76;Occitanie;11;2;01;061;Cambieure;304;4;308
76;Occitanie;11;2;14;062;Campagna-de-Sault;19;0;19
76;Occitanie;11;2;14;063;Campagne-sur-Aude;581;5;586
76;Occitanie;11;3;07;064;Camplong-d'Aude;367;5;372
76;Occitanie;11;2;14;065;Camps-sur-l'Agly;55;1;56
76;Occitanie;11;2;14;066;Camurac;98;0;98
76;Occitanie;11;3;16;067;Canet;1778;18;1796
76;Occitanie;11;1;18;068;Capendu;1468;66;1534
76;Occitanie;11;1;98;069;Carcassonne;46031;1334;47365
76;Occitanie;11;1;10;070;Carlipa;340;5;345
76;Occitanie;11;3;07;071;Cascastel-des-Corbières;221;7;228
76;Occitanie;11;1;01;072;La Cassaigne;169;8;177
76;Occitanie;11;2;14;073;Cassaignes;56;0;56
76;Occitanie;11;1;05;074;Les Cassés;295;2;297
76;Occitanie;11;1;15;075;Castans;134;2;136
76;Occitanie;11;3;08;077;Castelnau-d'Aude;491;9;500
76;Occitanie;11;1;05;076;Castelnaudary;11598;538;12136
76;Occitanie;11;2;09;078;Castelreng;207;7;214
76;Occitanie;11;1;19;079;Caudebronde;189;2;191
76;Occitanie;11;1;15;081;Caunes-Minervois;1654;35;1689
76;Occitanie;11;2;09;082;Caunette-sur-Lauquet;4;0;4
76;Occitanie;11;1;18;083;Caunettes-en-Val;44;1;45
76;Occitanie;11;1;10;084;Caux-et-Sauzens;979;23;1002
76;Occitanie;11;1;03;085;Cavanac;923;38;961
76;Occitanie;11;3;17;086;Caves;875;13;888
76;Occitanie;11;1;01;087;Cazalrenoux;91;1;92
76;Occitanie;11;1;03;088;Cazilhac;1648;52;1700
76;Occitanie;11;1;10;089;Cenne-Monestiés;401;7;408
76;Occitanie;11;2;09;090;Cépie;646;17;663
76;Occitanie;11;2;14;091;Chalabre;1118;12;1130
76;Occitanie;11;1;15;092;Citou;89;1;90
76;Occitanie;11;2;14;093;Le Clat;31;2;33
76;Occitanie;11;2;09;094;Clermont-sur-Lauquet;26;0;26
76;Occitanie;11;1;18;095;Comigne;305;7;312
76;Occitanie;11;2;14;096;Comus;43;3;46
76;Occitanie;11;3;08;098;Conilhac-Corbières;917;19;936
76;Occitanie;11;1;19;099;Conques-sur-Orbiel;2525;54;2579
76;Occitanie;11;2;14;100;Corbières;27;1;28
76;Occitanie;11;2;14;101;Coudons;52;1;53
76;Occitanie;11;1;03;102;Couffoulens;601;8;609
76;Occitanie;11;2;14;103;Couiza;1111;26;1137
76;Occitanie;11;2;14;104;Counozouls;48;0;48
76;Occitanie;11;2;09;105;Cournanel;714;10;724
76;Occitanie;11;3;06;106;Coursan;5908;93;6001
76;Occitanie;11;2;14;107;Courtauly;73;1;74
76;Occitanie;11;2;01;108;La Courtète;45;1;46
76;Occitanie;11;2;14;109;Coustaussa;52;1;53
76;Occitanie;11;3;07;110;Coustouge;121;0;121
76;Occitanie;11;3;08;111;Cruscades;926;6;932
76;Occitanie;11;2;14;112;Cubières-sur-Cinoble;96;1;97
76;Occitanie;11;3;07;113;Cucugnan;123;5;128
76;Occitanie;11;1;01;114;Cumiès;36;2;38
76;Occitanie;11;1;10;115;Cuxac-Cabardès;911;24;935
76;Occitanie;11;3;06;116;Cuxac-d'Aude;4030;70;4100
76;Occitanie;11;3;07;117;Davejean;117;1;118
76;Occitanie;11;3;07;118;Dernacueillette;41;2;43
76;Occitanie;11;2;09;119;La Digne-d'Amont;287;7;294
76;Occitanie;11;2;09;120;La Digne-d'Aval;536;4;540
76;Occitanie;11;2;01;121;Donazac;109;1;110
76;Occitanie;11;1;18;122;Douzens;733;12;745
76;Occitanie;11;3;07;123;Duilhac-sous-Peyrepertuse;146;2;148
76;Occitanie;11;3;07;124;Durban-Corbières;649;11;660
76;Occitanie;11;3;07;125;Embres-et-Castelmaure;152;0;152
76;Occitanie;11;3;08;126;Escales;465;4;469
76;Occitanie;11;2;14;127;Escouloubre;73;3;76
76;Occitanie;11;2;01;128;Escueillens-et-Saint-Just-de-Bélengard;156;2;158
76;Occitanie;11;2;14;129;Espéraza;1870;33;1903
76;Occitanie;11;2;14;130;Espezel;206;4;210
76;Occitanie;11;3;07;132;Fabrezan;1291;17;1308
76;Occitanie;11;1;18;133;Fajac-en-Val;38;0;38
76;Occitanie;11;1;01;134;Fajac-la-Relenque;50;4;54
76;Occitanie;11;2;14;135;La Fajolle;11;1;12
76;Occitanie;11;1;01;136;Fanjeaux;834;88;922
76;Occitanie;11;3;07;137;Félines-Termenès;117;4;121
76;Occitanie;11;1;05;138;Fendeille;532;16;548
76;Occitanie;11;1;01;139;Fenouillet-du-Razès;85;0;85
76;Occitanie;11;3;07;140;Ferrals-les-Corbières;1192;18;1210
76;Occitanie;11;1;01;141;Ferran;111;1;112
76;Occitanie;11;2;09;142;Festes-et-Saint-André;206;6;212
76;Occitanie;11;3;17;143;Feuilla;104;0;104
76;Occitanie;11;3;17;144;Fitou;1060;12;1072
76;Occitanie;11;3;06;145;Fleury;3825;63;3888
76;Occitanie;11;1;18;146;Floure;407;8;415
76;Occitanie;11;2;14;147;Fontanès-de-Sault;5;0;5
76;Occitanie;11;3;07;148;Fontcouverte;546;10;556
76;Occitanie;11;1;01;149;Fonters-du-Razès;79;1;80
76;Occitanie;11;1;10;150;Fontiers-Cabardès;454;50;504
76;Occitanie;11;1;18;151;Fontiès-d'Aude;481;10;491
76;Occitanie;11;3;07;152;Fontjoncouse;131;4;135
76;Occitanie;11;1;01;153;La Force;222;3;225
76;Occitanie;11;1;19;154;Fournes-Cabardès;50;0;50
76;Occitanie;11;2;14;155;Fourtou;73;1;74
76;Occitanie;11;1;10;156;Fraisse-Cabardès;104;2;106
76;Occitanie;11;3;07;157;Fraissé-des-Corbières;220;5;225
76;Occitanie;11;2;09;158;Gaja-et-Villedieu;292;11;303
76;Occitanie;11;1;01;159;Gaja-la-Selve;143;2;145
76;Occitanie;11;2;14;160;Galinagues;35;0;35
76;Occitanie;11;2;09;161;Gardie;121;3;124
76;Occitanie;11;1;01;162;Generville;60;1;61
76;Occitanie;11;2;14;163;Gincla;48;0;48
76;Occitanie;11;3;16;164;Ginestas;1445;20;1465
76;Occitanie;11;2;14;165;Ginoles;303;13;316
76;Occitanie;11;1;01;166;Gourvieille;76;0;76
76;Occitanie;11;2;01;167;Gramazie;117;2;119
76;Occitanie;11;2;14;168;Granès;97;0;97
76;Occitanie;11;2;09;169;Greffeil;79;5;84
76;Occitanie;11;3;12;170;Gruissan;5000;63;5063
76;Occitanie;11;3;08;172;Homps;591;11;602
76;Occitanie;11;1;01;173;Hounoux;136;3;139
76;Occitanie;11;1;19;174;Les Ilhes;52;0;52
76;Occitanie;11;1;05;175;Issel;488;9;497
76;Occitanie;11;3;07;176;Jonquières;59;2;61
76;Occitanie;11;2;14;177;Joucou;35;1;36
76;Occitanie;11;1;05;178;Labastide-d'Anjou;1326;15;1341
76;Occitanie;11;1;18;179;Labastide-en-Val;92;2;94
76;Occitanie;11;1;19;180;Labastide-Esparbairenque;73;0;73
76;Occitanie;11;1;10;181;Labécède-Lauragais;412;9;421
76;Occitanie;11;1;10;182;Lacombe;172;3;175
76;Occitanie;11;2;09;183;Ladern-sur-Lauquet;266;9;275
76;Occitanie;11;1;01;184;Lafage;89;3;92
76;Occitanie;11;3;07;185;Lagrasse;545;9;554
76;Occitanie;11;3;07;186;Lairière;52;2;54
76;Occitanie;11;3;07;187;Lanet;50;1;51
76;Occitanie;11;1;10;189;Laprade;95;1;96
76;Occitanie;11;3;07;191;Laroque-de-Fa;151;7;158
76;Occitanie;11;1;05;192;Lasbordes;788;30;818
76;Occitanie;11;1;01;193;Lasserre-de-Prouille;267;3;270
76;Occitanie;11;1;19;194;Lastours;159;3;162
76;Occitanie;11;1;01;195;Laurabuc;412;9;421
76;Occitanie;11;1;01;196;Laurac;175;8;183
76;Occitanie;11;2;01;197;Lauraguel;609;16;625
76;Occitanie;11;1;15;198;Laure-Minervois;1055;15;1070
76;Occitanie;11;1;04;199;Lavalette;1499;26;1525
76;Occitanie;11;1;15;200;Lespinassière;133;7;140
76;Occitanie;11;1;03;201;Leuc;849;15;864
76;Occitanie;11;3;17;202;Leucate;4428;57;4485
76;Occitanie;11;3;08;203;Lézignan-Corbières;11168;164;11332
76;Occitanie;11;2;01;204;Lignairolles;43;0;43
76;Occitanie;11;1;15;205;Limousis;129;2;131
76;Occitanie;11;2;09;206;Limoux;10066;548;10614
76;Occitanie;11;2;09;207;Loupia;240;5;245
76;Occitanie;11;1;01;208;La Louvière-Lauragais;77;2;79
76;Occitanie;11;2;14;209;Luc-sur-Aude;246;7;253
76;Occitanie;11;3;07;210;Luc-sur-Orbieu;1144;10;1154
76;Occitanie;11;2;09;211;Magrie;528;10;538
76;Occitanie;11;3;16;212;Mailhac;567;10;577
76;Occitanie;11;3;07;213;Maisons;46;0;46
76;Occitanie;11;2;09;214;Malras;396;12;408
76;Occitanie;11;1;19;215;Malves-en-Minervois;854;25;879
76;Occitanie;11;2;01;216;Malviès;369;12;381
76;Occitanie;11;3;16;217;Marcorignan;1300;27;1327
76;Occitanie;11;1;01;218;Marquein;82;0;82
76;Occitanie;11;2;14;219;Marsa;18;0;18
76;Occitanie;11;1;18;220;Marseillette;712;14;726
76;Occitanie;11;1;19;221;Les Martys;293;5;298
76;Occitanie;11;1;19;222;Mas-Cabardès;185;4;189
76;Occitanie;11;1;03;223;Mas-des-Cours;25;0;25
76;Occitanie;11;1;05;225;Mas-Saintes-Puelles;922;22;944
76;Occitanie;11;3;07;224;Massac;29;1;30
76;Occitanie;11;1;01;226;Mayreville;75;3;78
76;Occitanie;11;1;18;227;Mayronnes;35;1;36
76;Occitanie;11;2;01;228;Mazerolles-du-Razès;154;4;158
76;Occitanie;11;2;14;229;Mazuby;25;1;26
76;Occitanie;11;2;14;230;Mérial;31;0;31
76;Occitanie;11;1;01;231;Mézerville;95;0;95
76;Occitanie;11;1;19;232;Miraval-Cabardès;46;0;46
76;Occitanie;11;3;16;233;Mirepeisset;769;6;775
76;Occitanie;11;1;01;234;Mireval-Lauragais;171;5;176
76;Occitanie;11;2;14;235;Missègre;63;2;65
76;Occitanie;11;1;01;236;Molandier;237;6;243
76;Occitanie;11;1;01;238;Molleville;130;6;136
76;Occitanie;11;1;01;239;Montauriol;88;2;90
76;Occitanie;11;2;14;240;Montazels;560;10;570
76;Occitanie;11;3;08;241;Montbrun-des-Corbières;309;2;311
76;Occitanie;11;1;04;242;Montclar;171;0;171
76;Occitanie;11;1;05;243;Montferrand;565;9;574
76;Occitanie;11;2;14;244;Montfort-sur-Boulzane;88;3;91
76;Occitanie;11;3;07;245;Montgaillard;42;0;42
76;Occitanie;11;2;01;246;Montgradail;47;0;47
76;Occitanie;11;2;01;247;Monthaut;38;0;38
76;Occitanie;11;1;18;248;Montirat;74;1;75
76;Occitanie;11;2;14;249;Montjardin;87;1;88
76;Occitanie;11;3;07;250;Montjoi;37;1;38
76;Occitanie;11;1;05;252;Montmaur;307;9;316
76;Occitanie;11;1;10;253;Montolieu;846;15;861
76;Occitanie;11;1;10;254;Montréal;1896;174;2070
76;Occitanie;11;3;11;255;Montredon-des-Corbières;1477;15;1492
76;Occitanie;11;3;07;256;Montséret;594;12;606
76;Occitanie;11;1;18;257;Monze;227;2;229
76;Occitanie;11;3;16;258;Moussan;1940;46;1986
76;Occitanie;11;1;10;259;Moussoulens;1018;30;1048
76;Occitanie;11;3;07;260;Mouthoumet;107;3;110
76;Occitanie;11;3;18;261;Moux;701;9;710
76;Occitanie;11;3;99;262;Narbonne;54700;1176;55876
76;Occitanie;11;2;14;263;Nébias;246;5;251
76;Occitanie;11;3;11;264;Névian;1301;33;1334
76;Occitanie;11;2;14;265;Niort-de-Sault;32;1;33
76;Occitanie;11;3;08;267;Ornaisons;1181;26;1207
76;Occitanie;11;1;01;268;Orsans;104;0;104
76;Occitanie;11;3;16;269;Ouveillan;2463;50;2513
76;Occitanie;11;3;07;270;Padern;132;1;133
76;Occitanie;11;3;07;271;Palairac;30;0;30
76;Occitanie;11;1;03;272;Palaja;2357;97;2454
76;Occitanie;11;3;17;188;La Palme;1693;30;1723
76;Occitanie;11;3;16;273;Paraza;622;12;634
76;Occitanie;11;2;09;274;Pauligne;357;14;371
76;Occitanie;11;1;01;275;Payra-sur-l'Hers;205;3;208
76;Occitanie;11;3;07;276;Paziols;528;7;535
76;Occitanie;11;1;01;278;Pech-Luna;75;2;77
76;Occitanie;11;1;01;277;Pécharic-et-le-Py;27;0;27
76;Occitanie;11;1;19;279;Pennautier;2554;58;2612
76;Occitanie;11;1;15;280;Pépieux;1068;28;1096
76;Occitanie;11;1;01;281;Pexiora;1226;18;1244
76;Occitanie;11;2;14;282;Peyrefitte-du-Razès;48;2;50
76;Occitanie;11;1;01;283;Peyrefitte-sur-l'Hers;75;8;83
76;Occitanie;11;1;05;284;Peyrens;496;13;509
76;Occitanie;11;3;17;285;Peyriac-de-Mer;1113;23;1136
76;Occitanie;11;1;15;286;Peyriac-Minervois;1139;20;1159
76;Occitanie;11;2;14;287;Peyrolles;86;3;89
76;Occitanie;11;1;10;288;Pezens;1525;165;1690
76;Occitanie;11;2;09;289;Pieusse;987;18;1005
76;Occitanie;11;1;01;290;Plaigne;116;1;117
76;Occitanie;11;1;01;291;Plavilla;110;4;114
76;Occitanie;11;1;05;292;La Pomarède;143;3;146
76;Occitanie;11;2;09;293;Pomas;887;23;910
76;Occitanie;11;2;01;294;Pomy;59;1;60
76;Occitanie;11;3;17;266;Port-la-Nouvelle;5567;69;5636
76;Occitanie;11;3;17;295;Portel-des-Corbières;1357;20;1377
76;Occitanie;11;3;16;296;Pouzols-Minervois;547;8;555
76;Occitanie;11;1;19;297;Pradelles-Cabardès;143;1;144
76;Occitanie;11;1;04;299;Preixan;619;9;628
76;Occitanie;11;1;05;300;Puginier;152;0;152
76;Occitanie;11;1;15;301;Puichéric;1191;19;1210
76;Occitanie;11;2;14;302;Puilaurens;271;9;280
76;Occitanie;11;2;14;303;Puivert;471;16;487
76;Occitanie;11;2;14;304;Quillan;3258;111;3369
76;Occitanie;11;3;07;305;Quintillan;52;0;52
76;Occitanie;11;2;14;306;Quirbajou;51;2;53
76;Occitanie;11;3;16;307;Raissac-d'Aude;263;5;268
76;Occitanie;11;1;10;308;Raissac-sur-Lampy;456;9;465
76;Occitanie;11;1;15;190;La Redorte;1161;19;1180
76;Occitanie;11;2;14;309;Rennes-le-Château;80;3;83
76;Occitanie;11;2;14;310;Rennes-les-Bains;205;1;206
76;Occitanie;11;3;07;311;Ribaute;276;7;283
76;Occitanie;11;1;01;312;Ribouisse;109;5;114
76;Occitanie;11;1;05;313;Ricaud;299;7;306
76;Occitanie;11;1;18;314;Rieux-en-Val;88;7;95
76;Occitanie;11;1;15;315;Rieux-Minervois;1987;28;2015
76;Occitanie;11;2;14;316;Rivel;199;3;202
76;Occitanie;11;2;14;317;Rodome;124;3;127
76;Occitanie;11;3;18;318;Roquecourbe-Minervois;132;6;138
76;Occitanie;11;1;19;319;Roquefère;79;1;80
76;Occitanie;11;2;14;320;Roquefeuil;289;4;293
76;Occitanie;11;2;14;321;Roquefort-de-Sault;84;0;84
76;Occitanie;11;3;17;322;Roquefort-des-Corbières;1024;18;1042
76;Occitanie;11;2;14;323;Roquetaillade-et-Conilhac;277;2;279
76;Occitanie;11;3;16;324;Roubia;509;13;522
76;Occitanie;11;1;04;325;Rouffiac-d'Aude;441;11;452
76;Occitanie;11;3;07;326;Rouffiac-des-Corbières;86;1;87
76;Occitanie;11;1;04;327;Roullens;465;14;479
76;Occitanie;11;2;01;328;Routier;248;6;254
76;Occitanie;11;1;15;330;Rustiques;507;12;519
76;Occitanie;11;1;01;331;Saint-Amans;64;3;67
76;Occitanie;11;3;07;332;Saint-André-de-Roquelongue;1390;17;1407
76;Occitanie;11;2;14;333;Saint-Benoît;105;3;108
76;Occitanie;11;3;18;337;Saint-Couat-d'Aude;404;4;408
76;Occitanie;11;2;09;338;Saint-Couat-du-Razès;51;1;52
76;Occitanie;11;1;10;339;Saint-Denis;512;12;524
76;Occitanie;11;2;14;341;Saint-Ferriol;116;2;118
76;Occitanie;11;1;15;342;Saint-Frichoux;255;7;262
76;Occitanie;11;1;01;343;Saint-Gaudéric;115;2;117
76;Occitanie;11;2;09;344;Saint-Hilaire;773;15;788
76;Occitanie;11;3;07;345;Saint-Jean-de-Barrou;254;0;254
76;Occitanie;11;2;14;346;Saint-Jean-de-Paracol;124;3;127
76;Occitanie;11;2;14;347;Saint-Julia-de-Bec;104;3;107
76;Occitanie;11;1;01;348;Saint-Julien-de-Briola;89;1;90
76;Occitanie;11;2;14;350;Saint-Just-et-le-Bézu;44;3;47
76;Occitanie;11;3;07;351;Saint-Laurent-de-la-Cabrerisse;736;26;762
76;Occitanie;11;2;14;352;Saint-Louis-et-Parahou;55;2;57
76;Occitanie;11;3;16;353;Saint-Marcel-sur-Aude;2005;28;2033
76;Occitanie;11;2;09;355;Saint-Martin-de-Villereglan;363;8;371
76;Occitanie;11;3;07;354;Saint-Martin-des-Puits;28;0;28
76;Occitanie;11;1;05;356;Saint-Martin-Lalande;1124;20;1144
76;Occitanie;11;1;10;357;Saint-Martin-le-Vieil;226;8;234
76;Occitanie;11;2;14;358;Saint-Martin-Lys;25;2;27
76;Occitanie;11;1;01;359;Saint-Michel-de-Lanès;464;12;476
76;Occitanie;11;3;16;360;Saint-Nazaire-d'Aude;2032;36;2068
76;Occitanie;11;1;05;361;Saint-Papoul;835;19;854
76;Occitanie;11;1;05;362;Saint-Paulet;199;4;203
76;Occitanie;11;3;07;363;Saint-Pierre-des-Champs;181;4;185
76;Occitanie;11;2;09;364;Saint-Polycarpe;147;2;149
76;Occitanie;11;1;01;365;Saint-Sernin;38;2;40
76;Occitanie;11;1;01;334;Sainte-Camelle;119;2;121
76;Occitanie;11;2;14;335;Sainte-Colombe-sur-Guette;46;0;46
76;Occitanie;11;2;14;336;Sainte-Colombe-sur-l'Hers;435;7;442
76;Occitanie;11;1;10;340;Sainte-Eulalie;506;9;515
76;Occitanie;11;3;16;366;Sainte-Valière;563;10;573
76;Occitanie;11;1;10;367;Saissac;929;26;955
76;Occitanie;11;1;15;368;Sallèles-Cabardès;119;3;122
76;Occitanie;11;3;16;369;Sallèles-d'Aude;2922;45;2967
76;Occitanie;11;3;06;370;Salles-d'Aude;3255;75;3330
76;Occitanie;11;1;01;371;Salles-sur-l'Hers;701;13;714
76;Occitanie;11;1;19;372;Salsigne;390;4;394
76;Occitanie;11;2;14;373;Salvezines;77;0;77
76;Occitanie;11;3;07;374;Salza;17;0;17
76;Occitanie;11;2;01;375;Seignalens;32;1;33
76;Occitanie;11;2;14;376;La Serpent;92;4;96
76;Occitanie;11;2;14;377;Serres;65;2;67
76;Occitanie;11;1;18;378;Serviès-en-Val;213;6;219
76;Occitanie;11;3;17;379;Sigean;5477;94;5571
76;Occitanie;11;2;14;380;Sonnac-sur-l'Hers;135;3;138
76;Occitanie;11;2;14;381;Sougraigne;112;6;118
76;Occitanie;11;1;05;382;Souilhanels;365;64;429
76;Occitanie;11;1;05;383;Souilhe;319;9;328
76;Occitanie;11;3;07;384;Soulatgé;128;0;128
76;Occitanie;11;1;05;385;Soupex;246;7;253
76;Occitanie;11;3;07;386;Talairan;467;7;474
76;Occitanie;11;1;18;387;Taurize;113;1;114
76;Occitanie;11;3;07;388;Termes;38;0;38
76;Occitanie;11;2;14;389;Terroles;17;0;17
76;Occitanie;11;3;07;390;Thézan-des-Corbières;544;10;554
76;Occitanie;11;1;19;391;La Tourette-Cabardès;23;2;25
76;Occitanie;11;3;07;392;Tournissan;272;4;276
76;Occitanie;11;3;08;393;Tourouzelle;469;6;475
76;Occitanie;11;2;09;394;Tourreilles;127;0;127
76;Occitanie;11;1;15;395;Trassanel;34;0;34
76;Occitanie;11;1;15;396;Trausse;590;3;593
76;Occitanie;11;1;18;397;Trèbes;5601;159;5760
76;Occitanie;11;3;17;398;Treilles;247;4;251
76;Occitanie;11;1;05;399;Tréville;104;5;109
76;Occitanie;11;2;14;400;Tréziers;100;1;101
76;Occitanie;11;3;07;401;Tuchan;786;11;797
76;Occitanie;11;1;18;251;Val-de-Dagne;739;11;750
76;Occitanie;11;2;14;080;Val de Lambronne;185;2;187
76;Occitanie;11;2;14;131;Val-du-Faby;562;19;581
76;Occitanie;11;2;14;402;Valmigère;17;0;17
76;Occitanie;11;1;19;404;Ventenac-Cabardès;959;45;1004
76;Occitanie;11;3;16;405;Ventenac-en-Minervois;553;10;563
76;Occitanie;11;2;09;406;Véraza;32;2;34
76;Occitanie;11;1;10;407;Verdun-en-Lauragais;273;6;279
76;Occitanie;11;1;03;408;Verzeille;493;8;501
76;Occitanie;11;3;07;409;Vignevieille;105;1;106
76;Occitanie;11;1;19;410;Villalier;1004;17;1021
76;Occitanie;11;1;19;411;Villanière;137;1;138
76;Occitanie;11;1;18;414;Villar-en-Val;26;1;27
76;Occitanie;11;2;09;415;Villar-Saint-Anselme;121;0;121
76;Occitanie;11;2;09;412;Villardebelle;53;0;53
76;Occitanie;11;1;19;413;Villardonnel;498;12;510
76;Occitanie;11;1;15;416;Villarzel-Cabardès;238;5;243
76;Occitanie;11;2;01;417;Villarzel-du-Razès;103;0;103
76;Occitanie;11;1;01;418;Villasavary;1209;28;1237
76;Occitanie;11;1;01;419;Villautou;63;0;63
76;Occitanie;11;2;09;420;Villebazy;127;2;129
76;Occitanie;11;3;11;421;Villedaigne;510;8;518
76;Occitanie;11;1;18;422;Villedubert;345;15;360
76;Occitanie;11;1;03;423;Villefloure;165;4;169
76;Occitanie;11;2;14;424;Villefort;89;1;90
76;Occitanie;11;1;19;425;Villegailhenc;1735;42;1777
76;Occitanie;11;1;15;426;Villegly;1134;23;1157
76;Occitanie;11;2;09;427;Villelongue-d'Aude;305;8;313
76;Occitanie;11;1;10;428;Villemagne;261;6;267
76;Occitanie;11;1;19;429;Villemoustaussou;4423;79;4502
76;Occitanie;11;1;05;430;Villeneuve-la-Comptal;1305;40;1345
76;Occitanie;11;3;07;431;Villeneuve-les-Corbières;242;5;247
76;Occitanie;11;1;10;432;Villeneuve-lès-Montréal;300;10;310
76;Occitanie;11;1;15;433;Villeneuve-Minervois;1019;9;1028
76;Occitanie;11;1;01;434;Villepinte;1303;24;1327
76;Occitanie;11;3;07;435;Villerouge-Termenès;147;5;152
76;Occitanie;11;3;07;436;Villesèque-des-Corbières;374;2;376
76;Occitanie;11;1;10;437;Villesèquelande;896;17;913
76;Occitanie;11;1;01;438;Villesiscle;383;6;389
76;Occitanie;11;1;10;439;Villespy;373;7;380
76;Occitanie;11;1;18;440;Villetritouls;38;3;41
76;Occitanie;11;3;06;441;Vinassan;2646;43;2689
76;Occitanie;12;1;03;001;Agen-d'Aveyron;1051;30;1081
76;Occitanie;12;1;12;002;Aguessac;867;24;891
76;Occitanie;12;3;08;003;Les Albres;346;6;352
76;Occitanie;12;3;07;004;Almont-les-Junies;464;20;484
76;Occitanie;12;1;15;006;Alrance;358;11;369
76;Occitanie;12;3;23;007;Ambeyrac;174;6;180
76;Occitanie;12;3;06;008;Anglars-Saint-Félix;820;21;841
76;Occitanie;12;2;01;223;Argences en Aubrac;1646;37;1683
76;Occitanie;12;1;04;009;Arnac-sur-Dourdou;34;1;35
76;Occitanie;12;1;15;010;Arques;135;2;137
76;Occitanie;12;1;13;011;Arvieu;783;29;812
76;Occitanie;12;3;08;012;Asprières;733;7;740
76;Occitanie;12;3;06;013;Aubin;3761;116;3877
76;Occitanie;12;1;13;015;Auriac-Lagast;229;3;232
76;Occitanie;12;3;06;016;Auzits;846;28;874
76;Occitanie;12;1;15;017;Ayssènes;216;3;219
76;Occitanie;12;3;08;018;Balaguier-d'Olt;162;6;168
76;Occitanie;12;1;04;019;Balaguier-sur-Rance;92;2;94
76;Occitanie;12;3;05;056;Baraqueville;3142;84;3226
76;Occitanie;12;3;02;021;Le Bas Ségala;1581;55;1636
76;Occitanie;12;1;19;022;La Bastide-Pradines;101;2;103
76;Occitanie;12;1;04;023;La Bastide-Solages;108;0;108
76;Occitanie;12;3;06;024;Belcastel;191;3;194
76;Occitanie;12;1;04;025;Belmont-sur-Rance;976;12;988
76;Occitanie;12;2;09;026;Bertholène;1046;21;1067
76;Occitanie;12;2;10;027;Bessuéjouls;213;8;221
76;Occitanie;12;3;07;028;Boisse-Penchot;515;10;525
76;Occitanie;12;3;02;029;Bor-et-Bar;194;4;198
76;Occitanie;12;3;08;030;Bouillac;414;16;430
76;Occitanie;12;3;06;031;Bournazel;348;5;353
76;Occitanie;12;3;05;032;Boussac;579;13;592
76;Occitanie;12;2;03;033;Bozouls;2871;61;2932
76;Occitanie;12;3;23;034;Brandonnet;319;16;335
76;Occitanie;12;1;04;035;Brasc;167;7;174
76;Occitanie;12;2;01;036;Brommat;638;8;646
76;Occitanie;12;1;15;037;Broquiès;612;16;628
76;Occitanie;12;1;15;038;Brousse-le-Château;158;4;162
76;Occitanie;12;1;04;039;Brusque;276;6;282
76;Occitanie;12;3;05;041;Cabanès;252;7;259
76;Occitanie;12;1;19;042;Calmels-et-le-Viala;208;11;219
76;Occitanie;12;3;13;043;Calmont;2053;72;2125
76;Occitanie;12;1;04;044;Camarès;1038;32;1070
76;Occitanie;12;3;05;045;Camboulazet;398;10;408
76;Occitanie;12;3;05;046;Camjac;572;15;587
76;Occitanie;12;2;20;047;Campagnac;450;6;456
76;Occitanie;12;2;01;048;Campouriez;350;7;357
76;Occitanie;12;2;10;049;Campuac;451;7;458
76;Occitanie;12;1;15;050;Canet-de-Salars;431;5;436
76;Occitanie;12;2;01;051;Cantoin;305;2;307
76;Occitanie;12;3;08;052;Capdenac-Gare;4505;123;4628
76;Occitanie;12;3;23;053;La Capelle-Balaguier;306;8;314
76;Occitanie;12;3;02;054;La Capelle-Bleys;361;8;369
76;Occitanie;12;2;20;055;La Capelle-Bonance;83;0;83
76;Occitanie;12;3;13;057;Cassagnes-Bégonhès;904;36;940
76;Occitanie;12;2;01;058;Cassuéjouls;108;5;113
76;Occitanie;12;3;05;059;Castanet;513;24;537
76;Occitanie;12;3;02;060;Castelmary;115;4;119
76;Occitanie;12;2;09;061;Castelnau-de-Mandailles;586;11;597
76;Occitanie;12;1;20;062;Castelnau-Pégayrols;333;4;337
76;Occitanie;12;3;08;257;Causse-et-Diège;758;18;776
76;Occitanie;12;1;04;063;La Cavalerie;1441;29;1470
76;Occitanie;12;2;10;064;Le Cayrol;259;4;263
76;Occitanie;12;3;05;065;Centrès;459;10;469
76;Occitanie;12;2;21;066;Clairvaux-d'Aveyron;1144;26;1170
76;Occitanie;12;1;04;067;Le Clapier;78;0;78
76;Occitanie;12;3;05;068;Colombiès;903;27;930
76;Occitanie;12;1;04;069;Combret;270;7;277
76;Occitanie;12;1;12;070;Compeyre;530;18;548
76;Occitanie;12;3;23;071;Compolibat;347;6;353
76;Occitanie;12;1;11;072;Comprégnac;249;9;258
76;Occitanie;12;1;13;073;Comps-la-Grand-Ville;624;20;644
76;Occitanie;12;2;01;074;Condom-d'Aubrac;301;13;314
76;Occitanie;12;1;13;075;Connac;109;3;112
76;Occitanie;12;2;07;076;Conques-en-Rouergue;1673;51;1724
76;Occitanie;12;1;04;077;Cornus;524;12;536
76;Occitanie;12;1;15;078;Les Costes-Gozon;186;1;187
76;Occitanie;12;2;10;079;Coubisou;492;14;506
76;Occitanie;12;1;04;080;Coupiac;392;9;401
76;Occitanie;12;1;04;082;La Couvertoirade;188;2;190
76;Occitanie;12;3;06;083;Cransac;1508;55;1563
76;Occitanie;12;1;11;084;Creissels;1591;47;1638
76;Occitanie;12;3;02;085;Crespin;312;0;312
76;Occitanie;12;1;20;086;La Cresse;317;14;331
76;Occitanie;12;1;15;307;Curan;302;14;316
76;Occitanie;12;2;01;088;Curières;226;4;230
76;Occitanie;12;3;07;089;Decazeville;5360;204;5564
76;Occitanie;12;2;21;090;Druelle Balsac;3143;91;3234
76;Occitanie;12;3;23;091;Drulhe;446;13;459
76;Occitanie;12;1;13;092;Durenque;524;9;533
76;Occitanie;12;2;10;094;Entraygues-sur-Truyère;996;14;1010
76;Occitanie;12;3;06;095;Escandolières;234;6;240
76;Occitanie;12;2;10;096;Espalion;4516;127;4643
76;Occitanie;12;2;10;097;Espeyrac;245;3;248
76;Occitanie;12;2;10;098;Estaing;473;16;489
76;Occitanie;12;1;04;099;Fayet;257;4;261
76;Occitanie;12;2;10;093;Le Fel;176;1;177
76;Occitanie;12;3;06;100;Firmi;2393;66;2459
76;Occitanie;12;3;07;101;Flagnac;1060;36;1096
76;Occitanie;12;1;14;102;Flavin;2322;48;2370
76;Occitanie;12;2;01;103;Florentin-la-Capelle;279;8;287
76;Occitanie;12;3;08;104;Foissac;476;10;486
76;Occitanie;12;1;04;155;Fondamente;327;10;337
76;Occitanie;12;3;02;105;La Fouillade;1081;25;1106
76;Occitanie;12;2;03;106;Gabriac;504;10;514
76;Occitanie;12;2;09;107;Gaillac-d'Aveyron;307;4;311
76;Occitanie;12;3;08;108;Galgan;373;7;380
76;Occitanie;12;1;04;109;Gissac;103;2;105
76;Occitanie;12;2;10;110;Golinhac;336;17;353
76;Occitanie;12;3;06;111;Goutrens;509;19;528
76;Occitanie;12;3;05;113;Gramond;498;7;505
76;Occitanie;12;1;04;115;L' Hospitalet-du-Larzac;280;2;282
76;Occitanie;12;2;01;116;Huparlac;257;7;264
76;Occitanie;12;2;01;118;Lacroix-Barrez;506;13;519
76;Occitanie;12;2;01;119;Laguiole;1242;26;1268
76;Occitanie;12;2;09;120;Laissac-Sévérac l'Église;2120;102;2222
76;Occitanie;12;3;23;121;Lanuéjouls;731;17;748
76;Occitanie;12;1;04;122;Lapanouse-de-Cernon;123;8;131
76;Occitanie;12;2;09;124;Lassouts;289;13;302
76;Occitanie;12;1;04;125;Laval-Roquecezière;282;4;286
76;Occitanie;12;1;13;127;Lédergues;644;20;664
76;Occitanie;12;3;02;128;Lescure-Jaoul;229;6;235
76;Occitanie;12;1;15;129;Lestrade-et-Thouels;493;9;502
76;Occitanie;12;3;07;130;Livinhac-le-Haut;1123;34;1157
76;Occitanie;12;2;03;131;La Loubière;1472;46;1518
76;Occitanie;12;2;14;133;Luc-la-Primaube;5969;163;6132
76;Occitanie;12;3;08;134;Lugan;337;10;347
76;Occitanie;12;3;02;135;Lunac;434;16;450
76;Occitanie;12;3;23;136;Maleville;953;18;971
76;Occitanie;12;3;05;137;Manhac;819;11;830
76;Occitanie;12;2;21;138;Marcillac-Vallon;1707;50;1757
76;Occitanie;12;1;04;139;Marnhagues-et-Latour;139;1;140
76;Occitanie;12;3;23;140;Martiel;1009;24;1033
76;Occitanie;12;1;04;141;Martrin;226;7;233
76;Occitanie;12;3;06;142;Mayran;635;15;650
76;Occitanie;12;1;04;143;Mélagues;60;0;60
76;Occitanie;12;3;05;144;Meljac;130;2;132
76;Occitanie;12;1;98;145;Millau;22109;735;22844
76;Occitanie;12;2;17;146;Le Monastère;2283;75;2358
76;Occitanie;12;1;04;147;Montagnol;133;1;134
76;Occitanie;12;3;08;148;Montbazens;1388;43;1431
76;Occitanie;12;1;04;149;Montclar;161;5;166
76;Occitanie;12;3;02;150;Monteils;542;89;631
76;Occitanie;12;2;01;151;Montézic;226;8;234
76;Occitanie;12;1;04;152;Montfranc;124;2;126
76;Occitanie;12;1;20;153;Montjaux;406;7;413
76;Occitanie;12;1;04;154;Montlaur;626;25;651
76;Occitanie;12;2;01;156;Montpeyroux;541;11;552
76;Occitanie;12;2;03;157;Montrozier;1630;47;1677
76;Occitanie;12;3;23;158;Montsalès;330;5;335
76;Occitanie;12;3;02;159;Morlhon-le-Haut;557;24;581
76;Occitanie;12;1;20;160;Mostuéjouls;315;5;320
76;Occitanie;12;1;04;192;Mounes-Prohencoux;182;8;190
76;Occitanie;12;2;21;161;Mouret;538;19;557
76;Occitanie;12;3;05;162;Moyrazès;1109;28;1137
76;Occitanie;12;2;01;164;Mur-de-Barrez;759;19;778
76;Occitanie;12;1;04;163;Murasson;194;4;198
76;Occitanie;12;2;21;165;Muret-le-Château;352;16;368
76;Occitanie;12;2;01;166;Murols;113;1;114
76;Occitanie;12;3;02;167;Najac;698;22;720
76;Occitanie;12;1;12;168;Nant;1004;19;1023
76;Occitanie;12;3;05;169;Naucelle;2004;145;2149
76;Occitanie;12;3;08;170;Naussac;373;8;381
76;Occitanie;12;2;21;171;Nauviale;553;19;572
76;Occitanie;12;2;10;172;Le Nayrac;512;12;524
76;Occitanie;12;2;14;174;Olemps;3403;92;3495
76;Occitanie;12;3;23;175;Ols-et-Rinhodes;173;2;175
76;Occitanie;12;2;18;176;Onet-le-Château;11881;574;12455
76;Occitanie;12;2;09;177;Palmas d'Aveyron;1024;15;1039
76;Occitanie;12;1;12;178;Paulhe;389;9;398
76;Occitanie;12;1;04;179;Peux-et-Couffouleux;87;1;88
76;Occitanie;12;1;20;180;Peyreleau;74;5;79
76;Occitanie;12;3;08;181;Peyrusse-le-Roc;227;5;232
76;Occitanie;12;2;09;182;Pierrefiche;274;5;279
76;Occitanie;12;1;04;183;Plaisance;221;6;227
76;Occitanie;12;2;09;184;Pomayrols;119;4;123
76;Occitanie;12;1;15;185;Pont-de-Salars;1652;43;1695
76;Occitanie;12;1;04;186;Pousthomy;211;3;214
76;Occitanie;12;2;09;187;Prades-d'Aubrac;378;4;382
76;Occitanie;12;1;15;188;Prades-Salars;309;5;314
76;Occitanie;12;3;05;189;Pradinas;360;6;366
76;Occitanie;12;3;02;190;Prévinquières;308;6;314
76;Occitanie;12;3;23;191;Privezac;323;10;333
76;Occitanie;12;2;21;193;Pruines;297;13;310
76;Occitanie;12;3;05;194;Quins;844;21;865
76;Occitanie;12;1;04;195;Rebourguil;280;4;284
76;Occitanie;12;1;13;197;Réquista;2005;94;2099
76;Occitanie;12;3;02;198;Rieupeyroux;1974;71;2045
76;Occitanie;12;3;06;199;Rignac;1946;139;2085
76;Occitanie;12;1;20;200;Rivière-sur-Tarn;1043;23;1066
76;Occitanie;12;2;03;201;Rodelle;1066;41;1107
76;Occitanie;12;2;99;202;Rodez;24057;1848;25905
76;Occitanie;12;1;20;204;La Roque-Sainte-Marguerite;182;6;188
76;Occitanie;12;1;19;203;Roquefort-sur-Soulzon;552;15;567
76;Occitanie;12;3;22;205;La Rouquette;784;32;816
76;Occitanie;12;3;08;206;Roussennac;628;17;645
76;Occitanie;12;1;13;207;Rullac-Saint-Cirq;344;5;349
76;Occitanie;12;1;19;208;Saint-Affrique;8089;657;8746
76;Occitanie;12;2;01;209;Saint-Amans-des-Cots;754;13;767
76;Occitanie;12;3;02;210;Saint-André-de-Najac;442;4;446
76;Occitanie;12;1;20;211;Saint-André-de-Vézines;135;1;136
76;Occitanie;12;1;04;212;Saint-Beaulize;89;8;97
76;Occitanie;12;1;20;213;Saint-Beauzély;596;15;611
76;Occitanie;12;2;01;214;Saint-Chély-d'Aubrac;529;14;543
76;Occitanie;12;2;21;215;Saint-Christophe-Vallon;1138;40;1178
76;Occitanie;12;2;09;216;Saint-Côme-d'Olt;1349;29;1378
76;Occitanie;12;2;07;221;Saint-Félix-de-Lunel;347;9;356
76;Occitanie;12;1;19;222;Saint-Félix-de-Sorgues;213;4;217
76;Occitanie;12;2;09;224;Saint Geniez d'Olt et d'Aubrac;2196;39;2235
76;Occitanie;12;1;11;225;Saint-Georges-de-Luzençon;1617;38;1655
76;Occitanie;12;2;10;226;Saint-Hippolyte;435;12;447
76;Occitanie;12;3;23;227;Saint-Igest;191;5;196
76;Occitanie;12;1;19;228;Saint-Izaire;303;9;312
76;Occitanie;12;1;19;229;Saint-Jean-d'Alcapiès;255;8;263
76;Occitanie;12;1;13;230;Saint-Jean-Delnous;418;16;434
76;Occitanie;12;1;12;231;Saint-Jean-du-Bruel;702;7;709
76;Occitanie;12;1;04;232;Saint-Jean-et-Saint-Paul;278;8;286
76;Occitanie;12;1;04;233;Saint-Juéry;287;3;290
76;Occitanie;12;3;05;235;Saint-Just-sur-Viaur;209;7;216
76;Occitanie;12;2;20;237;Saint-Laurent-d'Olt;646;80;726
76;Occitanie;12;1;15;236;Saint-Laurent-de-Lévézou;153;5;158
76;Occitanie;12;1;15;238;Saint-Léons;398;9;407
76;Occitanie;12;2;20;239;Saint-Martin-de-Lenne;302;12;314
76;Occitanie;12;3;07;240;Saint-Parthem;406;10;416
76;Occitanie;12;3;23;242;Saint-Rémy;317;15;332
76;Occitanie;12;1;19;243;Saint-Rome-de-Cernon;925;12;937
76;Occitanie;12;1;15;244;Saint-Rome-de-Tarn;871;17;888
76;Occitanie;12;3;07;246;Saint-Santin;555;10;565
76;Occitanie;12;2;20;247;Saint-Saturnin-de-Lenne;295;7;302
76;Occitanie;12;1;04;248;Saint-Sernin-sur-Rance;622;116;738
76;Occitanie;12;1;04;249;Saint-Sever-du-Moustier;201;8;209
76;Occitanie;12;2;01;250;Saint-Symphorien-de-Thénières;211;2;213
76;Occitanie;12;1;15;251;Saint-Victor-et-Melvieu;365;7;372
76;Occitanie;12;3;23;217;Sainte-Croix;736;18;754
76;Occitanie;12;2;09;219;Sainte-Eulalie-d'Olt;374;14;388
76;Occitanie;12;1;04;220;Sainte-Eulalie-de-Cernon;286;2;288
76;Occitanie;12;3;13;234;Sainte-Juliette-sur-Viaur;598;7;605
76;Occitanie;12;2;14;241;Sainte-Radegonde;1756;64;1820
76;Occitanie;12;3;08;252;Salles-Courbatiès;417;9;426
76;Occitanie;12;1;15;253;Salles-Curan;1043;29;1072
76;Occitanie;12;2;21;254;Salles-la-Source;2220;75;2295
76;Occitanie;12;1;13;255;Salmiech;773;24;797
76;Occitanie;12;3;23;256;Salvagnac-Cajarc;378;6;384
76;Occitanie;12;3;02;258;La Salvetat-Peyralès;976;15;991
76;Occitanie;12;3;02;259;Sanvensa;654;17;671
76;Occitanie;12;1;04;260;Sauclières;170;2;172
76;Occitanie;12;3;23;261;Saujac;125;3;128
76;Occitanie;12;3;05;262;Sauveterre-de-Rouergue;777;15;792
76;Occitanie;12;3;23;263;Savignac;721;23;744
76;Occitanie;12;2;03;264;Sébazac-Concourès;3253;90;3343
76;Occitanie;12;2;10;265;Sébrazac;506;6;512
76;Occitanie;12;1;15;266;Ségur;557;5;562
76;Occitanie;12;1;13;267;La Selve;628;12;640
76;Occitanie;12;2;07;268;Sénergues;421;16;437
76;Occitanie;12;1;04;269;La Serre;120;3;123
76;Occitanie;12;2;20;270;Sévérac d'Aveyron;4084;128;4212
76;Occitanie;12;3;08;272;Sonnac;518;10;528
76;Occitanie;12;2;01;273;Soulages-Bonneval;293;8;301
76;Occitanie;12;1;04;274;Sylvanès;111;2;113
76;Occitanie;12;1;04;275;Tauriac-de-Camarès;41;1;42
76;Occitanie;12;3;05;276;Tauriac-de-Naucelle;372;13;385
76;Occitanie;12;2;01;277;Taussac;520;4;524
76;Occitanie;12;3;02;278;Tayrac;176;2;178
76;Occitanie;12;2;01;280;Thérondels;406;7;413
76;Occitanie;12;3;23;281;Toulonjac;747;22;769
76;Occitanie;12;1;19;282;Tournemire;427;8;435
76;Occitanie;12;1;15;283;Trémouilles;504;13;517
76;Occitanie;12;1;15;284;Le Truel;345;7;352
76;Occitanie;12;1;19;286;Vabres-l'Abbaye;1200;32;1232
76;Occitanie;12;3;22;287;Vailhourles;634;20;654
76;Occitanie;12;2;21;288;Valady;1536;36;1572
76;Occitanie;12;3;08;289;Valzergues;214;11;225
76;Occitanie;12;3;23;290;Vaureilles;499;11;510
76;Occitanie;12;1;20;291;Verrières;454;8;462
76;Occitanie;12;1;19;292;Versols-et-Lapeyre;420;14;434
76;Occitanie;12;1;20;293;Veyreau;137;1;138
76;Occitanie;12;1;15;294;Vézins-de-Lévézou;656;15;671
76;Occitanie;12;1;04;295;Viala-du-Pas-de-Jaux;99;2;101
76;Occitanie;12;1;20;296;Viala-du-Tarn;504;10;514
76;Occitanie;12;1;15;297;Le Vibal;507;19;526
76;Occitanie;12;2;10;298;Villecomtal;403;8;411
76;Occitanie;12;1;15;299;Villefranche-de-Panat;703;27;730
76;Occitanie;12;3;22;300;Villefranche-de-Rouergue;11867;624;12491
76;Occitanie;12;3;23;301;Villeneuve;1988;47;2035
76;Occitanie;12;2;09;303;Vimenet;244;8;252
76;Occitanie;12;3;07;305;Viviez;1274;33;1307
93;Provence-Alpes-Côte d'Azur;13;1;97;001;Aix-en-Provence;142482;3194;145676
93;Provence-Alpes-Côte d'Azur;13;3;03;002;Allauch;21187;207;21394
93;Provence-Alpes-Côte d'Azur;13;1;25;003;Alleins;2512;50;2562
93;Provence-Alpes-Côte d'Azur;13;2;04;004;Arles;52548;770;53318
93;Provence-Alpes-Côte d'Azur;13;3;05;005;Aubagne;46209;412;46621
93;Provence-Alpes-Côte d'Azur;13;2;26;006;Aureille;1522;27;1549
93;Provence-Alpes-Côte d'Azur;13;3;03;007;Auriol;11908;176;12084
93;Provence-Alpes-Côte d'Azur;13;1;25;008;Aurons;551;16;567
93;Provence-Alpes-Côte d'Azur;13;1;25;009;La Barben;845;33;878
93;Provence-Alpes-Côte d'Azur;13;2;07;010;Barbentane;4143;189;4332
93;Provence-Alpes-Côte d'Azur;13;2;26;011;Les Baux-de-Provence;355;8;363
93;Provence-Alpes-Côte d'Azur;13;1;28;012;Beaurecueil;582;54;636
93;Provence-Alpes-Côte d'Azur;13;3;03;013;Belcodène;1898;34;1932
93;Provence-Alpes-Côte d'Azur;13;4;06;014;Berre-l'Étang;13472;91;13563
93;Provence-Alpes-Côte d'Azur;13;1;29;015;Bouc-Bel-Air;14654;292;14946
93;Provence-Alpes-Côte d'Azur;13;3;03;016;La Bouilladisse;6194;81;6275
93;Provence-Alpes-Côte d'Azur;13;2;07;017;Boulbon;1506;19;1525
93;Provence-Alpes-Côte d'Azur;13;2;07;018;Cabannes;4441;59;4500
93;Provence-Alpes-Côte d'Azur;13;1;29;019;Cabriès;9751;329;10080
93;Provence-Alpes-Côte d'Azur;13;3;03;020;Cadolive;2161;44;2205
93;Provence-Alpes-Côte d'Azur;13;3;08;119;Carnoux-en-Provence;6600;83;6683
93;Provence-Alpes-Côte d'Azur;13;4;11;021;Carry-le-Rouet;5823;128;5951
93;Provence-Alpes-Côte d'Azur;13;3;08;022;Cassis;7149;101;7250
93;Provence-Alpes-Côte d'Azur;13;3;08;023;Ceyreste;4584;92;4676
93;Provence-Alpes-Côte d'Azur;13;1;25;024;Charleval;2700;36;2736
93;Provence-Alpes-Côte d'Azur;13;1;28;025;Châteauneuf-le-Rouge;2235;72;2307
93;Provence-Alpes-Côte d'Azur;13;4;11;026;Châteauneuf-les-Martigues;16850;70;16920
93;Provence-Alpes-Côte d'Azur;13;2;07;027;Châteaurenard;15814;227;16041
93;Provence-Alpes-Côte d'Azur;13;3;08;028;La Ciotat;35174;389;35563
93;Provence-Alpes-Côte d'Azur;13;4;06;029;Cornillon-Confoux;1373;22;1395
93;Provence-Alpes-Côte d'Azur;13;1;06;118;Coudoux;3765;51;3816
93;Provence-Alpes-Côte d'Azur;13;3;08;030;Cuges-les-Pins;5080;54;5134
93;Provence-Alpes-Côte d'Azur;13;3;03;031;La Destrousse;3503;42;3545
93;Provence-Alpes-Côte d'Azur;13;1;25;032;Éguilles;7856;140;7996
93;Provence-Alpes-Côte d'Azur;13;4;11;033;Ensuès-la-Redonne;5484;92;5576
93;Provence-Alpes-Côte d'Azur;13;2;26;034;Eygalières;1839;30;1869
93;Provence-Alpes-Côte d'Azur;13;1;26;035;Eyguières;7008;168;7176
93;Provence-Alpes-Côte d'Azur;13;2;07;036;Eyragues;4468;128;4596
93;Provence-Alpes-Côte d'Azur;13;1;06;037;La Fare-les-Oliviers;8476;98;8574
93;Provence-Alpes-Côte d'Azur;13;2;26;038;Fontvieille;3591;91;3682
93;Provence-Alpes-Côte d'Azur;13;4;10;039;Fos-sur-Mer;15494;160;15654
93;Provence-Alpes-Côte d'Azur;13;1;28;040;Fuveau;10157;181;10338
93;Provence-Alpes-Côte d'Azur;13;1;09;041;Gardanne;20794;349;21143
93;Provence-Alpes-Côte d'Azur;13;3;08;042;Gémenos;6502;124;6626
93;Provence-Alpes-Côte d'Azur;13;4;11;043;Gignac-la-Nerthe;9326;83;9409
93;Provence-Alpes-Côte d'Azur;13;4;27;044;Grans;5118;82;5200
93;Provence-Alpes-Côte d'Azur;13;2;07;045;Graveson;4864;80;4944
93;Provence-Alpes-Côte d'Azur;13;1;03;046;Gréasque;4235;74;4309
93;Provence-Alpes-Côte d'Azur;13;4;10;047;Istres;43133;684;43817
93;Provence-Alpes-Côte d'Azur;13;1;28;048;Jouques;4413;97;4510
93;Provence-Alpes-Côte d'Azur;13;1;26;049;Lamanon;2004;42;2046
93;Provence-Alpes-Côte d'Azur;13;1;25;050;Lambesc;9672;247;9919
93;Provence-Alpes-Côte d'Azur;13;1;06;051;Lançon-Provence;8959;116;9075
93;Provence-Alpes-Côte d'Azur;13;2;07;052;Maillane;2582;32;2614
93;Provence-Alpes-Côte d'Azur;13;1;25;053;Mallemort;6019;113;6132
93;Provence-Alpes-Côte d'Azur;13;4;11;054;Marignane;32920;242;33162
93;Provence-Alpes-Côte d'Azur;13;3;98;201;Marseille 1er Arrondissement;39786;181;39967
93;Provence-Alpes-Côte d'Azur;13;3;98;202;Marseille 2e Arrondissement;24810;63;24873
93;Provence-Alpes-Côte d'Azur;13;3;98;203;Marseille 3e Arrondissement;48764;226;48990
93;Provence-Alpes-Côte d'Azur;13;3;98;204;Marseille 4e Arrondissement;48459;332;48791
93;Provence-Alpes-Côte d'Azur;13;3;98;205;Marseille 5e Arrondissement;46199;300;46499
93;Provence-Alpes-Côte d'Azur;13;3;98;206;Marseille 6e Arrondissement;42827;422;43249
93;Provence-Alpes-Côte d'Azur;13;3;98;207;Marseille 7e Arrondissement;34909;319;35228
93;Provence-Alpes-Côte d'Azur;13;3;98;208;Marseille 8e Arrondissement;81028;1180;82208
93;Provence-Alpes-Côte d'Azur;13;3;98;209;Marseille 9e Arrondissement;75914;658;76572
93;Provence-Alpes-Côte d'Azur;13;3;98;210;Marseille 10e Arrondissement;56138;374;56512
93;Provence-Alpes-Côte d'Azur;13;3;98;211;Marseille 11e Arrondissement;56790;457;57247
93;Provence-Alpes-Côte d'Azur;13;3;98;212;Marseille 12e Arrondissement;60634;591;61225
93;Provence-Alpes-Côte d'Azur;13;3;98;213;Marseille 13e Arrondissement;91992;736;92728
93;Provence-Alpes-Côte d'Azur;13;3;98;214;Marseille 14e Arrondissement;62951;271;63222
93;Provence-Alpes-Côte d'Azur;13;3;98;215;Marseille 15e Arrondissement;75901;317;76218
93;Provence-Alpes-Côte d'Azur;13;3;98;216;Marseille 16e Arrondissement;16208;78;16286
93;Provence-Alpes-Côte d'Azur;13;4;24;056;Martigues;48188;468;48656
93;Provence-Alpes-Côte d'Azur;13;2;26;057;Mas-Blanc-des-Alpilles;511;11;522
93;Provence-Alpes-Côte d'Azur;13;2;26;058;Maussane-les-Alpilles;2289;48;2337
93;Provence-Alpes-Côte d'Azur;13;1;28;059;Meyrargues;3804;53;3857
93;Provence-Alpes-Côte d'Azur;13;1;28;060;Meyreuil;5669;87;5756
93;Provence-Alpes-Côte d'Azur;13;1;09;062;Mimet;4482;78;4560
93;Provence-Alpes-Côte d'Azur;13;4;27;063;Miramas;26470;357;26827
93;Provence-Alpes-Côte d'Azur;13;2;07;064;Mollégès;2594;28;2622
93;Provence-Alpes-Côte d'Azur;13;2;26;065;Mouriès;3409;49;3458
93;Provence-Alpes-Côte d'Azur;13;2;07;066;Noves;5891;75;5966
93;Provence-Alpes-Côte d'Azur;13;2;26;067;Orgon;2963;36;2999
93;Provence-Alpes-Côte d'Azur;13;2;26;068;Paradou;2023;33;2056
93;Provence-Alpes-Côte d'Azur;13;1;25;069;Pélissanne;10344;259;10603
93;Provence-Alpes-Côte d'Azur;13;3;05;070;La Penne-sur-Huveaune;6436;59;6495
93;Provence-Alpes-Côte d'Azur;13;1;09;071;Les Pennes-Mirabeau;21046;275;21321
93;Provence-Alpes-Côte d'Azur;13;1;28;072;Peynier;3480;132;3612
93;Provence-Alpes-Côte d'Azur;13;3;03;073;Peypin;5495;75;5570
93;Provence-Alpes-Côte d'Azur;13;1;28;074;Peyrolles-en-Provence;5105;89;5194
93;Provence-Alpes-Côte d'Azur;13;2;07;076;Plan-d'Orgon;3453;48;3501
93;Provence-Alpes-Côte d'Azur;13;3;03;075;Plan-de-Cuques;10934;110;11044
93;Provence-Alpes-Côte d'Azur;13;4;24;077;Port-de-Bouc;16516;122;16638
93;Provence-Alpes-Côte d'Azur;13;4;04;078;Port-Saint-Louis-du-Rhône;8449;84;8533
93;Provence-Alpes-Côte d'Azur;13;1;28;080;Le Puy-Sainte-Réparade;5719;92;5811
93;Provence-Alpes-Côte d'Azur;13;1;28;079;Puyloubier;1792;103;1895
93;Provence-Alpes-Côte d'Azur;13;4;06;081;Rognac;12223;107;12330
93;Provence-Alpes-Côte d'Azur;13;1;25;082;Rognes;4735;127;4862
93;Provence-Alpes-Côte d'Azur;13;2;07;083;Rognonas;4101;59;4160
93;Provence-Alpes-Côte d'Azur;13;1;25;084;La Roque-d'Anthéron;5455;108;5563
93;Provence-Alpes-Côte d'Azur;13;3;08;085;Roquefort-la-Bédoule;5688;71;5759
93;Provence-Alpes-Côte d'Azur;13;3;05;086;Roquevaire;9003;142;9145
93;Provence-Alpes-Côte d'Azur;13;1;28;087;Rousset;4844;127;4971
93;Provence-Alpes-Côte d'Azur;13;4;11;088;Le Rove;5128;44;5172
93;Provence-Alpes-Côte d'Azur;13;2;07;089;Saint-Andiol;3247;43;3290
93;Provence-Alpes-Côte d'Azur;13;1;28;090;Saint-Antonin-sur-Bayon;124;4;128
93;Provence-Alpes-Côte d'Azur;13;1;25;091;Saint-Cannat;5634;115;5749
93;Provence-Alpes-Côte d'Azur;13;4;06;092;Saint-Chamas;8574;125;8699
93;Provence-Alpes-Côte d'Azur;13;1;25;093;Saint-Estève-Janson;381;8;389
93;Provence-Alpes-Côte d'Azur;13;2;26;094;Saint-Étienne-du-Grès;2481;43;2524
93;Provence-Alpes-Côte d'Azur;13;1;28;095;Saint-Marc-Jaumegarde;1250;43;1293
93;Provence-Alpes-Côte d'Azur;13;2;27;097;Saint-Martin-de-Crau;13389;267;13656
93;Provence-Alpes-Côte d'Azur;13;4;10;098;Saint-Mitre-les-Remparts;5837;110;5947
93;Provence-Alpes-Côte d'Azur;13;1;28;099;Saint-Paul-lès-Durance;871;17;888
93;Provence-Alpes-Côte d'Azur;13;2;07;061;Saint-Pierre-de-Mézoargues;207;5;212
93;Provence-Alpes-Côte d'Azur;13;2;26;100;Saint-Rémy-de-Provence;9893;224;10117
93;Provence-Alpes-Côte d'Azur;13;3;03;101;Saint-Savournin;3361;56;3417
93;Provence-Alpes-Côte d'Azur;13;4;29;102;Saint-Victoret;6625;59;6684
93;Provence-Alpes-Côte d'Azur;13;2;04;096;Saintes-Maries-de-la-Mer;2330;22;2352
93;Provence-Alpes-Côte d'Azur;13;1;99;103;Salon-de-Provence;45528;582;46110
93;Provence-Alpes-Côte d'Azur;13;4;11;104;Sausset-les-Pins;7568;144;7712
93;Provence-Alpes-Côte d'Azur;13;1;26;105;Sénas;6965;87;7052
93;Provence-Alpes-Côte d'Azur;13;3;09;106;Septèmes-les-Vallons;11019;75;11094
93;Provence-Alpes-Côte d'Azur;13;1;09;107;Simiane-Collongue;5596;91;5687
93;Provence-Alpes-Côte d'Azur;13;2;07;108;Tarascon;14813;140;14953
93;Provence-Alpes-Côte d'Azur;13;1;28;109;Le Tholonet;2305;57;2362
93;Provence-Alpes-Côte d'Azur;13;1;28;110;Trets;10613;162;10775
93;Provence-Alpes-Côte d'Azur;13;1;28;111;Vauvenargues;1013;20;1033
93;Provence-Alpes-Côte d'Azur;13;1;06;112;Velaux;8689;153;8842
93;Provence-Alpes-Côte d'Azur;13;1;28;113;Venelles;8383;185;8568
93;Provence-Alpes-Côte d'Azur;13;1;06;114;Ventabren;5459;145;5604
93;Provence-Alpes-Côte d'Azur;13;1;25;115;Vernègues;1845;37;1882
93;Provence-Alpes-Côte d'Azur;13;2;07;116;Verquières;818;17;835
93;Provence-Alpes-Côte d'Azur;13;4;29;117;Vitrolles;33310;340;33650
28;Normandie;14;3;15;001;Ablon;1204;44;1248
28;Normandie;14;1;02;003;Agy;292;6;298
28;Normandie;14;2;12;006;Amayé-sur-Orne;1001;19;1020
28;Normandie;14;4;01;007;Amayé-sur-Seulles;230;4;234
28;Normandie;14;3;04;009;Amfreville;1399;20;1419
28;Normandie;14;3;04;012;Angerville;172;1;173
28;Normandie;14;2;11;015;Anisy;730;17;747
28;Normandie;14;3;04;016;Annebault;448;13;461
28;Normandie;14;1;02;019;Arganchy;227;3;230
28;Normandie;14;2;24;020;Argences;3718;30;3748
28;Normandie;14;1;11;021;Arromanches-les-Bains;489;12;501
28;Normandie;14;1;11;022;Asnelles;595;8;603
28;Normandie;14;1;23;023;Asnières-en-Bessin;65;2;67
28;Normandie;14;3;04;024;Auberville;574;12;586
28;Normandie;14;2;13;025;Aubigny;308;3;311
28;Normandie;14;1;03;026;Audrieu;1046;19;1065
28;Normandie;14;1;23;591;Aure sur Mer;739;9;748
28;Normandie;14;4;01;011;Aurseulles;1916;40;1956
28;Normandie;14;2;06;030;Authie;1595;47;1642
28;Normandie;14;3;21;032;Les Authieux-sur-Calonne;286;11;297
28;Normandie;14;3;19;033;Auvillars;227;2;229
28;Normandie;14;2;12;034;Avenay;557;2;559
28;Normandie;14;1;23;035;Balleroy-sur-Drôme;1408;57;1465
28;Normandie;14;2;24;036;Banneville-la-Campagne;173;1;174
28;Normandie;14;1;11;038;Banville;792;9;801
28;Normandie;14;2;22;039;Barbery;825;17;842
28;Normandie;14;1;02;040;Barbeville;178;3;181
28;Normandie;14;3;15;041;Barneville-la-Bertran;127;2;129
28;Normandie;14;2;12;042;Baron-sur-Odon;939;18;957
28;Normandie;14;2;13;043;Barou-en-Auge;78;0;78
28;Normandie;14;2;11;044;Basly;1105;17;1122
28;Normandie;14;3;04;045;Basseneville;257;1;258
28;Normandie;14;3;04;046;Bavent;1814;14;1828
28;Normandie;14;1;02;047;Bayeux;13121;370;13491
28;Normandie;14;1;11;049;Bazenville;137;2;139
28;Normandie;14;1;23;050;La Bazoque;183;2;185
28;Normandie;14;3;19;231;Beaufour-Druval;444;12;456
28;Normandie;14;2;13;053;Beaumais;181;1;182
28;Normandie;14;4;25;054;Beaumesnil;203;3;206
28;Normandie;14;3;21;055;Beaumont-en-Auge;400;8;408
28;Normandie;14;3;19;527;Belle Vie en Auge;533;8;541
28;Normandie;14;2;24;057;Bellengreville;1493;17;1510
28;Normandie;14;3;21;059;Benerville-sur-Mer;420;33;453
28;Normandie;14;2;20;060;Bénouville;2049;39;2088
28;Normandie;14;1;03;062;Bény-sur-Mer;445;8;453
28;Normandie;14;1;23;063;Bernesq;204;1;205
28;Normandie;14;2;13;064;Bernières-d'Ailly;243;7;250
28;Normandie;14;2;11;066;Bernières-sur-Mer;2308;36;2344
28;Normandie;14;3;17;069;Beuvillers;1351;27;1378
28;Normandie;14;3;19;070;Beuvron-en-Auge;188;6;194
28;Normandie;14;2;20;068;Biéville-Beuville;3391;71;3462
28;Normandie;14;2;20;076;Blainville-sur-Orne;5801;75;5876
28;Normandie;14;3;21;077;Blangy-le-Château;700;77;777
28;Normandie;14;1;23;078;Blay;383;6;389
28;Normandie;14;3;21;079;Blonville-sur-Mer;1545;35;1580
28;Normandie;14;2;22;080;Le Bô;116;5;121
28;Normandie;14;3;19;082;La Boissière;189;4;193
28;Normandie;14;3;19;083;Bonnebosq;677;15;692
28;Normandie;14;4;01;084;Bonnemaison;404;8;412
28;Normandie;14;3;21;085;Bonneville-la-Louvet;756;11;767
28;Normandie;14;3;21;086;Bonneville-sur-Touques;347;14;361
28;Normandie;14;2;13;087;Bonnœil;131;1;132
28;Normandie;14;2;13;088;Bons-Tassilly;404;8;412
28;Normandie;14;2;12;089;Bougy;402;7;409
28;Normandie;14;2;22;090;Boulon;681;6;687
28;Normandie;14;3;04;091;Bourgeauville;107;1;108
28;Normandie;14;2;12;092;Bourguébus;2016;22;2038
28;Normandie;14;3;04;093;Branville;196;4;200
28;Normandie;14;4;01;096;Brémoy;227;6;233
28;Normandie;14;2;22;097;Bretteville-le-Rabet;305;5;310
28;Normandie;14;2;22;100;Bretteville-sur-Laize;1876;25;1901
28;Normandie;14;2;05;101;Bretteville-sur-Odon;3833;80;3913
28;Normandie;14;3;21;102;Le Breuil-en-Auge;1028;23;1051
28;Normandie;14;1;23;103;Le Breuil-en-Bessin;399;7;406
28;Normandie;14;3;21;104;Le Brévedent;172;4;176
28;Normandie;14;3;04;106;Bréville-les-Monts;655;5;660
28;Normandie;14;1;23;107;Bricqueville;183;3;186
28;Normandie;14;3;04;110;Brucourt;115;2;117
28;Normandie;14;2;22;116;Le Bû-sur-Rouvres;100;2;102
28;Normandie;14;1;03;111;Bucéels;397;6;403
28;Normandie;14;3;04;117;Cabourg;3650;32;3682
28;Normandie;14;2;99;118;Caen;105354;2169;107523
28;Normandie;14;2;24;119;Cagny;1910;24;1934
28;Normandie;14;4;01;120;Cahagnes;1394;25;1419
28;Normandie;14;1;23;121;Cahagnolles;254;1;255
28;Normandie;14;2;12;122;La Caine;158;2;160
28;Normandie;14;2;03;123;Cairon;1987;46;2033
28;Normandie;14;1;23;124;La Cambe;561;10;571
28;Normandie;14;2;20;125;Cambes-en-Plaine;1722;49;1771
28;Normandie;14;3;19;126;Cambremer;1359;24;1383
28;Normandie;14;4;25;127;Campagnolles;535;0;535
28;Normandie;14;1;02;130;Campigny;189;1;190
28;Normandie;14;3;21;131;Canapville;233;5;238
28;Normandie;14;1;23;132;Canchy;205;0;205
28;Normandie;14;2;24;134;Canteloup;179;8;187
28;Normandie;14;1;03;135;Carcagny;281;6;287
28;Normandie;14;1;23;136;Cardonville;112;0;112
28;Normandie;14;2;06;137;Carpiquet;2607;23;2630
28;Normandie;14;1;23;138;Cartigny-l'Épinay;298;6;304
28;Normandie;14;2;12;554;Le Castelet;1516;11;1527
28;Normandie;14;1;23;140;Castillon;344;7;351
28;Normandie;14;3;19;141;Castillon-en-Auge;166;2;168
28;Normandie;14;2;12;538;Castine-en-Plaine;1552;21;1573
28;Normandie;14;4;01;143;Caumont-sur-Aure;2368;25;2393
28;Normandie;14;2;22;145;Cauvicourt;507;4;511
28;Normandie;14;2;22;146;Cauville;164;3;167
28;Normandie;14;3;18;147;Cernay;141;1;142
28;Normandie;14;2;24;149;Cesny-aux-Vignes;419;13;432
28;Normandie;14;2;22;150;Cesny-les-Sources;1334;28;1362
28;Normandie;14;1;02;159;Chouain;224;13;237
28;Normandie;14;2;22;160;Cintheaux;190;6;196
28;Normandie;14;3;21;161;Clarbec;360;10;370
28;Normandie;14;2;22;162;Clécy;1276;14;1290
28;Normandie;14;2;24;163;Cléville;372;2;374
28;Normandie;14;2;20;166;Colleville-Montgomery;2437;41;2478
28;Normandie;14;1;23;165;Colleville-sur-Mer;175;4;179
28;Normandie;14;2;14;167;Colombelles;6918;58;6976
28;Normandie;14;1;23;168;Colombières;210;3;213
28;Normandie;14;1;03;169;Colombiers-sur-Seulles;164;7;171
28;Normandie;14;2;11;014;Colomby-Anguerny;1108;32;1140
28;Normandie;14;2;22;171;Combray;148;1;149
28;Normandie;14;1;02;172;Commes;401;10;411
28;Normandie;14;4;10;174;Condé-en-Normandie;6634;278;6912
28;Normandie;14;2;19;173;Condé-sur-Ifs;445;14;459
28;Normandie;14;1;02;175;Condé-sur-Seulles;293;5;298
28;Normandie;14;3;21;177;Coquainvilliers;856;20;876
28;Normandie;14;3;17;179;Cordebugle;157;5;162
28;Normandie;14;2;13;180;Cordey;154;3;157
28;Normandie;14;2;16;181;Cormelles-le-Royal;4898;42;4940
28;Normandie;14;1;23;182;Cormolain;419;3;422
28;Normandie;14;2;22;183;Cossesseville;95;2;97
28;Normandie;14;1;02;184;Cottun;222;0;222
28;Normandie;14;2;13;190;Courcy;134;5;139
28;Normandie;14;2;11;191;Courseulles-sur-Mer;4199;59;4258
28;Normandie;14;3;17;193;Courtonne-la-Meurdrac;663;20;683
28;Normandie;14;3;17;194;Courtonne-les-Deux-Églises;658;11;669
28;Normandie;14;4;01;195;Courvaudon;239;1;240
28;Normandie;14;1;11;196;Crépon;212;6;218
28;Normandie;14;2;11;197;Cresserons;1145;28;1173
28;Normandie;14;3;04;198;Cresseveuille;262;8;270
28;Normandie;14;1;03;200;Creully sur Seulles;2278;79;2357
28;Normandie;14;3;15;202;Cricquebœuf;293;6;299
28;Normandie;14;3;04;203;Cricqueville-en-Auge;185;7;192
28;Normandie;14;1;23;204;Cricqueville-en-Bessin;194;3;197
28;Normandie;14;1;03;205;Cristot;214;6;220
28;Normandie;14;2;13;206;Crocy;311;10;321
28;Normandie;14;2;22;207;Croisilles;646;7;653
28;Normandie;14;1;23;209;Crouay;529;10;539
28;Normandie;14;2;22;211;Culey-le-Patry;357;4;361
28;Normandie;14;1;02;214;Cussy;186;3;189
28;Normandie;14;2;24;215;Cuverville;2130;32;2162
28;Normandie;14;2;13;216;Damblainville;241;3;244
28;Normandie;14;3;04;218;Danestal;385;7;392
28;Normandie;14;3;15;220;Deauville;3604;61;3665
28;Normandie;14;2;24;221;Démouville;3189;48;3237
28;Normandie;14;2;13;223;Le Détroit;87;2;89
28;Normandie;14;1;23;224;Deux-Jumeaux;55;3;58
28;Normandie;14;4;01;347;Dialan sur Chaîne;1068;15;1083
28;Normandie;14;3;04;225;Dives-sur-Mer;5546;186;5732
28;Normandie;14;2;22;226;Donnay;279;2;281
28;Normandie;14;3;04;227;Douville-en-Auge;213;6;219
28;Normandie;14;2;11;228;Douvres-la-Délivrande;5062;212;5274
28;Normandie;14;3;04;229;Dozulé;2284;23;2307
28;Normandie;14;3;19;230;Drubec;118;1;119
28;Normandie;14;1;03;232;Ducy-Sainte-Marguerite;160;3;163
28;Normandie;14;1;02;236;Ellon;504;6;510
28;Normandie;14;2;24;237;Émiéville;588;7;595
28;Normandie;14;3;21;238;Englesqueville-en-Auge;110;2;112
28;Normandie;14;1;23;239;Englesqueville-la-Percée;104;0;104
28;Normandie;14;2;13;240;Épaney;514;11;525
28;Normandie;14;4;01;241;Épinay-sur-Odon;614;10;624
28;Normandie;14;2;07;242;Épron;1634;26;1660
28;Normandie;14;3;15;243;Équemauville;1444;5;1449
28;Normandie;14;2;13;244;Eraines;349;8;357
28;Normandie;14;2;13;245;Ernes;322;10;332
28;Normandie;14;3;24;246;Escoville;803;4;807
28;Normandie;14;2;22;248;Espins;245;5;250
28;Normandie;14;2;12;249;Esquay-Notre-Dame;1433;10;1443
28;Normandie;14;1;02;250;Esquay-sur-Seulles;291;6;297
28;Normandie;14;2;22;251;Esson;516;10;526
28;Normandie;14;2;22;252;Estrées-la-Campagne;248;3;251
28;Normandie;14;2;09;254;Éterville;1631;27;1658
28;Normandie;14;1;23;256;Étréham;349;5;354
28;Normandie;14;2;12;257;Évrecy;2008;37;2045
28;Normandie;14;2;13;258;Falaise;8186;305;8491
28;Normandie;14;3;21;260;Fauguernon;246;7;253
28;Normandie;14;3;21;261;Le Faulq;343;7;350
28;Normandie;14;2;12;266;Feuguerolles-Bully;1428;24;1452
28;Normandie;14;3;21;269;Fierville-les-Parcs;212;4;216
28;Normandie;14;3;21;270;Firfol;414;16;430
28;Normandie;14;2;09;271;Fleury-sur-Orne;4915;70;4985
28;Normandie;14;1;23;272;La Folie;99;2;101
28;Normandie;14;3;18;273;La Folletière-Abenon;129;1;130
28;Normandie;14;2;12;274;Fontaine-Étoupefour;2348;58;2406
28;Normandie;14;1;03;275;Fontaine-Henry;466;6;472
28;Normandie;14;2;13;276;Fontaine-le-Pin;357;4;361
28;Normandie;14;2;12;277;Fontenay-le-Marmion;1930;23;1953
28;Normandie;14;1;03;278;Fontenay-le-Pesnel;1160;17;1177
28;Normandie;14;3;19;280;Formentin;250;5;255
28;Normandie;14;1;23;281;Formigny La Bataille;731;14;745
28;Normandie;14;1;23;282;Foulognes;197;3;200
28;Normandie;14;2;13;283;Fourches;231;4;235
28;Normandie;14;2;13;284;Fourneaux-le-Val;158;4;162
28;Normandie;14;3;19;285;Le Fournet;62;0;62
28;Normandie;14;3;15;286;Fourneville;495;22;517
28;Normandie;14;2;24;287;Frénouville;1948;14;1962
28;Normandie;14;2;03;288;Le Fresne-Camilly;900;23;923
28;Normandie;14;2;13;289;Fresné-la-Mère;604;14;618
28;Normandie;14;2;22;290;Fresney-le-Puceux;822;7;829
28;Normandie;14;2;22;291;Fresney-le-Vieux;272;5;277
28;Normandie;14;3;21;293;Fumichon;283;6;289
28;Normandie;14;2;12;297;Gavrus;555;7;562
28;Normandie;14;1;23;298;Géfosse-Fontenay;141;0;141
28;Normandie;14;3;15;299;Genneville;827;18;845
28;Normandie;14;3;19;300;Gerrots;53;3;56
28;Normandie;14;2;16;301;Giberville;4967;53;5020
28;Normandie;14;3;21;302;Glanville;172;15;187
28;Normandie;14;3;17;303;Glos;924;21;945
28;Normandie;14;3;04;306;Gonneville-en-Auge;392;4;396
28;Normandie;14;3;15;304;Gonneville-sur-Honfleur;875;34;909
28;Normandie;14;3;04;305;Gonneville-sur-Mer;673;13;686
28;Normandie;14;3;04;308;Goustranville;201;3;204
28;Normandie;14;2;22;309;Gouvix;843;3;846
28;Normandie;14;2;22;310;Grainville-Langannerie;701;7;708
28;Normandie;14;2;12;311;Grainville-sur-Odon;1037;9;1046
28;Normandie;14;1;23;312;Grandcamp-Maisy;1563;24;1587
28;Normandie;14;3;04;316;Grangues;249;3;252
28;Normandie;14;1;11;318;Graye-sur-Mer;685;9;694
28;Normandie;14;2;12;319;Grentheville;901;7;908
28;Normandie;14;2;22;320;Grimbosq;287;7;294
28;Normandie;14;1;02;322;Guéron;243;7;250
28;Normandie;14;2;20;325;Hermanville-sur-Mer;3110;40;3150
28;Normandie;14;3;21;326;Hermival-les-Vaux;813;38;851
28;Normandie;14;2;14;327;Hérouville-Saint-Clair;22954;260;23214
28;Normandie;14;3;04;328;Hérouvillette;1275;9;1284
28;Normandie;14;3;04;329;Heuland;97;3;100
28;Normandie;14;2;13;332;La Hoguette;714;19;733
28;Normandie;14;2;22;689;Le Hom;3689;60;3749
28;Normandie;14;3;15;333;Honfleur;7425;227;7652
28;Normandie;14;3;17;334;L' Hôtellerie;313;8;321
28;Normandie;14;3;19;335;Hotot-en-Auge;302;3;305
28;Normandie;14;1;01;336;Hottot-les-Bagues;483;8;491
28;Normandie;14;3;19;337;La Houblonnière;330;9;339
28;Normandie;14;3;04;338;Houlgate;1873;39;1912
28;Normandie;14;2;16;341;Ifs;11766;196;11962
28;Normandie;14;1;23;342;Isigny-sur-Mer;3639;45;3684
28;Normandie;14;2;13;343;Les Isles-Bardel;64;0;64
28;Normandie;14;2;24;344;Janville;368;9;377
28;Normandie;14;2;13;345;Jort;299;1;300
28;Normandie;14;1;02;346;Juaye-Mondaye;670;14;684
28;Normandie;14;1;03;348;Juvigny-sur-Seulles;84;1;85
28;Normandie;14;2;12;349;Laize-Clinchamps;2017;22;2039
28;Normandie;14;4;25;352;Landelles-et-Coupigny;861;20;881
28;Normandie;14;4;01;353;Landes-sur-Ajon;426;5;431
28;Normandie;14;2;11;354;Langrune-sur-Mer;1824;43;1867
28;Normandie;14;3;19;358;Léaupartie;88;2;90
28;Normandie;14;2;13;360;Leffard;204;2;206
28;Normandie;14;3;19;362;Lessard-et-le-Chêne;158;0;158
28;Normandie;14;1;01;364;Lingèvres;464;6;470
28;Normandie;14;2;20;365;Lion-sur-Mer;2461;39;2500
28;Normandie;14;3;17;366;Lisieux;20318;668;20986
28;Normandie;14;1;23;367;Lison;443;5;448
28;Normandie;14;3;18;368;Lisores;260;13;273
28;Normandie;14;1;23;369;Litteau;293;3;296
28;Normandie;14;3;18;371;Livarot-Pays-d'Auge;6323;114;6437
28;Normandie;14;4;01;374;Les Loges;132;2;134
28;Normandie;14;2;13;375;Les Loges-Saulces;170;3;173
28;Normandie;14;1;02;377;Longues-sur-Mer;606;15;621
28;Normandie;14;1;23;378;Longueville;279;9;288
28;Normandie;14;4;01;379;Longvillers;360;5;365
28;Normandie;14;1;03;380;Loucelles;183;5;188
28;Normandie;14;2;13;381;Louvagny;60;3;63
28;Normandie;14;2;09;383;Louvigny;2742;39;2781
28;Normandie;14;2;11;384;Luc-sur-Mer;3182;53;3235
28;Normandie;14;1;02;385;Magny-en-Bessin;155;8;163
28;Normandie;14;4;01;389;Maisoncelles-Pelvey;262;9;271
28;Normandie;14;4;01;390;Maisoncelles-sur-Ajon;189;4;193
28;Normandie;14;1;23;391;Maisons;388;4;392
28;Normandie;14;2;12;393;Maizet;363;4;367
28;Normandie;14;2;13;394;Maizières;444;15;459
28;Normandie;14;4;01;037;Malherbe-sur-Ajon;548;13;561
28;Normandie;14;2;12;396;Maltot;1036;21;1057
28;Normandie;14;1;23;397;Mandeville-en-Bessin;336;7;343
28;Normandie;14;3;19;398;Manerbe;555;16;571
28;Normandie;14;3;21;399;Manneville-la-Pipard;290;8;298
28;Normandie;14;1;02;400;Le Manoir;219;3;222
28;Normandie;14;1;02;401;Manvieux;131;6;137
28;Normandie;14;2;13;402;Le Marais-la-Chapelle;108;2;110
28;Normandie;14;3;17;403;Marolles;768;22;790
28;Normandie;14;2;22;404;Martainville;119;1;120
28;Normandie;14;2;13;405;Martigny-sur-l'Ante;319;6;325
28;Normandie;14;2;20;407;Mathieu;2223;66;2289
28;Normandie;14;2;12;408;May-sur-Orne;1960;15;1975
28;Normandie;14;3;04;409;Merville-Franceville-Plage;2169;36;2205
28;Normandie;14;3;19;410;Méry-Bissières-en-Auge;1106;8;1114
28;Normandie;14;2;22;411;Meslay;292;5;297
28;Normandie;14;4;01;412;Le Mesnil-au-Grain;77;2;79
28;Normandie;14;3;19;419;Le Mesnil-Eudes;258;8;266
28;Normandie;14;3;17;421;Le Mesnil-Guillaume;605;6;611
28;Normandie;14;4;25;424;Le Mesnil-Robert;193;2;195
28;Normandie;14;3;19;425;Le Mesnil-Simon;180;7;187
28;Normandie;14;3;21;426;Le Mesnil-sur-Blangy;166;7;173
28;Normandie;14;2;13;427;Le Mesnil-Villement;299;3;302
28;Normandie;14;1;11;430;Meuvaines;144;3;147
28;Normandie;14;3;19;431;Mézidon Vallée d'Auge;9712;116;9828
28;Normandie;14;1;23;370;Le Molay-Littry;2988;36;3024
28;Normandie;14;3;19;435;Les Monceaux;181;3;184
28;Normandie;14;1;02;436;Monceaux-en-Bessin;563;4;567
28;Normandie;14;2;16;437;Mondeville;9868;263;10131
28;Normandie;14;2;12;438;Mondrainville;521;9;530
28;Normandie;14;1;23;439;Monfréville;94;2;96
28;Normandie;14;1;23;445;Montfiquet;106;2;108
28;Normandie;14;2;12;446;Montigny;96;2;98
28;Normandie;14;2;22;713;Montillières-sur-Orne;596;11;607
28;Normandie;14;3;19;448;Montreuil-en-Auge;57;0;57
28;Normandie;14;4;89;027;Les Monts d'Aunay;4669;65;4734
28;Normandie;14;4;01;449;Monts-en-Bessin;415;5;420
28;Normandie;14;2;13;452;Morteaux-Coulibœuf;647;4;651
28;Normandie;14;1;23;453;Mosles;354;4;358
28;Normandie;14;2;05;454;Mouen;1601;22;1623
28;Normandie;14;2;22;455;Moulines;303;5;308
28;Normandie;14;1;03;406;Moulins en Bessin;1171;21;1192
28;Normandie;14;2;24;456;Moult-Chicheboville;3095;31;3126
28;Normandie;14;2;13;457;Les Moutiers-en-Auge;122;3;125
28;Normandie;14;2;22;458;Les Moutiers-en-Cinglais;517;59;576
28;Normandie;14;3;21;460;Moyaux;1359;33;1392
28;Normandie;14;2;22;461;Mutrécy;359;2;361
28;Normandie;14;1;02;465;Nonant;496;13;509
28;Normandie;14;3;21;466;Norolles;318;8;326
28;Normandie;14;2;13;467;Noron-l'Abbaye;301;6;307
28;Normandie;14;1;23;468;Noron-la-Poterie;397;5;402
28;Normandie;14;2;13;469;Norrey-en-Auge;93;3;96
28;Normandie;14;3;19;474;Notre-Dame-d'Estrées-Corbon;225;4;229
28;Normandie;14;3;19;473;Notre-Dame-de-Livaye;117;3;120
28;Normandie;14;4;25;658;Noues de Sienne;4423;100;4523
28;Normandie;14;2;13;476;Olendon;184;3;187
28;Normandie;14;3;18;478;Orbec;2013;49;2062
28;Normandie;14;1;23;480;Osmanville;533;7;540
28;Normandie;14;2;24;482;Ouézy;239;2;241
28;Normandie;14;2;22;483;Ouffières;189;3;192
28;Normandie;14;3;21;484;Ouilly-du-Houley;240;8;248
28;Normandie;14;2;13;486;Ouilly-le-Tesson;591;10;601
28;Normandie;14;3;21;487;Ouilly-le-Vicomte;810;24;834
28;Normandie;14;2;20;488;Ouistreham;9081;148;9229
28;Normandie;14;4;01;491;Parfouru-sur-Odon;196;11;207
28;Normandie;14;3;15;492;Pennedepie;290;7;297
28;Normandie;14;3;04;494;Périers-en-Auge;138;3;141
28;Normandie;14;2;20;495;Périers-sur-le-Dan;513;6;519
28;Normandie;14;4;10;496;Périgny;58;4;62
28;Normandie;14;2;13;497;Perrières;327;6;333
28;Normandie;14;2;13;498;Pertheville-Ners;245;5;250
28;Normandie;14;3;04;499;Petiville;508;4;512
28;Normandie;14;3;21;500;Pierrefitte-en-Auge;159;6;165
28;Normandie;14;2;13;501;Pierrefitte-en-Cinglais;257;6;263
28;Normandie;14;2;13;502;Pierrepont;93;1;94
28;Normandie;14;3;21;504;Le Pin;812;21;833
28;Normandie;14;1;23;506;Planquery;241;0;241
28;Normandie;14;2;11;509;Plumetot;215;5;220
28;Normandie;14;2;22;510;La Pommeraye;56;3;59
28;Normandie;14;4;25;511;Pont-Bellanger;66;0;66
28;Normandie;14;2;13;764;Pont-d'Ouilly;999;16;1015
28;Normandie;14;3;21;514;Pont-l'Évêque;4662;70;4732
28;Normandie;14;4;10;512;Pontécoulant;80;2;82
28;Normandie;14;1;03;355;Ponts sur Seulles;1169;20;1189
28;Normandie;14;1;02;515;Port-en-Bessin-Huppain;1942;20;1962
28;Normandie;14;2;13;516;Potigny;2075;17;2092
28;Normandie;14;3;19;520;Le Pré-d'Auge;887;22;909
28;Normandie;14;2;12;519;Préaux-Bocage;123;0;123
28;Normandie;14;3;19;522;Prêtreville;399;7;406
28;Normandie;14;3;04;524;Putot-en-Auge;296;5;301
28;Normandie;14;3;15;528;Quetteville;375;8;383
28;Normandie;14;1;02;529;Ranchy;248;3;251
28;Normandie;14;3;04;530;Ranville;1805;29;1834
28;Normandie;14;2;13;531;Rapilly;47;0;47
28;Normandie;14;3;19;533;Repentigny;89;3;92
28;Normandie;14;3;21;534;Reux;410;6;416
28;Normandie;14;2;03;535;Reviers;566;13;579
28;Normandie;14;3;15;536;La Rivière-Saint-Sauveur;2538;36;2574
28;Normandie;14;3;21;540;Rocques;286;14;300
28;Normandie;14;3;19;541;La Roque-Baignard;118;1;119
28;Normandie;14;2;03;542;Rosel;541;11;552
28;Normandie;14;2;03;543;Rots;2438;71;2509
28;Normandie;14;2;13;546;Rouvres;218;2;220
28;Normandie;14;1;23;547;Rubercy;171;3;174
28;Normandie;14;3;19;550;Rumesnil;101;3;104
28;Normandie;14;1;02;552;Ryes;517;16;533
28;Normandie;14;3;21;555;Saint-André-d'Hébertot;444;6;450
28;Normandie;14;2;09;556;Saint-André-sur-Orne;1831;23;1854
28;Normandie;14;3;21;557;Saint-Arnoult;1165;12;1177
28;Normandie;14;2;20;558;Saint-Aubin-d'Arquenay;1070;15;1085
28;Normandie;14;4;25;559;Saint-Aubin-des-Bois;234;1;235
28;Normandie;14;2;11;562;Saint-Aubin-sur-Mer;2387;40;2427
28;Normandie;14;3;21;563;Saint-Benoît-d'Hébertot;425;9;434
28;Normandie;14;1;11;565;Saint-Côme-de-Fresné;263;4;267
28;Normandie;14;2;06;566;Saint-Contest;2517;52;2569
28;Normandie;14;3;18;571;Saint-Denis-de-Mailloc;301;5;306
28;Normandie;14;4;10;572;Saint-Denis-de-Méré;834;12;846
28;Normandie;14;3;19;574;Saint-Désir;1710;95;1805
28;Normandie;14;3;21;575;Saint-Étienne-la-Thillaye;414;27;441
28;Normandie;14;3;15;578;Saint-Gatien-des-Bois;1314;29;1343
28;Normandie;14;3;19;582;Saint-Germain-de-Livet;769;17;786
28;Normandie;14;1;23;586;Saint-Germain-du-Pert;179;1;180
28;Normandie;14;2;06;587;Saint-Germain-la-Blanche-Herbe;2306;37;2343
28;Normandie;14;2;13;588;Saint-Germain-Langot;319;4;323
28;Normandie;14;2;22;589;Saint-Germain-le-Vasson;937;9;946
28;Normandie;14;3;21;593;Saint-Hymer;664;11;675
28;Normandie;14;3;19;595;Saint-Jean-de-Livet;221;5;226
28;Normandie;14;3;04;598;Saint-Jouin;211;3;214
28;Normandie;14;3;21;601;Saint-Julien-sur-Calonne;165;5;170
28;Normandie;14;2;22;602;Saint-Lambert;275;2;277
28;Normandie;14;2;22;603;Saint-Laurent-de-Condel;501;8;509
28;Normandie;14;1;23;605;Saint-Laurent-sur-Mer;261;8;269
28;Normandie;14;3;04;606;Saint-Léger-Dubosq;182;2;184
28;Normandie;14;4;01;607;Saint-Louet-sur-Seulles;148;1;149
28;Normandie;14;1;02;609;Saint-Loup-Hors;512;9;521
28;Normandie;14;2;03;610;Saint-Manvieu-Norrey;1927;113;2040
28;Normandie;14;1;23;613;Saint-Marcouf;102;2;104
28;Normandie;14;3;21;620;Saint-Martin-aux-Chartrains;412;9;421
28;Normandie;14;3;18;621;Saint-Martin-de-Bienfaite-la-Cressonnière;452;7;459
28;Normandie;14;1;23;622;Saint-Martin-de-Blagny;131;6;137
28;Normandie;14;2;12;623;Saint-Martin-de-Fontenay;2560;19;2579
28;Normandie;14;3;17;625;Saint-Martin-de-la-Lieue;782;14;796
28;Normandie;14;3;19;626;Saint-Martin-de-Mailloc;902;20;922
28;Normandie;14;2;13;627;Saint-Martin-de-Mieux;423;8;431
28;Normandie;14;1;02;630;Saint-Martin-des-Entrées;686;15;701
28;Normandie;14;2;22;635;Saint-Omer;184;2;186
28;Normandie;14;2;24;637;Saint-Ouen-du-Mesnil-Oger;208;3;211
28;Normandie;14;3;19;639;Saint-Ouen-le-Pin;259;9;268
28;Normandie;14;2;24;640;Saint-Pair;219;2;221
28;Normandie;14;1;23;643;Saint-Paul-du-Vernay;818;14;832
28;Normandie;14;3;21;644;Saint-Philbert-des-Champs;644;14;658
28;Normandie;14;3;21;645;Saint-Pierre-Azif;164;9;173
28;Normandie;14;2;13;646;Saint-Pierre-Canivet;400;3;403
28;Normandie;14;3;19;648;Saint-Pierre-des-Ifs;451;19;470
28;Normandie;14;2;13;649;Saint-Pierre-du-Bû;477;10;487
28;Normandie;14;4;01;650;Saint-Pierre-du-Fresne;195;5;200
28;Normandie;14;2;24;651;Saint-Pierre-du-Jonquet;237;1;238
28;Normandie;14;1;23;652;Saint-Pierre-du-Mont;80;1;81
28;Normandie;14;3;18;654;Saint-Pierre-en-Auge;7676;310;7986
28;Normandie;14;2;22;656;Saint-Rémy;1001;15;1016
28;Normandie;14;3;24;657;Saint-Samson;308;4;312
28;Normandie;14;2;22;659;Saint-Sylvain;1435;24;1459
28;Normandie;14;3;04;660;Saint-Vaast-en-Auge;95;3;98
28;Normandie;14;1;03;661;Saint-Vaast-sur-Seulles;147;1;148
28;Normandie;14;1;02;663;Saint-Vigor-le-Grand;2438;51;2489
28;Normandie;14;1;11;569;Sainte-Croix-sur-Mer;246;6;252
28;Normandie;14;1;23;590;Sainte-Honorine-de-Ducy;127;3;130
28;Normandie;14;2;12;592;Sainte-Honorine-du-Fay;1339;18;1357
28;Normandie;14;1;23;614;Sainte-Marguerite-d'Elle;767;13;780
28;Normandie;14;4;25;619;Sainte-Marie-Outre-l'Eau;123;2;125
28;Normandie;14;2;24;712;Saline;5428;117;5545
28;Normandie;14;1;23;664;Sallen;302;7;309
28;Normandie;14;3;04;665;Sallenelles;294;3;297
28;Normandie;14;1;23;667;Saon;225;4;229
28;Normandie;14;1;23;668;Saonnet;305;3;308
28;Normandie;14;2;13;669;Sassy;209;3;212
28;Normandie;14;4;01;579;Seulline;1343;18;1361
28;Normandie;14;2;22;674;Soignolles;123;3;126
28;Normandie;14;2;12;675;Soliers;2070;25;2095
28;Normandie;14;1;02;676;Sommervieu;990;23;1013
28;Normandie;14;2;13;677;Soulangy;255;6;261
28;Normandie;14;4;10;061;Souleuvre en Bocage;8839;155;8994
28;Normandie;14;2;13;678;Soumont-Saint-Quentin;542;7;549
28;Normandie;14;1;02;679;Subles;672;21;693
28;Normandie;14;1;02;680;Sully;140;9;149
28;Normandie;14;1;23;681;Surrain;158;3;161
28;Normandie;14;3;21;682;Surville;442;13;455
28;Normandie;14;4;10;357;Terres de Druance;947;23;970
28;Normandie;14;1;03;684;Tessel;249;3;252
28;Normandie;14;2;03;685;Thaon;1571;31;1602
28;Normandie;14;3;15;687;Le Theil-en-Auge;186;3;189
28;Normandie;14;2;03;098;Thue et Mue;5904;94;5998
28;Normandie;14;1;03;692;Tilly-sur-Seulles;1700;22;1722
28;Normandie;14;3;21;694;Le Torquesne;509;19;528
28;Normandie;14;3;24;698;Touffréville;372;1;373
28;Normandie;14;3;15;699;Touques;3679;67;3746
28;Normandie;14;1;23;700;Tour-en-Bessin;658;10;668
28;Normandie;14;3;21;701;Tourgéville;799;20;819
28;Normandie;14;1;23;705;Tournières;152;1;153
28;Normandie;14;3;21;706;Tourville-en-Auge;234;11;245
28;Normandie;14;2;05;707;Tourville-sur-Odon;1032;14;1046
28;Normandie;14;4;01;708;Tracy-Bocage;303;7;310
28;Normandie;14;1;02;709;Tracy-sur-Mer;341;7;348
28;Normandie;14;2;13;710;Tréprel;108;0;108
28;Normandie;14;1;23;711;Trévières;924;10;934
28;Normandie;14;1;23;714;Le Tronquay;776;10;786
28;Normandie;14;3;15;715;Trouville-sur-Mer;4628;89;4717
28;Normandie;14;1;23;716;Trungy;215;3;218
28;Normandie;14;2;22;719;Urville;671;6;677
28;Normandie;14;2;13;720;Ussy;872;26;898
28;Normandie;14;2;12;721;Vacognes-Neuilly;627;10;637
28;Normandie;14;4;01;475;Val d'Arry;2256;48;2304
28;Normandie;14;4;01;672;Val de Drôme;857;14;871
28;Normandie;14;3;18;576;Val-de-Vie;540;13;553
28;Normandie;14;2;24;005;Valambray;1769;25;1794
28;Normandie;14;4;10;726;Valdallière;5951;119;6070
28;Normandie;14;3;18;570;Valorbiquet;2508;45;2553
28;Normandie;14;3;19;723;Valsemé;276;11;287
28;Normandie;14;3;04;724;Varaville;954;20;974
28;Normandie;14;1;02;728;Vaucelles;455;7;462
28;Normandie;14;3;21;731;Vauville;189;13;202
28;Normandie;14;1;02;732;Vaux-sur-Aure;336;12;348
28;Normandie;14;1;02;733;Vaux-sur-Seulles;305;9;314
28;Normandie;14;1;03;734;Vendes;320;8;328
28;Normandie;14;2;18;735;Vendeuvre;774;11;785
28;Normandie;14;1;11;739;Ver-sur-Mer;1625;41;1666
28;Normandie;14;2;13;737;Versainville;469;8;477
28;Normandie;14;2;05;738;Verson;3616;52;3668
28;Normandie;14;3;18;740;La Vespière-Friardel;1199;17;1216
28;Normandie;14;2;22;741;Le Vey;117;3;120
28;Normandie;14;2;13;742;Vicques;70;0;70
28;Normandie;14;3;19;743;Victot-Pontfol;107;4;111
28;Normandie;14;1;02;744;Vienne-en-Bessin;297;4;301
28;Normandie;14;1;23;745;Vierville-sur-Mer;229;4;233
28;Normandie;14;2;12;747;Vieux;686;8;694
28;Normandie;14;3;21;748;Vieux-Bourg;78;1;79
28;Normandie;14;2;13;751;Vignats;289;8;297
28;Normandie;14;4;01;752;Villers-Bocage;3108;35;3143
28;Normandie;14;2;13;753;Villers-Canivet;771;21;792
28;Normandie;14;3;21;754;Villers-sur-Mer;2644;60;2704
28;Normandie;14;3;15;755;Villerville;627;14;641
28;Normandie;14;4;10;756;La Villette;226;3;229
28;Normandie;14;2;06;758;Villons-les-Buissons;749;24;773
28;Normandie;14;4;01;760;Villy-Bocage;782;6;788
28;Normandie;14;2;13;759;Villy-lez-Falaise;273;8;281
28;Normandie;14;2;24;761;Vimont;746;14;760
28;Normandie;14;4;25;762;Vire Normandie;17178;891;18069
84;Auvergne-Rhône-Alpes;15;3;07;025;Albepierre-Bredons;246;6;252
84;Auvergne-Rhône-Alpes;15;3;07;001;Allanche;790;9;799
84;Auvergne-Rhône-Alpes;15;3;09;002;Alleuze;216;4;220
84;Auvergne-Rhône-Alpes;15;2;05;003;Ally;605;12;617
84;Auvergne-Rhône-Alpes;15;3;11;004;Andelat;466;8;474
84;Auvergne-Rhône-Alpes;15;3;09;005;Anglards-de-Saint-Flour;349;16;365
84;Auvergne-Rhône-Alpes;15;2;05;006;Anglards-de-Salers;777;24;801
84;Auvergne-Rhône-Alpes;15;3;09;007;Anterrieux;123;7;130
84;Auvergne-Rhône-Alpes;15;2;15;008;Antignac;281;1;282
84;Auvergne-Rhône-Alpes;15;2;10;009;Apchon;186;6;192
84;Auvergne-Rhône-Alpes;15;2;15;010;Arches;181;3;184
84;Auvergne-Rhône-Alpes;15;1;13;011;Arnac;171;2;173
84;Auvergne-Rhône-Alpes;15;1;01;012;Arpajon-sur-Cère;6217;170;6387
84;Auvergne-Rhône-Alpes;15;3;11;013;Auriac-l'Église;153;0;153
84;Auvergne-Rhône-Alpes;15;1;98;014;Aurillac;25499;1329;26828
84;Auvergne-Rhône-Alpes;15;2;10;015;Auzers;166;4;170
84;Auvergne-Rhône-Alpes;15;1;13;016;Ayrens;652;14;666
84;Auvergne-Rhône-Alpes;15;1;14;017;Badailhac;139;6;145
84;Auvergne-Rhône-Alpes;15;2;05;018;Barriac-les-Bosquets;124;4;128
84;Auvergne-Rhône-Alpes;15;2;15;019;Bassignac;231;4;235
84;Auvergne-Rhône-Alpes;15;2;15;020;Beaulieu;94;4;98
84;Auvergne-Rhône-Alpes;15;1;08;269;Besse;126;3;129
84;Auvergne-Rhône-Alpes;15;1;06;021;Boisset;630;16;646
84;Auvergne-Rhône-Alpes;15;3;11;022;Bonnac;164;6;170
84;Auvergne-Rhône-Alpes;15;2;05;024;Brageac;76;0;76
84;Auvergne-Rhône-Alpes;15;3;12;026;Brezons;183;1;184
84;Auvergne-Rhône-Alpes;15;1;14;028;Carlat;352;10;362
84;Auvergne-Rhône-Alpes;15;1;01;029;Cassaniouze;528;17;545
84;Auvergne-Rhône-Alpes;15;1;13;030;Cayrols;294;7;301
84;Auvergne-Rhône-Alpes;15;3;09;032;Celoux;64;1;65
84;Auvergne-Rhône-Alpes;15;3;12;033;Cézens;218;4;222
84;Auvergne-Rhône-Alpes;15;3;09;034;Chaliers;160;8;168
84;Auvergne-Rhône-Alpes;15;2;05;036;Chalvignac;469;7;476
84;Auvergne-Rhône-Alpes;15;2;15;037;Champagnac;1095;24;1119
84;Auvergne-Rhône-Alpes;15;2;15;038;Champs-sur-Tarentaine-Marchal;1061;31;1092
84;Auvergne-Rhône-Alpes;15;3;10;040;Chanterelle;95;7;102
84;Auvergne-Rhône-Alpes;15;3;07;041;La Chapelle-d'Alagnon;249;6;255
84;Auvergne-Rhône-Alpes;15;3;11;042;La Chapelle-Laurent;261;3;264
84;Auvergne-Rhône-Alpes;15;3;07;043;Charmensac;85;2;87
84;Auvergne-Rhône-Alpes;15;3;09;045;Chaudes-Aigues;886;26;912
84;Auvergne-Rhône-Alpes;15;2;05;046;Chaussenac;219;3;222
84;Auvergne-Rhône-Alpes;15;3;09;048;Chazelles;33;0;33
84;Auvergne-Rhône-Alpes;15;3;07;049;Cheylade;225;6;231
84;Auvergne-Rhône-Alpes;15;3;07;050;Le Claux;181;2;183
84;Auvergne-Rhône-Alpes;15;3;09;051;Clavières;209;5;214
84;Auvergne-Rhône-Alpes;15;2;10;052;Collandres;152;12;164
84;Auvergne-Rhône-Alpes;15;3;11;053;Coltines;454;10;464
84;Auvergne-Rhône-Alpes;15;3;10;054;Condat;995;25;1020
84;Auvergne-Rhône-Alpes;15;3;11;055;Coren;434;12;446
84;Auvergne-Rhône-Alpes;15;1;08;056;Crandelles;845;22;867
84;Auvergne-Rhône-Alpes;15;1;13;057;Cros-de-Montvert;194;4;198
84;Auvergne-Rhône-Alpes;15;1;14;058;Cros-de-Ronesque;143;1;144
84;Auvergne-Rhône-Alpes;15;3;12;059;Cussac;127;7;134
84;Auvergne-Rhône-Alpes;15;3;09;060;Deux-Verges;50;2;52
84;Auvergne-Rhône-Alpes;15;3;07;061;Dienne;273;4;277
84;Auvergne-Rhône-Alpes;15;2;05;063;Drugeac;349;8;357
84;Auvergne-Rhône-Alpes;15;2;05;064;Escorailles;79;1;80
84;Auvergne-Rhône-Alpes;15;3;09;065;Espinasse;82;2;84
84;Auvergne-Rhône-Alpes;15;2;10;066;Le Falgoux;120;2;122
84;Auvergne-Rhône-Alpes;15;2;05;067;Le Fau;29;1;30
84;Auvergne-Rhône-Alpes;15;3;11;069;Ferrières-Saint-Mary;245;2;247
84;Auvergne-Rhône-Alpes;15;2;05;070;Fontanges;199;4;203
84;Auvergne-Rhône-Alpes;15;1;08;072;Freix-Anglards;218;6;224
84;Auvergne-Rhône-Alpes;15;3;09;073;Fridefont;103;2;105
84;Auvergne-Rhône-Alpes;15;1;14;074;Giou-de-Mamou;785;24;809
84;Auvergne-Rhône-Alpes;15;1;08;075;Girgols;76;4;80
84;Auvergne-Rhône-Alpes;15;1;13;076;Glénat;174;4;178
84;Auvergne-Rhône-Alpes;15;3;12;077;Gourdièges;60;0;60
84;Auvergne-Rhône-Alpes;15;3;09;078;Jabrun;155;2;157
84;Auvergne-Rhône-Alpes;15;2;15;079;Jaleyrac;370;9;379
84;Auvergne-Rhône-Alpes;15;1;14;081;Jou-sous-Monjou;102;2;104
84;Auvergne-Rhône-Alpes;15;3;07;080;Joursac;146;4;150
84;Auvergne-Rhône-Alpes;15;1;01;082;Junhac;301;11;312
84;Auvergne-Rhône-Alpes;15;1;08;083;Jussac;2019;72;2091
84;Auvergne-Rhône-Alpes;15;1;01;084;Labesserette;293;9;302
84;Auvergne-Rhône-Alpes;15;1;14;085;Labrousse;512;14;526
84;Auvergne-Rhône-Alpes;15;3;12;086;Lacapelle-Barrès;57;2;59
84;Auvergne-Rhône-Alpes;15;1;01;087;Lacapelle-del-Fraisse;344;10;354
84;Auvergne-Rhône-Alpes;15;1;13;088;Lacapelle-Viescamp;515;13;528
84;Auvergne-Rhône-Alpes;15;1;01;089;Ladinhac;458;8;466
84;Auvergne-Rhône-Alpes;15;1;01;090;Lafeuillade-en-Vézie;595;17;612
84;Auvergne-Rhône-Alpes;15;3;07;091;Landeyrat;89;5;94
84;Auvergne-Rhône-Alpes;15;2;15;092;Lanobre;1419;42;1461
84;Auvergne-Rhône-Alpes;15;1;01;093;Lapeyrugue;103;3;106
84;Auvergne-Rhône-Alpes;15;1;13;094;Laroquebrou;880;18;898
84;Auvergne-Rhône-Alpes;15;1;08;095;Laroquevieille;353;4;357
84;Auvergne-Rhône-Alpes;15;1;14;096;Lascelle;299;6;305
84;Auvergne-Rhône-Alpes;15;3;11;097;Lastic;122;4;126
84;Auvergne-Rhône-Alpes;15;3;11;098;Laurie;91;1;92
84;Auvergne-Rhône-Alpes;15;3;07;100;Laveissenet;130;3;133
84;Auvergne-Rhône-Alpes;15;3;07;101;Laveissière;524;14;538
84;Auvergne-Rhône-Alpes;15;3;07;102;Lavigerie;107;0;107
84;Auvergne-Rhône-Alpes;15;1;01;103;Leucamp;234;6;240
84;Auvergne-Rhône-Alpes;15;1;06;104;Leynhac;343;9;352
84;Auvergne-Rhône-Alpes;15;3;11;105;Leyvaux;37;3;40
84;Auvergne-Rhône-Alpes;15;3;09;106;Lieutadès;162;3;165
84;Auvergne-Rhône-Alpes;15;3;09;107;Lorcières;173;3;176
84;Auvergne-Rhône-Alpes;15;3;10;110;Lugarde;145;6;151
84;Auvergne-Rhône-Alpes;15;2;15;111;Madic;207;10;217
84;Auvergne-Rhône-Alpes;15;3;12;112;Malbo;97;5;102
84;Auvergne-Rhône-Alpes;15;1;14;113;Mandailles-Saint-Julien;187;3;190
84;Auvergne-Rhône-Alpes;15;3;10;114;Marcenat;515;7;522
84;Auvergne-Rhône-Alpes;15;3;10;116;Marchastel;154;11;165
84;Auvergne-Rhône-Alpes;15;1;06;117;Marcolès;595;60;655
84;Auvergne-Rhône-Alpes;15;1;08;118;Marmanhac;730;31;761
84;Auvergne-Rhône-Alpes;15;3;11;119;Massiac;1745;73;1818
84;Auvergne-Rhône-Alpes;15;2;05;120;Mauriac;3603;241;3844
84;Auvergne-Rhône-Alpes;15;3;09;121;Maurines;109;0;109
84;Auvergne-Rhône-Alpes;15;1;06;122;Maurs;2144;75;2219
84;Auvergne-Rhône-Alpes;15;2;10;123;Méallet;170;2;172
84;Auvergne-Rhône-Alpes;15;2;10;124;Menet;555;24;579
84;Auvergne-Rhône-Alpes;15;3;11;125;Mentières;127;3;130
84;Auvergne-Rhône-Alpes;15;3;11;126;Molèdes;92;2;94
84;Auvergne-Rhône-Alpes;15;3;11;127;Molompize;287;3;290
84;Auvergne-Rhône-Alpes;15;2;15;128;La Monselie;111;3;114
84;Auvergne-Rhône-Alpes;15;3;10;129;Montboudif;190;7;197
84;Auvergne-Rhône-Alpes;15;3;11;130;Montchamp;136;4;140
84;Auvergne-Rhône-Alpes;15;2;15;131;Le Monteil;285;12;297
84;Auvergne-Rhône-Alpes;15;3;10;132;Montgreleix;44;0;44
84;Auvergne-Rhône-Alpes;15;1;06;133;Montmurat;134;1;135
84;Auvergne-Rhône-Alpes;15;1;01;134;Montsalvy;817;12;829
84;Auvergne-Rhône-Alpes;15;1;13;135;Montvert;118;3;121
84;Auvergne-Rhône-Alpes;15;2;10;137;Moussages;273;7;280
84;Auvergne-Rhône-Alpes;15;3;07;138;Murat;1878;98;1976
84;Auvergne-Rhône-Alpes;15;3;12;139;Narnhac;72;0;72
84;Auvergne-Rhône-Alpes;15;1;08;140;Naucelles;2024;56;2080
84;Auvergne-Rhône-Alpes;15;3;07;141;Neussargues en Pinatelle;1818;30;1848
84;Auvergne-Rhône-Alpes;15;3;89;142;Neuvéglise-sur-Truyère;1746;43;1789
84;Auvergne-Rhône-Alpes;15;1;13;143;Nieudan;106;1;107
84;Auvergne-Rhône-Alpes;15;1;13;144;Omps;342;10;352
84;Auvergne-Rhône-Alpes;15;1;14;146;Pailherols;127;5;132
84;Auvergne-Rhône-Alpes;15;1;13;147;Parlan;437;14;451
84;Auvergne-Rhône-Alpes;15;3;12;148;Paulhac;414;11;425
84;Auvergne-Rhône-Alpes;15;3;12;149;Paulhenc;252;2;254
84;Auvergne-Rhône-Alpes;15;3;07;151;Peyrusse;153;0;153
84;Auvergne-Rhône-Alpes;15;3;12;152;Pierrefort;897;22;919
84;Auvergne-Rhône-Alpes;15;2;05;153;Pleaux;1489;35;1524
84;Auvergne-Rhône-Alpes;15;1;14;154;Polminhac;1163;28;1191
84;Auvergne-Rhône-Alpes;15;3;07;155;Pradiers;89;2;91
84;Auvergne-Rhône-Alpes;15;1;01;156;Prunet;677;15;692
84;Auvergne-Rhône-Alpes;15;1;88;027;Puycapel;783;14;797
84;Auvergne-Rhône-Alpes;15;1;06;157;Quézac;339;43;382
84;Auvergne-Rhône-Alpes;15;3;09;158;Rageade;100;2;102
84;Auvergne-Rhône-Alpes;15;1;14;159;Raulhac;272;7;279
84;Auvergne-Rhône-Alpes;15;1;08;160;Reilhac;1105;33;1138
84;Auvergne-Rhône-Alpes;15;3;11;161;Rézentières;110;2;112
84;Auvergne-Rhône-Alpes;15;2;10;162;Riom-ès-Montagnes;2513;63;2576
84;Auvergne-Rhône-Alpes;15;1;06;163;Roannes-Saint-Mary;1088;31;1119
84;Auvergne-Rhône-Alpes;15;3;11;164;Roffiac;615;18;633
84;Auvergne-Rhône-Alpes;15;1;13;165;Rouffiac;205;5;210
84;Auvergne-Rhône-Alpes;15;1;13;268;Le Rouget-Pers;1250;26;1276
84;Auvergne-Rhône-Alpes;15;1;13;166;Roumégoux;313;10;323
84;Auvergne-Rhône-Alpes;15;1;06;167;Rouziers;121;4;125
84;Auvergne-Rhône-Alpes;15;3;09;168;Ruynes-en-Margeride;707;24;731
84;Auvergne-Rhône-Alpes;15;2;15;169;Saignes;835;15;850
84;Auvergne-Rhône-Alpes;15;3;10;170;Saint-Amandin;231;4;235
84;Auvergne-Rhône-Alpes;15;1;06;172;Saint-Antoine;106;1;107
84;Auvergne-Rhône-Alpes;15;3;10;173;Saint-Bonnet-de-Condat;116;3;119
84;Auvergne-Rhône-Alpes;15;2;05;174;Saint-Bonnet-de-Salers;273;6;279
84;Auvergne-Rhône-Alpes;15;1;08;175;Saint-Cernin;1072;28;1100
84;Auvergne-Rhône-Alpes;15;2;08;176;Saint-Chamant;239;9;248
84;Auvergne-Rhône-Alpes;15;1;14;178;Saint-Cirgues-de-Jordanne;137;7;144
84;Auvergne-Rhône-Alpes;15;1;08;179;Saint-Cirgues-de-Malbert;249;4;253
84;Auvergne-Rhône-Alpes;15;1;14;180;Saint-Clément;75;1;76
84;Auvergne-Rhône-Alpes;15;1;06;181;Saint-Constant-Fournoulès;605;12;617
84;Auvergne-Rhône-Alpes;15;1;13;182;Saint-Étienne-Cantalès;132;3;135
84;Auvergne-Rhône-Alpes;15;1;14;183;Saint-Étienne-de-Carlat;132;2;134
84;Auvergne-Rhône-Alpes;15;2;10;185;Saint-Étienne-de-Chomeil;230;11;241
84;Auvergne-Rhône-Alpes;15;1;06;184;Saint-Étienne-de-Maurs;784;19;803
84;Auvergne-Rhône-Alpes;15;3;99;187;Saint-Flour;6435;512;6947
84;Auvergne-Rhône-Alpes;15;3;09;188;Saint-Georges;1177;30;1207
84;Auvergne-Rhône-Alpes;15;1;13;189;Saint-Gérons;217;7;224
84;Auvergne-Rhône-Alpes;15;2;10;190;Saint-Hippolyte;117;4;121
84;Auvergne-Rhône-Alpes;15;1;08;191;Saint-Illide;656;10;666
84;Auvergne-Rhône-Alpes;15;1;14;192;Saint-Jacques-des-Blats;330;5;335
84;Auvergne-Rhône-Alpes;15;1;06;194;Saint-Julien-de-Toursac;113;5;118
84;Auvergne-Rhône-Alpes;15;1;06;196;Saint-Mamet-la-Salvetat;1550;45;1595
84;Auvergne-Rhône-Alpes;15;3;09;199;Saint-Martial;81;1;82
84;Auvergne-Rhône-Alpes;15;2;05;200;Saint-Martin-Cantalès;146;3;149
84;Auvergne-Rhône-Alpes;15;3;12;201;Saint-Martin-sous-Vigouroux;236;5;241
84;Auvergne-Rhône-Alpes;15;2;05;202;Saint-Martin-Valmeroux;734;18;752
84;Auvergne-Rhône-Alpes;15;3;11;203;Saint-Mary-le-Plain;159;5;164
84;Auvergne-Rhône-Alpes;15;2;05;205;Saint-Paul-de-Salers;105;4;109
84;Auvergne-Rhône-Alpes;15;1;13;204;Saint-Paul-des-Landes;1534;47;1581
84;Auvergne-Rhône-Alpes;15;2;15;206;Saint-Pierre;134;2;136
84;Auvergne-Rhône-Alpes;15;3;11;207;Saint-Poncy;355;12;367
84;Auvergne-Rhône-Alpes;15;2;08;208;Saint-Projet-de-Salers;138;1;139
84;Auvergne-Rhône-Alpes;15;3;09;209;Saint-Rémy-de-Chaudes-Aigues;119;5;124
84;Auvergne-Rhône-Alpes;15;1;13;211;Saint-Santin-Cantalès;307;8;315
84;Auvergne-Rhône-Alpes;15;1;06;212;Saint-Santin-de-Maurs;356;15;371
84;Auvergne-Rhône-Alpes;15;3;07;213;Saint-Saturnin;205;4;209
84;Auvergne-Rhône-Alpes;15;1;13;214;Saint-Saury;185;5;190
84;Auvergne-Rhône-Alpes;15;1;14;215;Saint-Simon;1140;38;1178
84;Auvergne-Rhône-Alpes;15;3;09;216;Saint-Urcize;417;11;428
84;Auvergne-Rhône-Alpes;15;1;13;217;Saint-Victor;107;3;110
84;Auvergne-Rhône-Alpes;15;2;10;218;Saint-Vincent-de-Salers;66;2;68
84;Auvergne-Rhône-Alpes;15;2;05;186;Sainte-Eulalie;219;3;222
84;Auvergne-Rhône-Alpes;15;3;12;198;Sainte-Marie;108;1;109
84;Auvergne-Rhône-Alpes;15;2;05;219;Salers;329;5;334
84;Auvergne-Rhône-Alpes;15;2;05;220;Salins;147;2;149
84;Auvergne-Rhône-Alpes;15;1;06;221;Sansac-de-Marmiesse;1360;34;1394
84;Auvergne-Rhône-Alpes;15;1;01;222;Sansac-Veinazès;216;10;226
84;Auvergne-Rhône-Alpes;15;2;15;223;Sauvat;214;6;220
84;Auvergne-Rhône-Alpes;15;1;13;224;La Ségalassière;125;12;137
84;Auvergne-Rhône-Alpes;15;3;07;225;Ségur-les-Villas;202;5;207
84;Auvergne-Rhône-Alpes;15;1;01;226;Sénezergues;194;3;197
84;Auvergne-Rhône-Alpes;15;1;13;228;Siran;476;11;487
84;Auvergne-Rhône-Alpes;15;3;09;229;Soulages;80;3;83
84;Auvergne-Rhône-Alpes;15;2;15;230;Sourniac;201;9;210
84;Auvergne-Rhône-Alpes;15;3;11;231;Talizat;581;15;596
84;Auvergne-Rhône-Alpes;15;3;12;232;Tanavelle;234;8;242
84;Auvergne-Rhône-Alpes;15;1;08;233;Teissières-de-Cornet;293;5;298
84;Auvergne-Rhône-Alpes;15;1;14;234;Teissières-lès-Bouliès;329;6;335
84;Auvergne-Rhône-Alpes;15;3;12;235;Les Ternes;584;15;599
84;Auvergne-Rhône-Alpes;15;1;14;236;Thiézac;604;19;623
84;Auvergne-Rhône-Alpes;15;3;11;237;Tiviers;172;6;178
84;Auvergne-Rhône-Alpes;15;1;08;238;Tournemire;126;3;129
84;Auvergne-Rhône-Alpes;15;2;15;240;Trémouille;175;7;182
84;Auvergne-Rhône-Alpes;15;3;09;241;La Trinitat;48;4;52
84;Auvergne-Rhône-Alpes;15;1;06;242;Le Trioulou;103;3;106
84;Auvergne-Rhône-Alpes;15;2;10;243;Trizac;513;9;522
84;Auvergne-Rhône-Alpes;15;3;07;244;Ussel;479;9;488
84;Auvergne-Rhône-Alpes;15;3;09;245;Vabres;250;4;254
84;Auvergne-Rhône-Alpes;15;3;09;108;Val d'Arcomie;987;22;1009
84;Auvergne-Rhône-Alpes;15;2;10;246;Valette;228;8;236
84;Auvergne-Rhône-Alpes;15;3;11;247;Valjouze;24;0;24
84;Auvergne-Rhône-Alpes;15;3;12;248;Valuéjols;565;11;576
84;Auvergne-Rhône-Alpes;15;2;10;249;Le Vaulmier;71;4;75
84;Auvergne-Rhône-Alpes;15;2;15;250;Vebret;506;9;515
84;Auvergne-Rhône-Alpes;15;3;09;251;Védrines-Saint-Loup;141;7;148
84;Auvergne-Rhône-Alpes;15;1;14;252;Velzic;430;15;445
84;Auvergne-Rhône-Alpes;15;3;07;253;Vernols;65;1;66
84;Auvergne-Rhône-Alpes;15;2;15;254;Veyrières;112;3;115
84;Auvergne-Rhône-Alpes;15;1;14;255;Vézac;1205;36;1241
84;Auvergne-Rhône-Alpes;15;3;07;256;Vèze;56;5;61
84;Auvergne-Rhône-Alpes;15;1;14;257;Vezels-Roussy;130;3;133
84;Auvergne-Rhône-Alpes;15;1;14;258;Vic-sur-Cère;1828;33;1861
84;Auvergne-Rhône-Alpes;15;3;11;259;Vieillespesse;248;2;250
84;Auvergne-Rhône-Alpes;15;1;01;260;Vieillevie;111;4;115
84;Auvergne-Rhône-Alpes;15;2;05;261;Le Vigean;820;21;841
84;Auvergne-Rhône-Alpes;15;3;12;262;Villedieu;556;11;567
84;Auvergne-Rhône-Alpes;15;3;07;263;Virargues;133;6;139
84;Auvergne-Rhône-Alpes;15;1;06;264;Vitrac;265;6;271
84;Auvergne-Rhône-Alpes;15;2;15;265;Ydes;1699;30;1729
84;Auvergne-Rhône-Alpes;15;1;14;266;Yolet;550;10;560
84;Auvergne-Rhône-Alpes;15;1;02;267;Ytrac;4293;103;4396
75;Nouvelle-Aquitaine;16;3;10;001;Abzac;484;1;485
75;Nouvelle-Aquitaine;16;3;08;002;Les Adjots;525;8;533
75;Nouvelle-Aquitaine;16;1;19;003;Agris;857;10;867
75;Nouvelle-Aquitaine;16;3;08;005;Aigre;1591;39;1630
75;Nouvelle-Aquitaine;16;3;06;007;Alloue;468;11;479
75;Nouvelle-Aquitaine;16;3;05;008;Ambérac;319;2;321
75;Nouvelle-Aquitaine;16;3;10;009;Ambernac;368;6;374
75;Nouvelle-Aquitaine;16;2;07;010;Ambleville;180;4;184
75;Nouvelle-Aquitaine;16;3;05;011;Anais;581;21;602
75;Nouvelle-Aquitaine;16;2;07;012;Angeac-Champagne;509;9;518
75;Nouvelle-Aquitaine;16;2;07;013;Angeac-Charente;329;8;337
75;Nouvelle-Aquitaine;16;2;09;014;Angeduc;127;0;127
75;Nouvelle-Aquitaine;16;1;98;015;Angoulême;41740;1673;43413
75;Nouvelle-Aquitaine;16;3;10;016;Ansac-sur-Vienne;829;23;852
75;Nouvelle-Aquitaine;16;2;12;018;Ars;723;18;741
75;Nouvelle-Aquitaine;16;1;18;019;Asnières-sur-Nouère;1224;22;1246
75;Nouvelle-Aquitaine;16;1;17;020;Aubeterre-sur-Dronne;386;1;387
75;Nouvelle-Aquitaine;16;3;05;023;Aunac-sur-Charente;621;7;628
75;Nouvelle-Aquitaine;16;3;05;024;Aussac-Vadalle;513;8;521
75;Nouvelle-Aquitaine;16;2;09;025;Baignes-Sainte-Radegonde;1257;29;1286
75;Nouvelle-Aquitaine;16;1;14;026;Balzac;1337;33;1370
75;Nouvelle-Aquitaine;16;3;08;027;Barbezières;125;3;128
75;Nouvelle-Aquitaine;16;2;09;028;Barbezieux-Saint-Hilaire;4672;223;4895
75;Nouvelle-Aquitaine;16;1;17;029;Bardenac;228;9;237
75;Nouvelle-Aquitaine;16;2;09;030;Barret;1027;21;1048
75;Nouvelle-Aquitaine;16;3;08;031;Barro;413;11;424
75;Nouvelle-Aquitaine;16;2;15;032;Bassac;524;7;531
75;Nouvelle-Aquitaine;16;1;17;034;Bazac;143;5;148
75;Nouvelle-Aquitaine;16;3;06;035;Beaulieu-sur-Sonnette;207;3;210
75;Nouvelle-Aquitaine;16;2;09;036;Bécheresse;290;9;299
75;Nouvelle-Aquitaine;16;2;07;204;Bellevigne;1329;25;1354
75;Nouvelle-Aquitaine;16;1;17;037;Bellon;156;6;162
75;Nouvelle-Aquitaine;16;3;06;038;Benest;315;9;324
75;Nouvelle-Aquitaine;16;3;08;039;Bernac;489;9;498
75;Nouvelle-Aquitaine;16;2;09;040;Berneuil;316;6;322
75;Nouvelle-Aquitaine;16;1;17;041;Bessac;107;1;108
75;Nouvelle-Aquitaine;16;3;08;042;Bessé;121;7;128
75;Nouvelle-Aquitaine;16;3;08;044;Bioussac;227;7;234
75;Nouvelle-Aquitaine;16;2;07;045;Birac;361;5;366
75;Nouvelle-Aquitaine;16;1;17;047;Blanzaguet-Saint-Cybard;296;5;301
75;Nouvelle-Aquitaine;16;2;09;048;Boisbreteau;136;0;136
75;Nouvelle-Aquitaine;16;1;17;082;Boisné-La Tude;693;12;705
75;Nouvelle-Aquitaine;16;1;17;049;Bonnes;406;9;415
75;Nouvelle-Aquitaine;16;2;07;050;Bonneuil;260;1;261
75;Nouvelle-Aquitaine;16;2;09;053;Bors (Canton de Charente-Sud);116;1;117
75;Nouvelle-Aquitaine;16;1;17;052;Bors (Canton de Tude-et-Lavalette);268;4;272
75;Nouvelle-Aquitaine;16;3;06;054;Le Bouchage;166;1;167
75;Nouvelle-Aquitaine;16;1;04;055;Bouëx;892;12;904
75;Nouvelle-Aquitaine;16;2;15;056;Bourg-Charente;904;13;917
75;Nouvelle-Aquitaine;16;2;07;057;Bouteville;322;6;328
75;Nouvelle-Aquitaine;16;2;11;058;Boutiers-Saint-Trojan;1430;51;1481
75;Nouvelle-Aquitaine;16;3;08;059;Brettes;175;4;179
75;Nouvelle-Aquitaine;16;2;11;060;Bréville;466;13;479
75;Nouvelle-Aquitaine;16;1;16;061;Brie;4221;83;4304
75;Nouvelle-Aquitaine;16;2;09;062;Brie-sous-Barbezieux;130;1;131
75;Nouvelle-Aquitaine;16;1;17;063;Brie-sous-Chalais;154;0;154
75;Nouvelle-Aquitaine;16;3;10;064;Brigueuil;1096;17;1113
75;Nouvelle-Aquitaine;16;3;10;065;Brillac;639;6;645
75;Nouvelle-Aquitaine;16;2;09;066;Brossac;486;10;496
75;Nouvelle-Aquitaine;16;1;19;067;Bunzac;463;10;473
75;Nouvelle-Aquitaine;16;3;05;068;Cellefrouin;572;6;578
75;Nouvelle-Aquitaine;16;3;05;069;Cellettes;402;3;405
75;Nouvelle-Aquitaine;16;3;10;070;Chabanais;1651;33;1684
75;Nouvelle-Aquitaine;16;3;10;071;Chabrac;570;16;586
75;Nouvelle-Aquitaine;16;1;17;072;Chadurie;508;9;517
75;Nouvelle-Aquitaine;16;1;17;073;Chalais;1759;33;1792
75;Nouvelle-Aquitaine;16;2;09;074;Challignac;324;7;331
75;Nouvelle-Aquitaine;16;3;06;076;Champagne-Mouton;874;16;890
75;Nouvelle-Aquitaine;16;2;09;075;Champagne-Vigny;247;4;251
75;Nouvelle-Aquitaine;16;2;18;077;Champmillon;501;9;510
75;Nouvelle-Aquitaine;16;1;14;078;Champniers;5151;116;5267
75;Nouvelle-Aquitaine;16;2;09;079;Chantillac;332;3;335
75;Nouvelle-Aquitaine;16;3;05;081;La Chapelle;214;5;219
75;Nouvelle-Aquitaine;16;3;08;083;Charmé;355;6;361
75;Nouvelle-Aquitaine;16;1;19;084;Charras;337;3;340
75;Nouvelle-Aquitaine;16;3;06;085;Chasseneuil-sur-Bonnieure;3046;269;3315
75;Nouvelle-Aquitaine;16;3;10;086;Chassenon;880;20;900
75;Nouvelle-Aquitaine;16;3;06;087;Chassiecq;143;2;145
75;Nouvelle-Aquitaine;16;2;15;088;Chassors;1102;37;1139
75;Nouvelle-Aquitaine;16;2;12;089;Châteaubernard;3714;63;3777
75;Nouvelle-Aquitaine;16;2;07;090;Châteauneuf-sur-Charente;3536;62;3598
75;Nouvelle-Aquitaine;16;1;17;091;Châtignac;176;3;179
75;Nouvelle-Aquitaine;16;1;19;093;Chazelles;1558;25;1583
75;Nouvelle-Aquitaine;16;3;05;095;Chenon;135;5;140
75;Nouvelle-Aquitaine;16;3;06;096;Cherves-Châtelars;413;3;416
75;Nouvelle-Aquitaine;16;2;11;097;Cherves-Richemont;2344;101;2445
75;Nouvelle-Aquitaine;16;3;08;098;La Chèvrerie;140;2;142
75;Nouvelle-Aquitaine;16;2;09;099;Chillac;220;3;223
75;Nouvelle-Aquitaine;16;3;10;100;Chirac;751;17;768
75;Nouvelle-Aquitaine;16;1;04;101;Claix;1029;6;1035
75;Nouvelle-Aquitaine;16;2;99;102;Cognac;18825;450;19275
75;Nouvelle-Aquitaine;16;1;17;103;Combiers;124;5;129
75;Nouvelle-Aquitaine;16;3;08;104;Condac;477;9;486
75;Nouvelle-Aquitaine;16;2;09;105;Condéon;607;7;614
75;Nouvelle-Aquitaine;16;3;10;106;Confolens;2670;155;2825
75;Nouvelle-Aquitaine;16;2;09;046;Coteaux-du-Blanzacais;1033;18;1051
75;Nouvelle-Aquitaine;16;1;19;107;Coulgens;537;6;543
75;Nouvelle-Aquitaine;16;3;05;108;Coulonges;133;1;134
75;Nouvelle-Aquitaine;16;2;18;109;Courbillac;733;7;740
75;Nouvelle-Aquitaine;16;3;08;110;Courcôme;792;20;812
75;Nouvelle-Aquitaine;16;1;17;111;Courgeac;189;3;192
75;Nouvelle-Aquitaine;16;1;17;112;Courlac;54;2;56
75;Nouvelle-Aquitaine;16;1;13;113;La Couronne;7732;255;7987
75;Nouvelle-Aquitaine;16;3;08;114;Couture;159;3;162
75;Nouvelle-Aquitaine;16;2;07;116;Criteuil-la-Magdeleine;404;9;413
75;Nouvelle-Aquitaine;16;1;17;117;Curac;125;2;127
75;Nouvelle-Aquitaine;16;1;17;118;Deviat;143;0;143
75;Nouvelle-Aquitaine;16;1;04;119;Dignac;1322;15;1337
75;Nouvelle-Aquitaine;16;1;04;120;Dirac;1518;21;1539
75;Nouvelle-Aquitaine;16;2;18;121;Douzat;469;14;483
75;Nouvelle-Aquitaine;16;3;08;122;Ébréon;143;4;147
75;Nouvelle-Aquitaine;16;2;18;123;Échallat;497;4;501
75;Nouvelle-Aquitaine;16;1;19;124;Écuras;582;10;592
75;Nouvelle-Aquitaine;16;1;17;125;Édon;252;6;258
75;Nouvelle-Aquitaine;16;3;08;127;Empuré;100;3;103
75;Nouvelle-Aquitaine;16;3;10;128;Épenède;185;6;191
75;Nouvelle-Aquitaine;16;1;17;130;Les Essards;193;7;200
75;Nouvelle-Aquitaine;16;3;10;131;Esse;498;7;505
75;Nouvelle-Aquitaine;16;3;10;132;Étagnac;991;9;1000
75;Nouvelle-Aquitaine;16;2;09;133;Étriac;201;3;204
75;Nouvelle-Aquitaine;16;3;10;134;Exideuil-sur-Vienne;1014;27;1041
75;Nouvelle-Aquitaine;16;1;19;135;Eymouthiers;302;4;306
75;Nouvelle-Aquitaine;16;3;08;136;La Faye;596;11;607
75;Nouvelle-Aquitaine;16;1;19;137;Feuillade;310;6;316
75;Nouvelle-Aquitaine;16;1;01;138;Fléac;3742;103;3845
75;Nouvelle-Aquitaine;16;2;15;139;Fleurac;242;2;244
75;Nouvelle-Aquitaine;16;3;05;140;Fontclaireau;436;15;451
75;Nouvelle-Aquitaine;16;3;05;141;Fontenille;322;11;333
75;Nouvelle-Aquitaine;16;3;08;142;La Forêt-de-Tessé;189;6;195
75;Nouvelle-Aquitaine;16;1;17;143;Fouquebrune;682;13;695
75;Nouvelle-Aquitaine;16;3;08;144;Fouqueure;402;6;408
75;Nouvelle-Aquitaine;16;2;15;145;Foussignac;635;20;655
75;Nouvelle-Aquitaine;16;1;04;146;Garat;2055;34;2089
75;Nouvelle-Aquitaine;16;1;17;147;Gardes-le-Pontaroux;275;7;282
75;Nouvelle-Aquitaine;16;2;18;148;Genac-Bignac;997;13;1010
75;Nouvelle-Aquitaine;16;2;07;150;Gensac-la-Pallue;1549;41;1590
75;Nouvelle-Aquitaine;16;2;07;151;Genté;884;20;904
75;Nouvelle-Aquitaine;16;2;12;152;Gimeux;716;20;736
75;Nouvelle-Aquitaine;16;1;14;154;Gond-Pontouvre;6010;114;6124
75;Nouvelle-Aquitaine;16;3;08;155;Les Gours;108;1;109
75;Nouvelle-Aquitaine;16;3;06;157;Le Grand-Madieu;173;3;176
75;Nouvelle-Aquitaine;16;1;19;158;Grassac;323;5;328
75;Nouvelle-Aquitaine;16;2;07;297;Graves-Saint-Amant;334;10;344
75;Nouvelle-Aquitaine;16;2;09;160;Guimps;477;8;485
75;Nouvelle-Aquitaine;16;2;09;161;Guizengeard;170;2;172
75;Nouvelle-Aquitaine;16;1;17;162;Gurat;180;2;182
75;Nouvelle-Aquitaine;16;2;18;163;Hiersac;1101;20;1121
75;Nouvelle-Aquitaine;16;3;10;164;Hiesse;243;2;245
75;Nouvelle-Aquitaine;16;2;15;165;Houlette;368;4;372
75;Nouvelle-Aquitaine;16;1;02;166;L' Isle-d'Espagnac;5604;153;5757
75;Nouvelle-Aquitaine;16;2;15;167;Jarnac;4403;133;4536
75;Nouvelle-Aquitaine;16;1;16;168;Jauldes;801;8;809
75;Nouvelle-Aquitaine;16;2;12;169;Javrezac;583;8;591
75;Nouvelle-Aquitaine;16;1;17;170;Juignac;408;1;409
75;Nouvelle-Aquitaine;16;2;07;171;Juillac-le-Coq;649;12;661
75;Nouvelle-Aquitaine;16;3;05;173;Juillé;184;4;188
75;Nouvelle-Aquitaine;16;2;15;174;Julienne;508;11;519
75;Nouvelle-Aquitaine;16;2;09;176;Lachaise;319;6;325
75;Nouvelle-Aquitaine;16;2;09;177;Ladiville;120;2;122
75;Nouvelle-Aquitaine;16;2;09;178;Lagarde-sur-le-Né;184;5;189
75;Nouvelle-Aquitaine;16;1;17;180;Laprade;247;5;252
75;Nouvelle-Aquitaine;16;3;06;183;Lésignac-Durand;187;2;189
75;Nouvelle-Aquitaine;16;3;10;181;Lessac;535;11;546
75;Nouvelle-Aquitaine;16;3;10;182;Lesterps;479;15;494
75;Nouvelle-Aquitaine;16;3;05;184;Lichères;87;0;87
75;Nouvelle-Aquitaine;16;3;08;185;Ligné;159;2;161
75;Nouvelle-Aquitaine;16;2;07;186;Lignières-Sonneville;585;19;604
75;Nouvelle-Aquitaine;16;1;18;187;Linars;2078;48;2126
75;Nouvelle-Aquitaine;16;3;06;188;Le Lindois;345;4;349
75;Nouvelle-Aquitaine;16;3;08;189;Londigny;251;6;257
75;Nouvelle-Aquitaine;16;3;08;190;Longré;187;5;192
75;Nouvelle-Aquitaine;16;3;05;191;Lonnes;178;1;179
75;Nouvelle-Aquitaine;16;2;11;193;Louzac-Saint-André;995;18;1013
75;Nouvelle-Aquitaine;16;3;08;194;Lupsault;99;1;100
75;Nouvelle-Aquitaine;16;3;06;195;Lussac;290;7;297
75;Nouvelle-Aquitaine;16;3;05;196;Luxé;723;7;730
75;Nouvelle-Aquitaine;16;3;08;197;La Magdeleine;114;7;121
75;Nouvelle-Aquitaine;16;1;17;198;Magnac-Lavalette-Villars;440;5;445
75;Nouvelle-Aquitaine;16;1;16;199;Magnac-sur-Touvre;3139;68;3207
75;Nouvelle-Aquitaine;16;3;05;200;Maine-de-Boixe;484;3;487
75;Nouvelle-Aquitaine;16;2;15;153;Mainxe-Gondeville;1159;24;1183
75;Nouvelle-Aquitaine;16;1;19;203;Mainzac;110;0;110
75;Nouvelle-Aquitaine;16;3;10;205;Manot;550;5;555
75;Nouvelle-Aquitaine;16;3;05;206;Mansle;1671;17;1688
75;Nouvelle-Aquitaine;16;2;18;207;Marcillac-Lanville;511;10;521
75;Nouvelle-Aquitaine;16;2;18;208;Mareuil;405;4;409
75;Nouvelle-Aquitaine;16;1;19;209;Marillac-le-Franc;824;9;833
75;Nouvelle-Aquitaine;16;1;18;210;Marsac;827;11;838
75;Nouvelle-Aquitaine;16;1;19;211;Marthon;559;7;566
75;Nouvelle-Aquitaine;16;3;06;212;Massignac;390;6;396
75;Nouvelle-Aquitaine;16;3;06;213;Mazerolles;305;5;310
75;Nouvelle-Aquitaine;16;1;17;215;Médillac;158;5;163
75;Nouvelle-Aquitaine;16;2;15;216;Mérignac;839;14;853
75;Nouvelle-Aquitaine;16;2;12;217;Merpins;1104;40;1144
75;Nouvelle-Aquitaine;16;2;11;218;Mesnac;405;22;427
75;Nouvelle-Aquitaine;16;2;15;220;Les Métairies;727;15;742
75;Nouvelle-Aquitaine;16;2;18;221;Mons;247;4;251
75;Nouvelle-Aquitaine;16;1;17;222;Montboyer;350;7;357
75;Nouvelle-Aquitaine;16;1;19;223;Montbron;2028;23;2051
75;Nouvelle-Aquitaine;16;3;06;225;Montembœuf;653;29;682
75;Nouvelle-Aquitaine;16;3;05;226;Montignac-Charente;728;10;738
75;Nouvelle-Aquitaine;16;1;17;227;Montignac-le-Coq;138;2;140
75;Nouvelle-Aquitaine;16;3;08;229;Montjean;236;4;240
75;Nouvelle-Aquitaine;16;2;09;224;Montmérac;722;17;739
75;Nouvelle-Aquitaine;16;1;17;230;Montmoreau;2575;102;2677
75;Nouvelle-Aquitaine;16;3;10;231;Montrollet;312;2;314
75;Nouvelle-Aquitaine;16;1;16;232;Mornac;2172;51;2223
75;Nouvelle-Aquitaine;16;2;07;233;Mosnac;451;5;456
75;Nouvelle-Aquitaine;16;2;18;234;Moulidars;725;8;733
75;Nouvelle-Aquitaine;16;1;19;406;Moulins-sur-Tardoire;777;15;792
75;Nouvelle-Aquitaine;16;1;04;236;Mouthiers-sur-Boëme;2436;59;2495
75;Nouvelle-Aquitaine;16;3;05;237;Mouton;224;3;227
75;Nouvelle-Aquitaine;16;3;05;238;Moutonneau;115;0;115
75;Nouvelle-Aquitaine;16;3;06;239;Mouzon;131;2;133
75;Nouvelle-Aquitaine;16;1;17;240;Nabinaud;100;0;100
75;Nouvelle-Aquitaine;16;3;05;241;Nanclars;204;5;209
75;Nouvelle-Aquitaine;16;3;08;242;Nanteuil-en-Vallée;1359;25;1384
75;Nouvelle-Aquitaine;16;2;15;243;Nercillac;1081;22;1103
75;Nouvelle-Aquitaine;16;1;13;244;Nersac;2416;53;2469
75;Nouvelle-Aquitaine;16;3;06;245;Nieuil;932;22;954
75;Nouvelle-Aquitaine;16;1;17;246;Nonac;281;7;288
75;Nouvelle-Aquitaine;16;3;08;248;Oradour;164;1;165
75;Nouvelle-Aquitaine;16;3;10;249;Oradour-Fanais;396;3;399
75;Nouvelle-Aquitaine;16;1;19;250;Orgedeuil;229;1;230
75;Nouvelle-Aquitaine;16;2;09;251;Oriolles;255;6;261
75;Nouvelle-Aquitaine;16;1;17;252;Orival;154;3;157
75;Nouvelle-Aquitaine;16;3;08;253;Paizay-Naudouin-Embourie;368;3;371
75;Nouvelle-Aquitaine;16;1;17;254;Palluaud;228;6;234
75;Nouvelle-Aquitaine;16;3;06;255;Parzac;140;5;145
75;Nouvelle-Aquitaine;16;2;09;256;Passirac;240;11;251
75;Nouvelle-Aquitaine;16;2;09;258;Pérignac;462;10;472
75;Nouvelle-Aquitaine;16;1;17;260;Pillac;266;5;271
75;Nouvelle-Aquitaine;16;3;06;261;Les Pins;462;15;477
75;Nouvelle-Aquitaine;16;1;04;263;Plassac-Rouffiac;401;6;407
75;Nouvelle-Aquitaine;16;3;10;264;Pleuville;342;6;348
75;Nouvelle-Aquitaine;16;1;17;267;Poullignac;87;1;88
75;Nouvelle-Aquitaine;16;3;08;268;Poursac;204;2;206
75;Nouvelle-Aquitaine;16;1;19;269;Pranzac;903;10;913
75;Nouvelle-Aquitaine;16;3;10;270;Pressignac;349;5;354
75;Nouvelle-Aquitaine;16;1;13;271;Puymoyen;2377;145;2522
75;Nouvelle-Aquitaine;16;3;05;272;Puyréaux;533;9;542
75;Nouvelle-Aquitaine;16;3;08;273;Raix;141;7;148
75;Nouvelle-Aquitaine;16;3;08;275;Ranville-Breuillaud;176;2;178
75;Nouvelle-Aquitaine;16;2;09;276;Reignac;747;16;763
75;Nouvelle-Aquitaine;16;2;15;277;Réparsac;601;11;612
75;Nouvelle-Aquitaine;16;1;17;279;Rioux-Martin;233;3;236
75;Nouvelle-Aquitaine;16;1;19;280;Rivières;1999;31;2030
75;Nouvelle-Aquitaine;16;1;19;281;La Rochefoucauld-en-Angoumois;3981;155;4136
75;Nouvelle-Aquitaine;16;1;19;282;La Rochette;533;11;544
75;Nouvelle-Aquitaine;16;1;17;283;Ronsenac;571;7;578
75;Nouvelle-Aquitaine;16;1;17;284;Rouffiac;122;0;122
75;Nouvelle-Aquitaine;16;1;17;285;Rougnac;407;5;412
75;Nouvelle-Aquitaine;16;2;18;286;Rouillac;2976;50;3026
75;Nouvelle-Aquitaine;16;1;04;287;Roullet-Saint-Estèphe;4262;67;4329
75;Nouvelle-Aquitaine;16;3;06;289;Roussines;283;2;285
75;Nouvelle-Aquitaine;16;1;19;290;Rouzède;241;4;245
75;Nouvelle-Aquitaine;16;1;16;291;Ruelle-sur-Touvre;7201;205;7406
75;Nouvelle-Aquitaine;16;3;08;292;Ruffec;3410;161;3571
75;Nouvelle-Aquitaine;16;1;19;293;Saint-Adjutory;481;7;488
75;Nouvelle-Aquitaine;16;3;05;295;Saint-Amant-de-Boixe;1370;23;1393
75;Nouvelle-Aquitaine;16;2;18;298;Saint-Amant-de-Nouère;404;3;407
75;Nouvelle-Aquitaine;16;2;09;301;Saint-Aulais-la-Chapelle;233;3;236
75;Nouvelle-Aquitaine;16;1;17;302;Saint-Avit;199;2;201
75;Nouvelle-Aquitaine;16;2;09;303;Saint-Bonnet;407;6;413
75;Nouvelle-Aquitaine;16;2;11;304;Saint-Brice;965;34;999
75;Nouvelle-Aquitaine;16;3;10;306;Saint-Christophe;332;8;340
75;Nouvelle-Aquitaine;16;3;05;307;Saint-Ciers-sur-Bonnieure;334;14;348
75;Nouvelle-Aquitaine;16;3;06;308;Saint-Claud;1057;24;1081
75;Nouvelle-Aquitaine;16;3;06;310;Saint-Coutant;220;2;222
75;Nouvelle-Aquitaine;16;2;18;312;Saint-Cybardeaux;829;12;841
75;Nouvelle-Aquitaine;16;2;09;315;Saint-Félix;111;1;112
75;Nouvelle-Aquitaine;16;2;07;316;Saint-Fort-sur-le-Né;372;6;378
75;Nouvelle-Aquitaine;16;3;08;317;Saint-Fraigne;442;5;447
75;Nouvelle-Aquitaine;16;3;05;318;Saint-Front;369;1;370
75;Nouvelle-Aquitaine;16;2;18;320;Saint-Genis-d'Hiersac;907;18;925
75;Nouvelle-Aquitaine;16;3;08;321;Saint-Georges;54;0;54
75;Nouvelle-Aquitaine;16;1;19;323;Saint-Germain-de-Montbron;477;11;488
75;Nouvelle-Aquitaine;16;3;08;325;Saint-Gourson;140;1;141
75;Nouvelle-Aquitaine;16;3;05;326;Saint-Groux;137;0;137
75;Nouvelle-Aquitaine;16;3;06;329;Saint-Laurent-de-Céris;778;15;793
75;Nouvelle-Aquitaine;16;2;12;330;Saint-Laurent-de-Cognac;829;27;856
75;Nouvelle-Aquitaine;16;1;17;331;Saint-Laurent-des-Combes;92;2;94
75;Nouvelle-Aquitaine;16;1;17;334;Saint-Martial;131;3;134
75;Nouvelle-Aquitaine;16;3;08;335;Saint-Martin-du-Clocher;123;3;126
75;Nouvelle-Aquitaine;16;3;06;336;Saint-Mary;348;3;351
75;Nouvelle-Aquitaine;16;3;10;337;Saint-Maurice-des-Lions;881;24;905
75;Nouvelle-Aquitaine;16;2;09;338;Saint-Médard;326;4;330
75;Nouvelle-Aquitaine;16;2;15;340;Saint-Même-les-Carrières;1068;29;1097
75;Nouvelle-Aquitaine;16;1;13;341;Saint-Michel;3227;39;3266
75;Nouvelle-Aquitaine;16;2;09;342;Saint-Palais-du-Né;289;6;295
75;Nouvelle-Aquitaine;16;2;07;343;Saint-Preuil;292;10;302
75;Nouvelle-Aquitaine;16;1;17;346;Saint-Quentin-de-Chalais;255;8;263
75;Nouvelle-Aquitaine;16;3;10;345;Saint-Quentin-sur-Charente;215;2;217
75;Nouvelle-Aquitaine;16;1;17;347;Saint-Romain;529;14;543
75;Nouvelle-Aquitaine;16;1;18;348;Saint-Saturnin;1292;31;1323
75;Nouvelle-Aquitaine;16;1;17;350;Saint-Séverin;774;6;780
75;Nouvelle-Aquitaine;16;2;07;351;Saint-Simeux;594;13;607
75;Nouvelle-Aquitaine;16;2;07;352;Saint-Simon;203;3;206
75;Nouvelle-Aquitaine;16;1;19;353;Saint-Sornin;801;16;817
75;Nouvelle-Aquitaine;16;2;11;355;Saint-Sulpice-de-Cognac;1216;16;1232
75;Nouvelle-Aquitaine;16;3;08;356;Saint-Sulpice-de-Ruffec;31;0;31
75;Nouvelle-Aquitaine;16;2;09;357;Saint-Vallier;136;1;137
75;Nouvelle-Aquitaine;16;1;14;358;Saint-Yrieix-sur-Charente;7274;223;7497
75;Nouvelle-Aquitaine;16;2;15;349;Sainte-Sévère;524;11;535
75;Nouvelle-Aquitaine;16;2;09;354;Sainte-Souline;118;4;122
75;Nouvelle-Aquitaine;16;2;07;359;Salles-d'Angles;1026;28;1054
75;Nouvelle-Aquitaine;16;2;09;360;Salles-de-Barbezieux;427;92;519
75;Nouvelle-Aquitaine;16;3;08;361;Salles-de-Villefagnan;323;6;329
75;Nouvelle-Aquitaine;16;1;17;362;Salles-Lavalette;352;13;365
75;Nouvelle-Aquitaine;16;3;10;363;Saulgond;522;10;532
75;Nouvelle-Aquitaine;16;3;06;364;Sauvagnac;62;2;64
75;Nouvelle-Aquitaine;16;2;09;365;Sauvignac;104;1;105
75;Nouvelle-Aquitaine;16;2;07;366;Segonzac;2089;79;2168
75;Nouvelle-Aquitaine;16;1;04;368;Sers;871;20;891
75;Nouvelle-Aquitaine;16;2;15;369;Sigogne;992;20;1012
75;Nouvelle-Aquitaine;16;1;18;370;Sireuil;1158;42;1200
75;Nouvelle-Aquitaine;16;1;19;372;Souffrignac;134;2;136
75;Nouvelle-Aquitaine;16;3;08;373;Souvigné;208;6;214
75;Nouvelle-Aquitaine;16;1;03;374;Soyaux;9351;308;9659
75;Nouvelle-Aquitaine;16;3;06;375;Suaux;390;5;395
75;Nouvelle-Aquitaine;16;3;05;377;La Tâche;115;0;115
75;Nouvelle-Aquitaine;16;3;08;378;Taizé-Aizie;577;16;593
75;Nouvelle-Aquitaine;16;1;19;379;Taponnat-Fleurignac;1504;27;1531
75;Nouvelle-Aquitaine;16;2;09;380;Le Tâtre;394;6;400
75;Nouvelle-Aquitaine;16;3;89;192;Terres-de-Haute-Charente;3953;105;4058
75;Nouvelle-Aquitaine;16;3;08;381;Theil-Rabier;171;2;173
75;Nouvelle-Aquitaine;16;1;04;382;Torsac;749;32;781
75;Nouvelle-Aquitaine;16;3;05;383;Tourriers;758;9;767
75;Nouvelle-Aquitaine;16;2;09;384;Touvérac;626;6;632
75;Nouvelle-Aquitaine;16;1;16;385;Touvre;1191;26;1217
75;Nouvelle-Aquitaine;16;2;15;387;Triac-Lautrait;453;62;515
75;Nouvelle-Aquitaine;16;1;18;388;Trois-Palis;955;21;976
75;Nouvelle-Aquitaine;16;3;06;389;Turgon;86;3;89
75;Nouvelle-Aquitaine;16;3;08;390;Tusson;221;7;228
75;Nouvelle-Aquitaine;16;2;18;339;Val-d'Auge;811;19;830
75;Nouvelle-Aquitaine;16;3;05;300;Val-de-Bonnieure;1301;17;1318
75;Nouvelle-Aquitaine;16;2;09;175;Val des Vignes;1428;24;1452
75;Nouvelle-Aquitaine;16;3;05;392;Valence;197;4;201
75;Nouvelle-Aquitaine;16;3;05;393;Vars;2081;31;2112
75;Nouvelle-Aquitaine;16;1;17;394;Vaux-Lavalette;93;2;95
75;Nouvelle-Aquitaine;16;2;18;395;Vaux-Rouillac;297;3;300
75;Nouvelle-Aquitaine;16;3;05;396;Ventouse;126;0;126
75;Nouvelle-Aquitaine;16;3;08;397;Verdille;353;7;360
75;Nouvelle-Aquitaine;16;3;06;398;Verneuil;98;5;103
75;Nouvelle-Aquitaine;16;2;07;399;Verrières;352;9;361
75;Nouvelle-Aquitaine;16;3;08;400;Verteuil-sur-Charente;658;5;663
75;Nouvelle-Aquitaine;16;3;05;401;Vervant;146;2;148
75;Nouvelle-Aquitaine;16;2;07;402;Vibrac;287;5;292
75;Nouvelle-Aquitaine;16;3;06;403;Le Vieux-Cérier;131;3;134
75;Nouvelle-Aquitaine;16;3;06;404;Vieux-Ruffec;106;2;108
75;Nouvelle-Aquitaine;16;2;09;405;Vignolles;168;10;178
75;Nouvelle-Aquitaine;16;1;17;408;Villebois-Lavalette;744;20;764
75;Nouvelle-Aquitaine;16;3;08;409;Villefagnan;999;11;1010
75;Nouvelle-Aquitaine;16;3;05;412;Villejoubert;332;1;333
75;Nouvelle-Aquitaine;16;3;08;413;Villiers-le-Roux;137;2;139
75;Nouvelle-Aquitaine;16;3;05;414;Villognon;321;5;326
75;Nouvelle-Aquitaine;16;1;18;415;Vindelle;1075;18;1093
75;Nouvelle-Aquitaine;16;3;06;416;Vitrac-Saint-Vincent;521;10;531
75;Nouvelle-Aquitaine;16;3;05;419;Vouharte;329;2;331
75;Nouvelle-Aquitaine;16;1;04;420;Voulgézac;248;4;252
75;Nouvelle-Aquitaine;16;1;19;421;Vouthon;419;6;425
75;Nouvelle-Aquitaine;16;1;04;422;Vouzan;780;8;788
75;Nouvelle-Aquitaine;16;1;04;418;Vœuil-et-Giget;1509;27;1536
75;Nouvelle-Aquitaine;16;3;05;423;Xambes;293;4;297
75;Nouvelle-Aquitaine;16;1;17;424;Yviers;510;4;514
75;Nouvelle-Aquitaine;16;1;19;425;Yvrac-et-Malleyrand;547;10;557
75;Nouvelle-Aquitaine;17;1;07;002;Agudelle;134;4;138
75;Nouvelle-Aquitaine;17;2;23;003;Aigrefeuille-d'Aunis;4037;71;4108
75;Nouvelle-Aquitaine;17;1;07;005;Allas-Bocage;195;1;196
75;Nouvelle-Aquitaine;17;1;07;006;Allas-Champagne;264;4;268
75;Nouvelle-Aquitaine;17;2;06;007;Anais;320;7;327
75;Nouvelle-Aquitaine;17;3;09;008;Andilly;2235;33;2268
75;Nouvelle-Aquitaine;17;3;09;009;Angliers;1060;8;1068
75;Nouvelle-Aquitaine;17;3;03;010;Angoulins;3940;99;4039
75;Nouvelle-Aquitaine;17;5;18;011;Annepont;377;5;382
75;Nouvelle-Aquitaine;17;5;18;012;Annezay;162;5;167
75;Nouvelle-Aquitaine;17;5;11;013;Antezant-la-Chapelle;349;7;356
75;Nouvelle-Aquitaine;17;4;21;015;Arces;753;8;761
75;Nouvelle-Aquitaine;17;1;07;016;Archiac;772;12;784
75;Nouvelle-Aquitaine;17;5;18;017;Archingeay;671;13;684
75;Nouvelle-Aquitaine;17;2;23;018;Ardillières;849;13;862
75;Nouvelle-Aquitaine;17;3;05;019;Ars-en-Ré;1307;23;1330
75;Nouvelle-Aquitaine;17;1;07;020;Arthenac;345;4;349
75;Nouvelle-Aquitaine;17;2;26;021;Arvert;3448;78;3526
75;Nouvelle-Aquitaine;17;5;11;022;Asnières-la-Giraud;1050;31;1081
75;Nouvelle-Aquitaine;17;5;02;023;Aujac;369;6;375
75;Nouvelle-Aquitaine;17;5;11;024;Aulnay;1369;25;1394
75;Nouvelle-Aquitaine;17;5;02;025;Aumagne;707;11;718
75;Nouvelle-Aquitaine;17;5;02;026;Authon-Ébéon;390;5;395
75;Nouvelle-Aquitaine;17;1;12;027;Avy;476;7;483
75;Nouvelle-Aquitaine;17;3;01;028;Aytré;8725;160;8885
75;Nouvelle-Aquitaine;17;5;11;029;Bagnizeau;207;1;208
75;Nouvelle-Aquitaine;17;4;19;030;Balanzac;549;6;555
75;Nouvelle-Aquitaine;17;5;11;031;Ballans;197;2;199
75;Nouvelle-Aquitaine;17;2;23;032;Ballon;795;7;802
75;Nouvelle-Aquitaine;17;1;27;033;La Barde;497;6;503
75;Nouvelle-Aquitaine;17;4;21;034;Barzan;470;7;477
75;Nouvelle-Aquitaine;17;5;11;035;Bazauges;117;3;120
75;Nouvelle-Aquitaine;17;2;10;036;Beaugeay;779;20;799
75;Nouvelle-Aquitaine;17;5;11;037;Beauvais-sur-Matha;635;9;644
75;Nouvelle-Aquitaine;17;1;27;038;Bedenac;686;6;692
75;Nouvelle-Aquitaine;17;1;12;039;Belluire;208;1;209
75;Nouvelle-Aquitaine;17;3;09;041;Benon;1625;15;1640
75;Nouvelle-Aquitaine;17;5;02;042;Bercloux;439;9;448
75;Nouvelle-Aquitaine;17;5;18;043;Bernay-Saint-Martin;767;12;779
75;Nouvelle-Aquitaine;17;4;24;044;Berneuil;1146;21;1167
75;Nouvelle-Aquitaine;17;4;19;045;Beurlay;1034;18;1052
75;Nouvelle-Aquitaine;17;5;18;046;Bignay;411;13;424
75;Nouvelle-Aquitaine;17;1;12;047;Biron;230;1;231
75;Nouvelle-Aquitaine;17;5;11;048;Blanzac-lès-Matha;328;4;332
75;Nouvelle-Aquitaine;17;5;11;049;Blanzay-sur-Boutonne;82;5;87
75;Nouvelle-Aquitaine;17;1;12;050;Bois;530;132;662
75;Nouvelle-Aquitaine;17;3;05;051;Le Bois-Plage-en-Ré;2248;31;2279
75;Nouvelle-Aquitaine;17;1;12;052;Boisredon;702;9;711
75;Nouvelle-Aquitaine;17;5;18;053;Bords;1347;29;1376
75;Nouvelle-Aquitaine;17;1;27;054;Boresse-et-Martron;210;11;221
75;Nouvelle-Aquitaine;17;1;27;055;Boscamnant;387;2;389
75;Nouvelle-Aquitaine;17;1;12;056;Bougneau;605;14;619
75;Nouvelle-Aquitaine;17;2;06;057;Bouhet;903;16;919
75;Nouvelle-Aquitaine;17;2;10;058;Bourcefranc-le-Chapus;3454;119;3573
75;Nouvelle-Aquitaine;17;3;06;059;Bourgneuf;1275;23;1298
75;Nouvelle-Aquitaine;17;4;21;060;Boutenac-Touvent;224;5;229
75;Nouvelle-Aquitaine;17;1;27;061;Bran;130;2;132
75;Nouvelle-Aquitaine;17;2;04;486;La Brée-les-Bains;695;5;700
75;Nouvelle-Aquitaine;17;5;11;062;Bresdon;223;4;227
75;Nouvelle-Aquitaine;17;2;23;063;Breuil-la-Réorte;457;7;464
75;Nouvelle-Aquitaine;17;2;25;065;Breuil-Magné;1685;48;1733
75;Nouvelle-Aquitaine;17;2;26;064;Breuillet;2917;58;2975
75;Nouvelle-Aquitaine;17;1;07;066;Brie-sous-Archiac;241;5;246
75;Nouvelle-Aquitaine;17;5;11;067;Brie-sous-Matha;179;4;183
75;Nouvelle-Aquitaine;17;4;21;068;Brie-sous-Mortagne;236;3;239
75;Nouvelle-Aquitaine;17;1;24;069;Brives-sur-Charente;233;6;239
75;Nouvelle-Aquitaine;17;5;02;070;Brizambourg;905;15;920
75;Nouvelle-Aquitaine;17;5;11;071;La Brousse;509;9;518
75;Nouvelle-Aquitaine;17;4;02;072;Burie;1279;26;1305
75;Nouvelle-Aquitaine;17;1;27;074;Bussac-Forêt;1034;16;1050
75;Nouvelle-Aquitaine;17;4;02;073;Bussac-sur-Charente;1266;39;1305
75;Nouvelle-Aquitaine;17;2;25;075;Cabariot;1341;24;1365
75;Nouvelle-Aquitaine;17;1;07;076;Celles;323;3;326
75;Nouvelle-Aquitaine;17;1;27;077;Cercoux;1171;14;1185
75;Nouvelle-Aquitaine;17;1;12;078;Chadenac;498;7;505
75;Nouvelle-Aquitaine;17;2;26;079;Chaillevette;1565;33;1598
75;Nouvelle-Aquitaine;17;2;23;080;Chambon;928;12;940
75;Nouvelle-Aquitaine;17;1;27;081;Chamouillac;374;7;381
75;Nouvelle-Aquitaine;17;1;07;082;Champagnac;529;8;537
75;Nouvelle-Aquitaine;17;2;10;083;Champagne;611;12;623
75;Nouvelle-Aquitaine;17;1;12;084;Champagnolles;648;8;656
75;Nouvelle-Aquitaine;17;5;18;085;Champdolent;400;7;407
75;Nouvelle-Aquitaine;17;4;02;086;Chaniers;3590;90;3680
75;Nouvelle-Aquitaine;17;5;18;087;Chantemerle-sur-la-Soie;185;3;188
75;Nouvelle-Aquitaine;17;4;02;089;La Chapelle-des-Pots;1002;23;1025
75;Nouvelle-Aquitaine;17;3;09;091;Charron;1989;23;2012
75;Nouvelle-Aquitaine;17;1;27;092;Chartuzac;151;2;153
75;Nouvelle-Aquitaine;17;2;04;093;Le Château-d'Oléron;4184;66;4250
75;Nouvelle-Aquitaine;17;3;03;094;Châtelaillon-Plage;5846;91;5937
75;Nouvelle-Aquitaine;17;1;27;095;Chatenet;222;7;229
75;Nouvelle-Aquitaine;17;1;07;096;Chaunac;78;2;80
75;Nouvelle-Aquitaine;17;4;22;097;Le Chay;767;15;782
75;Nouvelle-Aquitaine;17;4;21;098;Chenac-Saint-Seurin-d'Uzet;594;13;607
75;Nouvelle-Aquitaine;17;1;27;099;Chepniers;646;11;657
75;Nouvelle-Aquitaine;17;4;02;100;Chérac;1104;16;1120
75;Nouvelle-Aquitaine;17;5;11;101;Cherbonnières;338;2;340
75;Nouvelle-Aquitaine;17;4;24;102;Chermignac;1247;34;1281
75;Nouvelle-Aquitaine;17;1;27;104;Chevanceaux;1044;113;1157
75;Nouvelle-Aquitaine;17;5;11;105;Chives;331;1;332
75;Nouvelle-Aquitaine;17;1;07;106;Cierzac;307;5;312
75;Nouvelle-Aquitaine;17;2;23;107;Ciré-d'Aunis;1361;23;1384
75;Nouvelle-Aquitaine;17;1;07;108;Clam;418;15;433
75;Nouvelle-Aquitaine;17;3;06;109;Clavette;1380;19;1399
75;Nouvelle-Aquitaine;17;1;27;110;Clérac;977;16;993
75;Nouvelle-Aquitaine;17;1;07;111;Clion;813;12;825
75;Nouvelle-Aquitaine;17;4;24;112;La Clisse;691;15;706
75;Nouvelle-Aquitaine;17;1;27;113;La Clotte;708;7;715
75;Nouvelle-Aquitaine;17;5;11;114;Coivert;213;2;215
75;Nouvelle-Aquitaine;17;4;24;115;Colombiers;313;7;320
75;Nouvelle-Aquitaine;17;1;07;116;Consac;211;8;219
75;Nouvelle-Aquitaine;17;5;11;117;Contré;145;2;147
75;Nouvelle-Aquitaine;17;1;27;118;Corignac;360;10;370
75;Nouvelle-Aquitaine;17;4;22;119;Corme-Écluse;1113;22;1135
75;Nouvelle-Aquitaine;17;4;24;120;Corme-Royal;1839;38;1877
75;Nouvelle-Aquitaine;17;3;05;121;La Couarde-sur-Mer;1206;20;1226
75;Nouvelle-Aquitaine;17;1;24;122;Coulonges;241;4;245
75;Nouvelle-Aquitaine;17;5;18;124;Courant;414;5;419
75;Nouvelle-Aquitaine;17;5;11;125;Courcelles;471;10;481
75;Nouvelle-Aquitaine;17;5;11;126;Courcerac;296;6;302
75;Nouvelle-Aquitaine;17;4;24;128;Courcoury;690;12;702
75;Nouvelle-Aquitaine;17;1;12;129;Courpignac;412;6;418
75;Nouvelle-Aquitaine;17;3;09;127;Courçon;1740;28;1768
75;Nouvelle-Aquitaine;17;1;27;130;Coux;456;13;469
75;Nouvelle-Aquitaine;17;4;21;131;Cozes;2142;43;2185
75;Nouvelle-Aquitaine;17;3;09;132;Cramchaban;655;13;668
75;Nouvelle-Aquitaine;17;4;21;133;Cravans;872;75;947
75;Nouvelle-Aquitaine;17;4;19;134;Crazannes;440;10;450
75;Nouvelle-Aquitaine;17;5;11;135;Cressé;240;3;243
75;Nouvelle-Aquitaine;17;3;06;136;Croix-Chapeau;1245;27;1272
75;Nouvelle-Aquitaine;17;5;18;137;La Croix-Comtesse;223;3;226
75;Nouvelle-Aquitaine;17;5;11;138;Dampierre-sur-Boutonne;282;3;285
75;Nouvelle-Aquitaine;17;2;89;457;La Devise;1121;17;1138
75;Nouvelle-Aquitaine;17;2;04;140;Dolus-d'Oléron;3229;67;3296
75;Nouvelle-Aquitaine;17;4;02;141;Dompierre-sur-Charente;458;9;467
75;Nouvelle-Aquitaine;17;3;01;142;Dompierre-sur-Mer;5482;139;5621
75;Nouvelle-Aquitaine;17;4;02;143;Le Douhet;713;13;726
75;Nouvelle-Aquitaine;17;5;18;139;Dœuil-sur-le-Mignon;338;7;345
75;Nouvelle-Aquitaine;17;1;12;145;Échebrune;485;8;493
75;Nouvelle-Aquitaine;17;2;25;146;Échillais;3545;60;3605
75;Nouvelle-Aquitaine;17;4;02;147;Écoyeux;1354;23;1377
75;Nouvelle-Aquitaine;17;4;19;148;Écurat;471;15;486
75;Nouvelle-Aquitaine;17;5;11;149;Les Éduts;62;1;63
75;Nouvelle-Aquitaine;17;5;11;150;Les Églises-d'Argenteuil;519;7;526
75;Nouvelle-Aquitaine;17;2;22;151;L' Éguille;872;21;893
75;Nouvelle-Aquitaine;17;4;21;152;Épargnes;843;7;850
75;Nouvelle-Aquitaine;17;3;08;153;Esnandes;2069;24;2093
75;Nouvelle-Aquitaine;17;4;19;154;Les Essards;698;8;706
75;Nouvelle-Aquitaine;17;5;18;277;Essouvert;1163;76;1239
75;Nouvelle-Aquitaine;17;2;26;155;Étaules;2475;42;2517
75;Nouvelle-Aquitaine;17;1;27;156;Expiremont;127;3;130
75;Nouvelle-Aquitaine;17;5;18;157;Fenioux;160;2;162
75;Nouvelle-Aquitaine;17;3;09;158;Ferrières;922;7;929
75;Nouvelle-Aquitaine;17;1;12;159;Fléac-sur-Seugne;373;7;380
75;Nouvelle-Aquitaine;17;4;21;160;Floirac;371;4;375
75;Nouvelle-Aquitaine;17;3;05;161;La Flotte;2762;42;2804
75;Nouvelle-Aquitaine;17;5;11;162;Fontaine-Chalendray;201;0;201
75;Nouvelle-Aquitaine;17;1;07;163;Fontaines-d'Ozillac;520;12;532
75;Nouvelle-Aquitaine;17;4;02;164;Fontcouverte;2354;55;2409
75;Nouvelle-Aquitaine;17;5;11;165;Fontenet;396;13;409
75;Nouvelle-Aquitaine;17;2;23;166;Forges;1301;14;1315
75;Nouvelle-Aquitaine;17;1;27;167;Le Fouilloux;774;14;788
75;Nouvelle-Aquitaine;17;2;03;168;Fouras;4006;76;4082
75;Nouvelle-Aquitaine;17;4;19;171;Geay;747;20;767
75;Nouvelle-Aquitaine;17;4;21;172;Gémozac;2851;29;2880
75;Nouvelle-Aquitaine;17;1;27;173;La Genétouze;230;8;238
75;Nouvelle-Aquitaine;17;2;25;174;Genouillé;895;9;904
75;Nouvelle-Aquitaine;17;1;07;175;Germignac;651;7;658
75;Nouvelle-Aquitaine;17;5;11;176;Gibourne;112;0;112
75;Nouvelle-Aquitaine;17;5;11;177;Le Gicq;125;0;125
75;Nouvelle-Aquitaine;17;1;12;178;Givrezac;68;1;69
75;Nouvelle-Aquitaine;17;4;24;179;Les Gonds;1726;70;1796
75;Nouvelle-Aquitaine;17;5;11;180;Gourvillette;89;3;92
75;Nouvelle-Aquitaine;17;2;04;485;Le Grand-Village-Plage;1051;14;1065
75;Nouvelle-Aquitaine;17;5;18;181;Grandjean;300;6;306
75;Nouvelle-Aquitaine;17;3;09;182;La Grève-sur-Mignon;563;11;574
75;Nouvelle-Aquitaine;17;4;21;183;Grézac;929;19;948
75;Nouvelle-Aquitaine;17;2;10;184;La Gripperie-Saint-Symphorien;593;5;598
75;Nouvelle-Aquitaine;17;2;10;185;Le Gua;2097;33;2130
75;Nouvelle-Aquitaine;17;3;09;186;Le Gué-d'Alleré;928;11;939
75;Nouvelle-Aquitaine;17;1;07;187;Guitinières;542;6;548
75;Nouvelle-Aquitaine;17;5;11;188;Haimps;464;9;473
75;Nouvelle-Aquitaine;17;3;08;190;L' Houmeau;2853;56;2909
75;Nouvelle-Aquitaine;17;2;03;004;Île-d'Aix;224;5;229
75;Nouvelle-Aquitaine;17;4;24;191;La Jard;422;3;425
75;Nouvelle-Aquitaine;17;1;07;192;Jarnac-Champagne;786;20;806
75;Nouvelle-Aquitaine;17;3;06;193;La Jarne;2490;42;2532
75;Nouvelle-Aquitaine;17;3;06;194;La Jarrie;3265;68;3333
75;Nouvelle-Aquitaine;17;5;18;195;La Jarrie-Audouin;265;15;280
75;Nouvelle-Aquitaine;17;4;21;196;Jazennes;532;7;539
75;Nouvelle-Aquitaine;17;1;07;197;Jonzac;3432;224;3656
75;Nouvelle-Aquitaine;17;5;02;198;Juicq;294;0;294
75;Nouvelle-Aquitaine;17;1;27;199;Jussas;150;2;152
75;Nouvelle-Aquitaine;17;3;08;200;Lagord;7048;151;7199
75;Nouvelle-Aquitaine;17;3;09;201;La Laigne;474;5;479
75;Nouvelle-Aquitaine;17;5;18;202;Landes;611;17;628
75;Nouvelle-Aquitaine;17;2;23;203;Landrais;736;9;745
75;Nouvelle-Aquitaine;17;1;07;204;Léoville;312;8;320
75;Nouvelle-Aquitaine;17;2;25;205;Loire-les-Marais;393;9;402
75;Nouvelle-Aquitaine;17;5;11;206;Loiré-sur-Nie;284;4;288
75;Nouvelle-Aquitaine;17;3;05;207;Loix;729;17;746
75;Nouvelle-Aquitaine;17;3;09;208;Longèves;975;15;990
75;Nouvelle-Aquitaine;17;1;07;209;Lonzac;271;4;275
75;Nouvelle-Aquitaine;17;1;12;210;Lorignac;493;4;497
75;Nouvelle-Aquitaine;17;5;18;211;Loulay;766;9;775
75;Nouvelle-Aquitaine;17;5;11;212;Louzignac;160;1;161
75;Nouvelle-Aquitaine;17;5;18;213;Lozay;136;4;140
75;Nouvelle-Aquitaine;17;4;24;214;Luchat;525;11;536
75;Nouvelle-Aquitaine;17;1;07;215;Lussac;52;0;52
75;Nouvelle-Aquitaine;17;2;25;216;Lussant;1002;14;1016
75;Nouvelle-Aquitaine;17;5;11;217;Macqueville;290;8;298
75;Nouvelle-Aquitaine;17;3;09;218;Marans;4497;64;4561
75;Nouvelle-Aquitaine;17;2;10;219;Marennes-Hiers-Brouage;6252;104;6356
75;Nouvelle-Aquitaine;17;1;12;220;Marignac;422;17;439
75;Nouvelle-Aquitaine;17;2;23;221;Marsais;922;21;943
75;Nouvelle-Aquitaine;17;3;08;222;Marsilly;3045;88;3133
75;Nouvelle-Aquitaine;17;5;11;223;Massac;175;2;177
75;Nouvelle-Aquitaine;17;5;11;224;Matha;2166;80;2246
75;Nouvelle-Aquitaine;17;2;26;225;Les Mathes;1974;29;2003
75;Nouvelle-Aquitaine;17;5;18;226;Mazeray;959;14;973
75;Nouvelle-Aquitaine;17;1;12;227;Mazerolles;228;3;231
75;Nouvelle-Aquitaine;17;4;22;228;Médis;2881;68;2949
75;Nouvelle-Aquitaine;17;1;27;229;Mérignac;224;3;227
75;Nouvelle-Aquitaine;17;2;21;230;Meschers-sur-Gironde;3110;64;3174
75;Nouvelle-Aquitaine;17;1;27;231;Messac;105;6;111
75;Nouvelle-Aquitaine;17;4;21;232;Meursac;1489;21;1510
75;Nouvelle-Aquitaine;17;1;07;233;Meux;316;7;323
75;Nouvelle-Aquitaine;17;5;18;234;Migré;331;6;337
75;Nouvelle-Aquitaine;17;4;02;235;Migron;724;15;739
75;Nouvelle-Aquitaine;17;1;12;236;Mirambeau;1492;31;1523
75;Nouvelle-Aquitaine;17;2;10;237;Moëze;564;4;568
75;Nouvelle-Aquitaine;17;5;11;239;Mons;438;8;446
75;Nouvelle-Aquitaine;17;1;27;240;Montendre;3242;55;3297
75;Nouvelle-Aquitaine;17;1;27;241;Montguyon;1576;23;1599
75;Nouvelle-Aquitaine;17;4;24;242;Montils;853;12;865
75;Nouvelle-Aquitaine;17;1;27;243;Montlieu-la-Garde;1264;10;1274
75;Nouvelle-Aquitaine;17;4;21;244;Montpellier-de-Médillan;682;8;690
75;Nouvelle-Aquitaine;17;3;06;245;Montroy;893;13;906
75;Nouvelle-Aquitaine;17;2;25;246;Moragne;507;7;514
75;Nouvelle-Aquitaine;17;2;26;247;Mornac-sur-Seudre;841;12;853
75;Nouvelle-Aquitaine;17;4;21;248;Mortagne-sur-Gironde;904;11;915
75;Nouvelle-Aquitaine;17;1;07;249;Mortiers;186;1;187
75;Nouvelle-Aquitaine;17;1;12;250;Mosnac;466;5;471
75;Nouvelle-Aquitaine;17;5;18;252;Le Mung;305;8;313
75;Nouvelle-Aquitaine;17;2;25;253;Muron;1344;17;1361
75;Nouvelle-Aquitaine;17;5;18;254;Nachamps;194;4;198
75;Nouvelle-Aquitaine;17;4;19;255;Nancras;786;12;798
75;Nouvelle-Aquitaine;17;5;02;256;Nantillé;326;12;338
75;Nouvelle-Aquitaine;17;5;11;257;Néré;734;8;742
75;Nouvelle-Aquitaine;17;1;07;258;Neuillac;302;11;313
75;Nouvelle-Aquitaine;17;1;07;259;Neulles;148;2;150
75;Nouvelle-Aquitaine;17;1;27;260;Neuvicq;452;5;457
75;Nouvelle-Aquitaine;17;5;11;261;Neuvicq-le-Château;321;5;326
75;Nouvelle-Aquitaine;17;1;07;263;Nieul-le-Virouil;578;18;596
75;Nouvelle-Aquitaine;17;4;19;262;Nieul-lès-Saintes;1252;22;1274
75;Nouvelle-Aquitaine;17;3;08;264;Nieul-sur-Mer;5759;144;5903
75;Nouvelle-Aquitaine;17;2;10;265;Nieulle-sur-Seudre;1227;20;1247
75;Nouvelle-Aquitaine;17;5;18;266;Les Nouillers;698;8;706
75;Nouvelle-Aquitaine;17;3;09;267;Nuaillé-d'Aunis;1139;15;1154
75;Nouvelle-Aquitaine;17;5;11;268;Nuaillé-sur-Boutonne;198;7;205
75;Nouvelle-Aquitaine;17;1;27;269;Orignolles;676;7;683
75;Nouvelle-Aquitaine;17;1;07;270;Ozillac;626;14;640
75;Nouvelle-Aquitaine;17;5;11;271;Paillé;315;6;321
75;Nouvelle-Aquitaine;17;1;24;273;Pérignac;1017;13;1030
75;Nouvelle-Aquitaine;17;3;01;274;Périgny;8428;184;8612
75;Nouvelle-Aquitaine;17;4;24;275;Pessines;745;29;774
75;Nouvelle-Aquitaine;17;1;27;276;Le Pin;80;1;81
75;Nouvelle-Aquitaine;17;4;24;278;Pisany;738;10;748
75;Nouvelle-Aquitaine;17;1;12;279;Plassac;597;5;602
75;Nouvelle-Aquitaine;17;4;19;280;Plassay;721;18;739
75;Nouvelle-Aquitaine;17;1;27;281;Polignac;170;3;173
75;Nouvelle-Aquitaine;17;1;27;282;Pommiers-Moulons;207;2;209
75;Nouvelle-Aquitaine;17;1;12;283;Pons;4182;249;4431
75;Nouvelle-Aquitaine;17;4;19;284;Pont-l'Abbé-d'Arnoult;1807;235;2042
75;Nouvelle-Aquitaine;17;4;19;285;Port-d'Envaux;1154;28;1182
75;Nouvelle-Aquitaine;17;2;25;484;Port-des-Barques;1777;17;1794
75;Nouvelle-Aquitaine;17;3;05;286;Les Portes-en-Ré;606;12;618
75;Nouvelle-Aquitaine;17;1;27;287;Pouillac;249;0;249
75;Nouvelle-Aquitaine;17;5;11;288;Poursay-Garnaud;315;6;321
75;Nouvelle-Aquitaine;17;4;24;289;Préguillac;450;18;468
75;Nouvelle-Aquitaine;17;5;11;290;Prignac;297;9;306
75;Nouvelle-Aquitaine;17;3;01;291;Puilboreau;6182;117;6299
75;Nouvelle-Aquitaine;17;5;18;292;Puy-du-Lac;487;5;492
75;Nouvelle-Aquitaine;17;2;23;293;Puyravault;673;10;683
75;Nouvelle-Aquitaine;17;5;18;294;Puyrolland;201;1;202
75;Nouvelle-Aquitaine;17;1;07;295;Réaux sur Trèfle;821;15;836
75;Nouvelle-Aquitaine;17;4;24;296;Rétaud;1069;19;1088
75;Nouvelle-Aquitaine;17;4;24;298;Rioux;960;18;978
75;Nouvelle-Aquitaine;17;3;05;297;Rivedoux-Plage;2280;45;2325
75;Nouvelle-Aquitaine;17;2;13;299;Rochefort;24151;694;24845
75;Nouvelle-Aquitaine;17;3;99;300;La Rochelle;75735;2120;77855
75;Nouvelle-Aquitaine;17;5;11;301;Romazières;71;1;72
75;Nouvelle-Aquitaine;17;4;19;302;Romegoux;603;8;611
75;Nouvelle-Aquitaine;17;3;09;303;La Ronde;1050;32;1082
75;Nouvelle-Aquitaine;17;4;24;304;Rouffiac;459;5;464
75;Nouvelle-Aquitaine;17;1;27;305;Rouffignac;422;9;431
75;Nouvelle-Aquitaine;17;2;17;306;Royan;18398;551;18949
75;Nouvelle-Aquitaine;17;4;22;307;Sablonceaux;1397;31;1428
75;Nouvelle-Aquitaine;17;2;10;308;Saint-Agnant;2682;61;2743
75;Nouvelle-Aquitaine;17;1;27;309;Saint-Aigulin;1911;40;1951
75;Nouvelle-Aquitaine;17;4;21;310;Saint-André-de-Lidon;1105;14;1119
75;Nouvelle-Aquitaine;17;2;26;311;Saint-Augustin;1351;24;1375
75;Nouvelle-Aquitaine;17;1;12;312;Saint-Bonnet-sur-Gironde;825;14;839
75;Nouvelle-Aquitaine;17;4;02;313;Saint-Bris-des-Bois;389;9;398
75;Nouvelle-Aquitaine;17;4;02;314;Saint-Césaire;875;17;892
75;Nouvelle-Aquitaine;17;3;06;315;Saint-Christophe;1357;27;1384
75;Nouvelle-Aquitaine;17;1;07;316;Saint-Ciers-Champagne;416;13;429
75;Nouvelle-Aquitaine;17;1;12;317;Saint-Ciers-du-Taillon;550;8;558
75;Nouvelle-Aquitaine;17;3;05;318;Saint-Clément-des-Baleines;644;10;654
75;Nouvelle-Aquitaine;17;2;25;320;Saint-Coutant-le-Grand;421;1;422
75;Nouvelle-Aquitaine;17;2;18;321;Saint-Crépin;347;3;350
75;Nouvelle-Aquitaine;17;3;09;322;Saint-Cyr-du-Doret;656;4;660
75;Nouvelle-Aquitaine;17;2;04;323;Saint-Denis-d'Oléron;1320;22;1342
75;Nouvelle-Aquitaine;17;1;07;324;Saint-Dizant-du-Bois;111;1;112
75;Nouvelle-Aquitaine;17;1;12;325;Saint-Dizant-du-Gua;533;3;536
75;Nouvelle-Aquitaine;17;1;07;326;Saint-Eugène;276;5;281
75;Nouvelle-Aquitaine;17;5;18;327;Saint-Félix;299;3;302
75;Nouvelle-Aquitaine;17;1;12;328;Saint-Fort-sur-Gironde;909;10;919
75;Nouvelle-Aquitaine;17;2;10;329;Saint-Froult;335;7;342
75;Nouvelle-Aquitaine;17;1;12;331;Saint-Genis-de-Saintonge;1244;51;1295
75;Nouvelle-Aquitaine;17;1;07;332;Saint-Georges-Antignac;379;6;385
75;Nouvelle-Aquitaine;17;2;04;337;Saint-Georges-d'Oléron;3719;56;3775
75;Nouvelle-Aquitaine;17;2;17;333;Saint-Georges-de-Didonne;5360;111;5471
75;Nouvelle-Aquitaine;17;5;11;334;Saint-Georges-de-Longuepierre;230;4;234
75;Nouvelle-Aquitaine;17;1;12;335;Saint-Georges-des-Agoûts;288;3;291
75;Nouvelle-Aquitaine;17;4;19;336;Saint-Georges-des-Coteaux;2692;58;2750
75;Nouvelle-Aquitaine;17;2;23;338;Saint-Georges-du-Bois;1774;32;1806
75;Nouvelle-Aquitaine;17;1;07;339;Saint-Germain-de-Lusignan;1303;125;1428
75;Nouvelle-Aquitaine;17;1;07;341;Saint-Germain-de-Vibrac;190;2;192
75;Nouvelle-Aquitaine;17;1;12;342;Saint-Germain-du-Seudre;433;8;441
75;Nouvelle-Aquitaine;17;1;12;343;Saint-Grégoire-d'Ardennes;151;3;154
75;Nouvelle-Aquitaine;17;5;02;344;Saint-Hilaire-de-Villefranche;1321;15;1336
75;Nouvelle-Aquitaine;17;1;07;345;Saint-Hilaire-du-Bois;332;6;338
75;Nouvelle-Aquitaine;17;2;25;346;Saint-Hippolyte;1416;15;1431
75;Nouvelle-Aquitaine;17;5;18;347;Saint-Jean-d'Angély;6976;441;7417
75;Nouvelle-Aquitaine;17;2;10;348;Saint-Jean-d'Angle;693;7;700
75;Nouvelle-Aquitaine;17;3;09;349;Saint-Jean-de-Liversay;2891;41;2932
75;Nouvelle-Aquitaine;17;5;11;350;Saint-Julien-de-l'Escap;891;20;911
75;Nouvelle-Aquitaine;17;2;10;351;Saint-Just-Luzac;1993;36;2029
75;Nouvelle-Aquitaine;17;2;03;353;Saint-Laurent-de-la-Prée;2114;39;2153
75;Nouvelle-Aquitaine;17;1;12;354;Saint-Léger;632;12;644
75;Nouvelle-Aquitaine;17;5;18;356;Saint-Loup;303;4;307
75;Nouvelle-Aquitaine;17;1;07;357;Saint-Maigrin;531;10;541
75;Nouvelle-Aquitaine;17;5;11;358;Saint-Mandé-sur-Brédoire;309;6;315
75;Nouvelle-Aquitaine;17;2;23;359;Saint-Mard;1198;18;1216
75;Nouvelle-Aquitaine;17;5;11;361;Saint-Martial;116;2;118
75;Nouvelle-Aquitaine;17;1;12;362;Saint-Martial-de-Mirambeau;270;6;276
75;Nouvelle-Aquitaine;17;1;07;363;Saint-Martial-de-Vitaterne;548;14;562
75;Nouvelle-Aquitaine;17;1;07;364;Saint-Martial-sur-Né;452;10;462
75;Nouvelle-Aquitaine;17;1;27;365;Saint-Martin-d'Ary;473;12;485
75;Nouvelle-Aquitaine;17;1;27;366;Saint-Martin-de-Coux;461;4;465
75;Nouvelle-Aquitaine;17;5;11;367;Saint-Martin-de-Juillers;158;3;161
75;Nouvelle-Aquitaine;17;3;05;369;Saint-Martin-de-Ré;2231;20;2251
75;Nouvelle-Aquitaine;17;1;07;372;Saint-Médard;75;1;76
75;Nouvelle-Aquitaine;17;3;06;373;Saint-Médard-d'Aunis;2255;43;2298
75;Nouvelle-Aquitaine;17;2;25;375;Saint-Nazaire-sur-Charente;1186;25;1211
75;Nouvelle-Aquitaine;17;3;09;376;Saint-Ouen-d'Aunis;1730;28;1758
75;Nouvelle-Aquitaine;17;5;11;377;Saint-Ouen-la-Thène;114;6;120
75;Nouvelle-Aquitaine;17;1;27;378;Saint-Palais-de-Négrignac;438;6;444
75;Nouvelle-Aquitaine;17;1;12;379;Saint-Palais-de-Phiolin;208;3;211
75;Nouvelle-Aquitaine;17;2;26;380;Saint-Palais-sur-Mer;3897;91;3988
75;Nouvelle-Aquitaine;17;5;11;381;Saint-Pardoult;241;4;245
75;Nouvelle-Aquitaine;17;2;23;382;Saint-Pierre-d'Amilly;529;5;534
75;Nouvelle-Aquitaine;17;2;04;385;Saint-Pierre-d'Oléron;6743;137;6880
75;Nouvelle-Aquitaine;17;5;11;383;Saint-Pierre-de-Juillers;363;3;366
75;Nouvelle-Aquitaine;17;5;11;384;Saint-Pierre-de-l'Isle;264;4;268
75;Nouvelle-Aquitaine;17;1;27;386;Saint-Pierre-du-Palais;366;8;374
75;Nouvelle-Aquitaine;17;2;23;340;Saint-Pierre-La-Noue;1575;60;1635
75;Nouvelle-Aquitaine;17;4;19;387;Saint-Porchaire;1862;32;1894
75;Nouvelle-Aquitaine;17;1;12;388;Saint-Quantin-de-Rançanne;268;7;275
75;Nouvelle-Aquitaine;17;3;06;391;Saint-Rogatien;2206;50;2256
75;Nouvelle-Aquitaine;17;4;22;393;Saint-Romain-de-Benet;1712;27;1739
75;Nouvelle-Aquitaine;17;2;23;394;Saint-Saturnin-du-Bois;891;18;909
75;Nouvelle-Aquitaine;17;4;02;395;Saint-Sauvant;485;9;494
75;Nouvelle-Aquitaine;17;3;09;396;Saint-Sauveur-d'Aunis;1704;28;1732
75;Nouvelle-Aquitaine;17;5;18;397;Saint-Savinien;2433;106;2539
75;Nouvelle-Aquitaine;17;1;12;398;Saint-Seurin-de-Palenne;165;7;172
75;Nouvelle-Aquitaine;17;4;24;400;Saint-Sever-de-Saintonge;614;15;629
75;Nouvelle-Aquitaine;17;5;11;401;Saint-Séverin-sur-Boutonne;99;7;106
75;Nouvelle-Aquitaine;17;1;07;402;Saint-Sigismond-de-Clermont;159;3;162
75;Nouvelle-Aquitaine;17;1;07;403;Saint-Simon-de-Bordes;734;13;747
75;Nouvelle-Aquitaine;17;4;21;404;Saint-Simon-de-Pellouaille;654;7;661
75;Nouvelle-Aquitaine;17;1;12;405;Saint-Sorlin-de-Conac;198;2;200
75;Nouvelle-Aquitaine;17;2;10;406;Saint-Sornin;389;3;392
75;Nouvelle-Aquitaine;17;4;19;408;Saint-Sulpice-d'Arnoult;865;10;875
75;Nouvelle-Aquitaine;17;2;22;409;Saint-Sulpice-de-Royan;3204;60;3264
75;Nouvelle-Aquitaine;17;1;12;410;Saint-Thomas-de-Conac;559;9;568
75;Nouvelle-Aquitaine;17;2;04;411;Saint-Trojan-les-Bains;1262;23;1285
75;Nouvelle-Aquitaine;17;4;02;412;Saint-Vaize;651;8;659
75;Nouvelle-Aquitaine;17;3;03;413;Saint-Vivien;1307;19;1326
75;Nouvelle-Aquitaine;17;3;08;414;Saint-Xandre;4848;158;5006
75;Nouvelle-Aquitaine;17;1;27;319;Sainte-Colombe;109;1;110
75;Nouvelle-Aquitaine;17;4;19;330;Sainte-Gemme;1320;15;1335
75;Nouvelle-Aquitaine;17;1;07;355;Sainte-Lheurine;512;10;522
75;Nouvelle-Aquitaine;17;3;05;360;Sainte-Marie-de-Ré;3366;107;3473
75;Nouvelle-Aquitaine;17;5;02;374;Sainte-Même;244;2;246
75;Nouvelle-Aquitaine;17;4;19;389;Sainte-Radegonde;580;11;591
75;Nouvelle-Aquitaine;17;1;12;390;Sainte-Ramée;121;4;125
75;Nouvelle-Aquitaine;17;3;06;407;Sainte-Soulle;4533;90;4623
75;Nouvelle-Aquitaine;17;4;20;415;Saintes;25470;1343;26813
75;Nouvelle-Aquitaine;17;5;11;416;Saleignes;62;0;62
75;Nouvelle-Aquitaine;17;1;12;417;Salignac-de-Mirambeau;164;1;165
75;Nouvelle-Aquitaine;17;1;24;418;Salignac-sur-Charente;599;16;615
75;Nouvelle-Aquitaine;17;3;03;420;Salles-sur-Mer;2153;58;2211
75;Nouvelle-Aquitaine;17;4;22;421;Saujon;7165;114;7279
75;Nouvelle-Aquitaine;17;5;11;422;Seigné;77;0;77
75;Nouvelle-Aquitaine;17;1;12;423;Semillac;72;1;73
75;Nouvelle-Aquitaine;17;1;12;424;Semoussac;364;3;367
75;Nouvelle-Aquitaine;17;4;22;425;Semussac;2333;46;2379
75;Nouvelle-Aquitaine;17;4;02;426;Le Seure;255;4;259
75;Nouvelle-Aquitaine;17;5;11;427;Siecq;215;5;220
75;Nouvelle-Aquitaine;17;5;11;428;Sonnac;505;10;515
75;Nouvelle-Aquitaine;17;2;25;429;Soubise;2998;29;3027
75;Nouvelle-Aquitaine;17;1;12;430;Soubran;380;6;386
75;Nouvelle-Aquitaine;17;4;19;431;Soulignonne;701;6;707
75;Nouvelle-Aquitaine;17;1;27;432;Souméras;363;6;369
75;Nouvelle-Aquitaine;17;1;27;433;Sousmoulins;219;7;226
75;Nouvelle-Aquitaine;17;2;23;434;Surgères;6807;186;6993
75;Nouvelle-Aquitaine;17;5;18;435;Taillant;182;1;183
75;Nouvelle-Aquitaine;17;5;18;436;Taillebourg;731;22;753
75;Nouvelle-Aquitaine;17;4;21;437;Talmont-sur-Gironde;100;1;101
75;Nouvelle-Aquitaine;17;4;21;438;Tanzac;312;3;315
75;Nouvelle-Aquitaine;17;3;09;439;Taugon;791;13;804
75;Nouvelle-Aquitaine;17;5;18;440;Ternant;379;8;387
75;Nouvelle-Aquitaine;17;4;24;441;Tesson;1075;23;1098
75;Nouvelle-Aquitaine;17;4;21;442;Thaims;384;3;387
75;Nouvelle-Aquitaine;17;3;06;443;Thairé;1691;42;1733
75;Nouvelle-Aquitaine;17;4;24;444;Thénac;1677;276;1953
75;Nouvelle-Aquitaine;17;4;24;445;Thézac;321;5;326
75;Nouvelle-Aquitaine;17;5;11;446;Thors;460;6;466
75;Nouvelle-Aquitaine;17;2;23;447;Le Thou;1900;31;1931
75;Nouvelle-Aquitaine;17;5;18;448;Tonnay-Boutonne;1151;11;1162
75;Nouvelle-Aquitaine;17;2;25;449;Tonnay-Charente;8010;134;8144
75;Nouvelle-Aquitaine;17;5;18;450;Torxé;202;8;210
75;Nouvelle-Aquitaine;17;5;11;451;Les Touches-de-Périgny;568;10;578
75;Nouvelle-Aquitaine;17;2;26;452;La Tremblade;4336;63;4399
75;Nouvelle-Aquitaine;17;4;19;453;Trizay;1476;33;1509
75;Nouvelle-Aquitaine;17;1;27;454;Tugéras-Saint-Maurice;376;6;382
75;Nouvelle-Aquitaine;17;4;19;455;La Vallée;677;11;688
75;Nouvelle-Aquitaine;17;1;27;458;Vanzac;148;1;149
75;Nouvelle-Aquitaine;17;5;11;459;Varaize;560;10;570
75;Nouvelle-Aquitaine;17;4;24;460;Varzay;816;14;830
75;Nouvelle-Aquitaine;17;2;17;461;Vaux-sur-Mer;3798;75;3873
75;Nouvelle-Aquitaine;17;4;02;462;Vénérand;761;16;777
75;Nouvelle-Aquitaine;17;2;25;463;Vergeroux;1208;22;1230
75;Nouvelle-Aquitaine;17;5;18;465;La Vergne;585;8;593
75;Nouvelle-Aquitaine;17;5;18;464;Vergné;138;3;141
75;Nouvelle-Aquitaine;17;3;06;466;Vérines;2245;31;2276
75;Nouvelle-Aquitaine;17;5;11;467;Vervant;238;2;240
75;Nouvelle-Aquitaine;17;1;07;468;Vibrac;152;3;155
75;Nouvelle-Aquitaine;17;4;21;469;Villars-en-Pons;566;12;578
75;Nouvelle-Aquitaine;17;4;02;470;Villars-les-Bois;246;9;255
75;Nouvelle-Aquitaine;17;5;11;471;La Villedieu;209;2;211
75;Nouvelle-Aquitaine;17;3;09;472;Villedoux;2237;17;2254
75;Nouvelle-Aquitaine;17;5;11;473;Villemorin;97;0;97
75;Nouvelle-Aquitaine;17;5;18;474;Villeneuve-la-Comtesse;741;15;756
75;Nouvelle-Aquitaine;17;1;07;476;Villexavier;272;3;275
75;Nouvelle-Aquitaine;17;5;11;477;Villiers-Couture;116;1;117
75;Nouvelle-Aquitaine;17;5;11;478;Vinax;61;1;62
75;Nouvelle-Aquitaine;17;4;21;479;Virollet;275;4;279
75;Nouvelle-Aquitaine;17;2;23;480;Virson;760;10;770
75;Nouvelle-Aquitaine;17;5;18;481;Voissay;156;3;159
75;Nouvelle-Aquitaine;17;2;23;482;Vouhé;656;11;667
75;Nouvelle-Aquitaine;17;3;03;483;Yves;1477;24;1501
24;Centre-Val de Loire;18;1;15;001;Achères;380;7;387
24;Centre-Val de Loire;18;2;08;002;Ainay-le-Vieil;186;4;190
24;Centre-Val de Loire;18;1;14;003;Les Aix-d'Angillon;1916;28;1944
24;Centre-Val de Loire;18;1;15;004;Allogny;1017;22;1039
24;Centre-Val de Loire;18;3;11;005;Allouis;1071;21;1092
24;Centre-Val de Loire;18;1;17;006;Annoix;233;2;235
24;Centre-Val de Loire;18;2;10;007;Apremont-sur-Allier;71;3;74
24;Centre-Val de Loire;18;2;08;009;Arcomps;306;12;318
24;Centre-Val de Loire;18;2;08;010;Ardenais;200;8;208
24;Centre-Val de Loire;18;3;01;011;Argent-sur-Sauldre;2102;40;2142
24;Centre-Val de Loire;18;1;02;012;Argenvières;461;6;467
24;Centre-Val de Loire;18;2;09;013;Arpheuilles;297;5;302
24;Centre-Val de Loire;18;1;17;008;Arçay;510;10;520
24;Centre-Val de Loire;18;1;16;014;Assigny;152;7;159
24;Centre-Val de Loire;18;3;01;015;Aubigny-sur-Nère;5488;130;5618
24;Centre-Val de Loire;18;1;14;016;Aubinges;394;3;397
24;Centre-Val de Loire;18;2;09;017;Augy-sur-Aubois;290;2;292
24;Centre-Val de Loire;18;1;02;018;Avord;2613;32;2645
24;Centre-Val de Loire;18;1;14;019;Azy;445;7;452
24;Centre-Val de Loire;18;1;16;020;Bannay;907;14;921
24;Centre-Val de Loire;18;2;09;021;Bannegon;274;4;278
24;Centre-Val de Loire;18;1;16;022;Barlieu;359;8;367
24;Centre-Val de Loire;18;1;02;023;Baugy;1721;29;1750
24;Centre-Val de Loire;18;2;08;024;Beddes;93;3;96
24;Centre-Val de Loire;18;1;02;025;Beffes;641;12;653
24;Centre-Val de Loire;18;1;16;026;Belleville-sur-Loire;1058;28;1086
24;Centre-Val de Loire;18;1;02;027;Bengy-sur-Craon;663;65;728
24;Centre-Val de Loire;18;3;11;028;Berry-Bouy;1189;37;1226
24;Centre-Val de Loire;18;2;09;029;Bessais-le-Fromental;312;4;316
24;Centre-Val de Loire;18;3;01;030;Blancafort;1038;33;1071
24;Centre-Val de Loire;18;2;10;031;Blet;575;6;581
24;Centre-Val de Loire;18;1;16;032;Boulleret;1436;33;1469
24;Centre-Val de Loire;18;1;98;033;Bourges;64551;2038;66589
24;Centre-Val de Loire;18;2;12;034;Bouzais;313;8;321
24;Centre-Val de Loire;18;1;14;035;Brécy;1013;24;1037
24;Centre-Val de Loire;18;3;11;036;Brinay;522;7;529
24;Centre-Val de Loire;18;3;01;037;Brinon-sur-Sauldre;982;14;996
24;Centre-Val de Loire;18;2;12;038;Bruère-Allichamps;564;10;574
24;Centre-Val de Loire;18;1;16;039;Bué;313;8;321
24;Centre-Val de Loire;18;2;09;040;Bussy;380;6;386
24;Centre-Val de Loire;18;2;08;041;La Celette;181;2;183
24;Centre-Val de Loire;18;2;12;042;La Celle;348;2;350
24;Centre-Val de Loire;18;2;08;043;La Celle-Condé;202;0;202
24;Centre-Val de Loire;18;3;11;044;Cerbois;435;9;444
24;Centre-Val de Loire;18;2;09;045;Chalivoy-Milon;431;8;439
24;Centre-Val de Loire;18;2;17;046;Chambon;173;3;176
24;Centre-Val de Loire;18;3;01;047;La Chapelle-d'Angillon;629;9;638
24;Centre-Val de Loire;18;2;10;048;La Chapelle-Hugon;387;5;392
24;Centre-Val de Loire;18;1;02;049;La Chapelle-Montlinard;471;9;480
24;Centre-Val de Loire;18;1;13;050;La Chapelle-Saint-Ursin;3542;79;3621
24;Centre-Val de Loire;18;1;14;051;La Chapelotte;151;2;153
24;Centre-Val de Loire;18;2;09;052;Charenton-du-Cher;1045;21;1066
24;Centre-Val de Loire;18;1;02;053;Charentonnay;289;8;297
24;Centre-Val de Loire;18;2;10;054;Charly;249;3;252
24;Centre-Val de Loire;18;1;07;055;Chârost;980;13;993
24;Centre-Val de Loire;18;1;02;056;Chassy;241;5;246
24;Centre-Val de Loire;18;2;08;057;Châteaumeillant;1780;20;1800
24;Centre-Val de Loire;18;2;17;058;Châteauneuf-sur-Cher;1454;19;1473
24;Centre-Val de Loire;18;2;08;059;Le Châtelet;994;13;1007
24;Centre-Val de Loire;18;2;09;060;Chaumont;54;0;54
24;Centre-Val de Loire;18;1;02;061;Chaumoux-Marcilly;95;1;96
24;Centre-Val de Loire;18;2;10;062;Le Chautay;293;2;295
24;Centre-Val de Loire;18;2;17;063;Chavannes;173;5;178
24;Centre-Val de Loire;18;3;11;064;Chéry;214;9;223
24;Centre-Val de Loire;18;2;08;065;Chezal-Benoît;829;13;842
24;Centre-Val de Loire;18;1;07;066;Civray;920;14;934
24;Centre-Val de Loire;18;3;01;067;Clémont;719;8;727
24;Centre-Val de Loire;18;2;09;068;Cogny;35;2;37
24;Centre-Val de Loire;18;2;12;069;Colombiers;408;16;424
24;Centre-Val de Loire;18;1;16;070;Concressault;204;2;206
24;Centre-Val de Loire;18;2;09;071;Contres;32;0;32
24;Centre-Val de Loire;18;2;10;072;Cornusse;268;4;272
24;Centre-Val de Loire;18;2;17;073;Corquoy;209;8;217
24;Centre-Val de Loire;18;1;16;074;Couargues;205;5;210
24;Centre-Val de Loire;18;2;10;075;Cours-les-Barres;1034;25;1059
24;Centre-Val de Loire;18;2;09;076;Coust;445;8;453
24;Centre-Val de Loire;18;1;02;077;Couy;355;10;365
24;Centre-Val de Loire;18;1;16;079;Crézancy-en-Sancerre;486;8;494
24;Centre-Val de Loire;18;2;17;078;Crézançay-sur-Cher;56;1;57
24;Centre-Val de Loire;18;2;10;080;Croisy;163;1;164
24;Centre-Val de Loire;18;1;02;081;Crosses;391;3;394
24;Centre-Val de Loire;18;2;10;082;Cuffy;1075;31;1106
24;Centre-Val de Loire;18;2;08;083;Culan;715;6;721
24;Centre-Val de Loire;18;1;16;084;Dampierre-en-Crot;204;4;208
24;Centre-Val de Loire;18;3;19;085;Dampierre-en-Graçay;248;6;254
24;Centre-Val de Loire;18;2;12;086;Drevant;543;16;559
24;Centre-Val de Loire;18;2;09;087;Dun-sur-Auron;3844;77;3921
24;Centre-Val de Loire;18;3;01;088;Ennordres;210;7;217
24;Centre-Val de Loire;18;2;08;089;Épineuil-le-Fleuriel;443;9;452
24;Centre-Val de Loire;18;1;02;090;Étréchy;456;8;464
24;Centre-Val de Loire;18;2;12;091;Farges-Allichamps;241;2;243
24;Centre-Val de Loire;18;1;02;092;Farges-en-Septaine;1009;23;1032
24;Centre-Val de Loire;18;2;08;093;Faverdines;142;3;145
24;Centre-Val de Loire;18;1;16;094;Feux;343;8;351
24;Centre-Val de Loire;18;2;10;095;Flavigny;205;2;207
24;Centre-Val de Loire;18;3;11;096;Foëcy;2085;23;2108
24;Centre-Val de Loire;18;1;15;097;Fussy;1982;32;2014
24;Centre-Val de Loire;18;1;16;098;Gardefort;142;5;147
24;Centre-Val de Loire;18;1;02;099;Garigny;236;3;239
24;Centre-Val de Loire;18;3;19;100;Genouilly;680;16;696
24;Centre-Val de Loire;18;2;10;101;Germigny-l'Exempt;307;4;311
24;Centre-Val de Loire;18;2;09;102;Givardon;298;4;302
24;Centre-Val de Loire;18;3;19;103;Graçay;1447;13;1460
24;Centre-Val de Loire;18;1;02;104;Groises;131;2;133
24;Centre-Val de Loire;18;1;02;105;Gron;469;9;478
24;Centre-Val de Loire;18;2;09;106;Grossouvre;274;4;278
24;Centre-Val de Loire;18;2;12;107;La Groutte;127;8;135
24;Centre-Val de Loire;18;2;10;108;La Guerche-sur-l'Aubois;3274;37;3311
24;Centre-Val de Loire;18;1;14;109;Henrichemont;1760;21;1781
24;Centre-Val de Loire;18;1;02;110;Herry;988;25;1013
24;Centre-Val de Loire;18;1;14;111;Humbligny;190;0;190
24;Centre-Val de Loire;18;2;08;112;Ids-Saint-Roch;299;1;300
24;Centre-Val de Loire;18;2;10;113;Ignol;180;3;183
24;Centre-Val de Loire;18;2;08;114;Ineuil;238;4;242
24;Centre-Val de Loire;18;3;01;115;Ivoy-le-Pré;803;8;811
24;Centre-Val de Loire;18;1;16;116;Jalognes;292;3;295
24;Centre-Val de Loire;18;1;16;117;Jars;507;5;512
24;Centre-Val de Loire;18;2;10;118;Jouet-sur-l'Aubois;1348;36;1384
24;Centre-Val de Loire;18;1;02;119;Jussy-Champagne;194;5;199
24;Centre-Val de Loire;18;1;02;120;Jussy-le-Chaudrier;607;14;621
24;Centre-Val de Loire;18;2;09;121;Lantan;91;2;93
24;Centre-Val de Loire;18;1;17;122;Lapan;207;2;209
24;Centre-Val de Loire;18;3;11;124;Lazenay;342;5;347
24;Centre-Val de Loire;18;1;16;125;Léré;1098;22;1120
24;Centre-Val de Loire;18;1;17;126;Levet;1392;34;1426
24;Centre-Val de Loire;18;2;08;127;Lignières;1355;28;1383
24;Centre-Val de Loire;18;3;11;128;Limeux;162;0;162
24;Centre-Val de Loire;18;1;17;129;Lissay-Lochy;224;5;229
24;Centre-Val de Loire;18;2;08;130;Loye-sur-Arnon;305;6;311
24;Centre-Val de Loire;18;2;10;131;Lugny-Bourbonnais;35;0;35
24;Centre-Val de Loire;18;1;02;132;Lugny-Champagne;142;1;143
24;Centre-Val de Loire;18;1;07;133;Lunery;1570;17;1587
24;Centre-Val de Loire;18;3;11;134;Lury-sur-Arnon;668;15;683
24;Centre-Val de Loire;18;2;08;135;Maisonnais;239;5;244
24;Centre-Val de Loire;18;1;07;137;Mareuil-sur-Arnon;532;10;542
24;Centre-Val de Loire;18;1;13;138;Marmagne;1960;58;2018
24;Centre-Val de Loire;18;1;02;139;Marseilles-lès-Aubigny;657;9;666
24;Centre-Val de Loire;18;2;12;136;Marçais;282;5;287
24;Centre-Val de Loire;18;3;11;140;Massay;1390;27;1417
24;Centre-Val de Loire;18;3;11;141;Mehun-sur-Yèvre;6562;125;6687
24;Centre-Val de Loire;18;2;12;142;Meillant;686;17;703
24;Centre-Val de Loire;18;2;10;143;Menetou-Couture;365;8;373
24;Centre-Val de Loire;18;1;16;144;Menetou-Râtel;484;10;494
24;Centre-Val de Loire;18;1;15;145;Menetou-Salon;1617;32;1649
24;Centre-Val de Loire;18;1;16;146;Ménétréol-sous-Sancerre;315;13;328
24;Centre-Val de Loire;18;3;01;147;Ménétréol-sur-Sauldre;212;4;216
24;Centre-Val de Loire;18;3;11;148;Méreau;2610;63;2673
24;Centre-Val de Loire;18;3;01;149;Méry-ès-Bois;577;14;591
24;Centre-Val de Loire;18;3;19;150;Méry-sur-Cher;678;16;694
24;Centre-Val de Loire;18;1;14;151;Montigny;387;7;394
24;Centre-Val de Loire;18;2;08;152;Montlouis;109;0;109
24;Centre-Val de Loire;18;2;08;153;Morlac;329;3;332
24;Centre-Val de Loire;18;2;10;154;Mornay-Berry;183;4;187
24;Centre-Val de Loire;18;2;09;155;Mornay-sur-Allier;431;9;440
24;Centre-Val de Loire;18;1;14;156;Morogues;438;9;447
24;Centre-Val de Loire;18;1;07;157;Morthomiers;761;24;785
24;Centre-Val de Loire;18;1;02;158;Moulins-sur-Yèvre;852;17;869
24;Centre-Val de Loire;18;3;01;159;Nançay;832;30;862
24;Centre-Val de Loire;18;2;10;160;Nérondes;1481;35;1516
24;Centre-Val de Loire;18;2;09;161;Neuilly-en-Dun;224;2;226
24;Centre-Val de Loire;18;1;14;162;Neuilly-en-Sancerre;253;1;254
24;Centre-Val de Loire;18;1;14;163;Neuvy-Deux-Clochers;280;5;285
24;Centre-Val de Loire;18;2;09;164;Neuvy-le-Barrois;139;2;141
24;Centre-Val de Loire;18;3;01;165;Neuvy-sur-Barangeon;1156;33;1189
24;Centre-Val de Loire;18;1;02;166;Nohant-en-Goût;600;9;609
24;Centre-Val de Loire;18;3;19;167;Nohant-en-Graçay;306;2;308
24;Centre-Val de Loire;18;1;16;168;Le Noyer;219;3;222
24;Centre-Val de Loire;18;2;12;169;Nozières;215;7;222
24;Centre-Val de Loire;18;3;01;170;Oizon;675;15;690
24;Centre-Val de Loire;18;2;12;171;Orcenais;253;4;257
24;Centre-Val de Loire;18;2;12;172;Orval;1814;44;1858
24;Centre-Val de Loire;18;2;09;173;Osmery;263;2;265
24;Centre-Val de Loire;18;1;02;174;Osmoy;269;3;272
24;Centre-Val de Loire;18;2;10;175;Ourouer-les-Bourdelins;615;3;618
24;Centre-Val de Loire;18;1;14;176;Parassy;414;5;419
24;Centre-Val de Loire;18;2;09;177;Parnay;64;0;64
24;Centre-Val de Loire;18;2;08;178;La Perche;205;3;208
24;Centre-Val de Loire;18;1;15;179;Pigny;962;19;981
24;Centre-Val de Loire;18;1;17;180;Plaimpied-Givaudins;1999;65;2064
24;Centre-Val de Loire;18;1;07;181;Plou;529;8;537
24;Centre-Val de Loire;18;1;07;182;Poisieux;223;4;227
24;Centre-Val de Loire;18;2;09;183;Le Pondy;144;3;147
24;Centre-Val de Loire;18;1;02;184;Précy;345;1;346
24;Centre-Val de Loire;18;3;01;185;Presly;248;11;259
24;Centre-Val de Loire;18;3;11;186;Preuilly;441;8;449
24;Centre-Val de Loire;18;2;08;187;Préveranges;525;10;535
24;Centre-Val de Loire;18;1;07;188;Primelles;247;6;253
24;Centre-Val de Loire;18;1;15;189;Quantilly;470;4;474
24;Centre-Val de Loire;18;3;11;190;Quincy;868;19;887
24;Centre-Val de Loire;18;2;09;191;Raymond;199;2;201
24;Centre-Val de Loire;18;2;08;192;Reigny;256;3;259
24;Centre-Val de Loire;18;2;08;193;Rezay;213;5;218
24;Centre-Val de Loire;18;1;14;194;Rians;973;19;992
24;Centre-Val de Loire;18;2;09;195;Sagonne;190;6;196
24;Centre-Val de Loire;18;2;09;196;Saint-Aignan-des-Noyers;94;0;94
24;Centre-Val de Loire;18;2;12;197;Saint-Amand-Montrond;9437;277;9714
24;Centre-Val de Loire;18;1;07;198;Saint-Ambroix;364;9;373
24;Centre-Val de Loire;18;2;08;199;Saint-Baudel;250;4;254
24;Centre-Val de Loire;18;1;16;200;Saint-Bouize;312;14;326
24;Centre-Val de Loire;18;1;17;201;Saint-Caprais;767;15;782
24;Centre-Val de Loire;18;1;14;202;Saint-Céols;14;0;14
24;Centre-Val de Loire;18;2;08;203;Saint-Christophe-le-Chaudry;104;1;105
24;Centre-Val de Loire;18;2;09;204;Saint-Denis-de-Palin;302;8;310
24;Centre-Val de Loire;18;1;13;205;Saint-Doulchard;9505;247;9752
24;Centre-Val de Loire;18;1;15;206;Saint-Éloy-de-Gy;1541;52;1593
24;Centre-Val de Loire;18;1;07;207;Saint-Florent-sur-Cher;6537;102;6639
24;Centre-Val de Loire;18;2;08;209;Saint-Georges-de-Poisieux;456;9;465
24;Centre-Val de Loire;18;3;19;210;Saint-Georges-sur-la-Prée;611;11;622
24;Centre-Val de Loire;18;1;15;211;Saint-Georges-sur-Moulon;696;12;708
24;Centre-Val de Loire;18;2;09;212;Saint-Germain-des-Bois;628;15;643
24;Centre-Val de Loire;18;1;14;213;Saint-Germain-du-Puy;5085;114;5199
24;Centre-Val de Loire;18;3;19;214;Saint-Hilaire-de-Court;595;13;608
24;Centre-Val de Loire;18;2;10;215;Saint-Hilaire-de-Gondilly;179;5;184
24;Centre-Val de Loire;18;2;08;216;Saint-Hilaire-en-Lignières;491;14;505
24;Centre-Val de Loire;18;2;08;217;Saint-Jeanvrin;152;4;156
24;Centre-Val de Loire;18;1;17;218;Saint-Just;643;4;647
24;Centre-Val de Loire;18;3;15;219;Saint-Laurent;502;10;512
24;Centre-Val de Loire;18;1;02;220;Saint-Léger-le-Petit;355;5;360
24;Centre-Val de Loire;18;2;17;221;Saint-Loup-des-Chaumes;299;2;301
24;Centre-Val de Loire;18;1;15;223;Saint-Martin-d'Auxigny;2397;38;2435
24;Centre-Val de Loire;18;1;02;224;Saint-Martin-des-Champs;304;9;313
24;Centre-Val de Loire;18;2;08;225;Saint-Maur;295;4;299
24;Centre-Val de Loire;18;1;14;226;Saint-Michel-de-Volangis;468;16;484
24;Centre-Val de Loire;18;3;19;228;Saint-Outrille;220;3;223
24;Centre-Val de Loire;18;1;15;229;Saint-Palais;619;19;638
24;Centre-Val de Loire;18;2;08;230;Saint-Pierre-les-Bois;287;11;298
24;Centre-Val de Loire;18;2;09;231;Saint-Pierre-les-Étieux;711;17;728
24;Centre-Val de Loire;18;2;08;232;Saint-Priest-la-Marche;229;3;232
24;Centre-Val de Loire;18;1;16;233;Saint-Satur;1426;50;1476
24;Centre-Val de Loire;18;2;08;234;Saint-Saturnin;422;8;430
24;Centre-Val de Loire;18;2;17;236;Saint-Symphorien;134;1;135
24;Centre-Val de Loire;18;2;08;238;Saint-Vitte;131;3;134
24;Centre-Val de Loire;18;1;16;208;Sainte-Gemme-en-Sancerrois;427;7;434
24;Centre-Val de Loire;18;3;01;227;Sainte-Montaine;181;4;185
24;Centre-Val de Loire;18;1;14;235;Sainte-Solange;1135;19;1154
24;Centre-Val de Loire;18;3;11;237;Sainte-Thorette;480;3;483
24;Centre-Val de Loire;18;1;02;240;Sancergues;649;10;659
24;Centre-Val de Loire;18;1;16;241;Sancerre;1393;39;1432
24;Centre-Val de Loire;18;2;09;242;Sancoins;3080;44;3124
24;Centre-Val de Loire;18;1;16;243;Santranges;410;8;418
24;Centre-Val de Loire;18;1;07;244;Saugy;79;0;79
24;Centre-Val de Loire;18;2;08;245;Saulzais-le-Potier;497;9;506
24;Centre-Val de Loire;18;1;16;246;Savigny-en-Sancerre;1030;21;1051
24;Centre-Val de Loire;18;1;02;247;Savigny-en-Septaine;712;14;726
24;Centre-Val de Loire;18;1;17;248;Senneçay;472;6;478
24;Centre-Val de Loire;18;1;16;249;Sens-Beaujeu;399;14;413
24;Centre-Val de Loire;18;2;17;250;Serruelles;74;2;76
24;Centre-Val de Loire;18;1;02;251;Sévry;62;2;64
24;Centre-Val de Loire;18;2;08;252;Sidiailles;303;5;308
24;Centre-Val de Loire;18;1;14;253;Soulangis;497;8;505
24;Centre-Val de Loire;18;1;17;254;Soye-en-Septaine;583;15;598
24;Centre-Val de Loire;18;1;07;255;Le Subdray;932;205;1137
24;Centre-Val de Loire;18;1;16;256;Subligny;341;7;348
24;Centre-Val de Loire;18;1;16;258;Sury-en-Vaux;703;17;720
24;Centre-Val de Loire;18;1;16;259;Sury-ès-Bois;270;2;272
24;Centre-Val de Loire;18;1;16;257;Sury-près-Léré;711;14;725
24;Centre-Val de Loire;18;2;10;260;Tendron;93;2;95
24;Centre-Val de Loire;18;2;09;261;Thaumiers;417;7;424
24;Centre-Val de Loire;18;1;16;262;Thauvenay;332;8;340
24;Centre-Val de Loire;18;3;19;263;Thénioux;664;9;673
24;Centre-Val de Loire;18;1;16;264;Thou;76;2;78
24;Centre-Val de Loire;18;2;10;265;Torteron;795;16;811
24;Centre-Val de Loire;18;2;08;266;Touchay;262;10;272
24;Centre-Val de Loire;18;1;17;267;Trouy;3959;116;4075
24;Centre-Val de Loire;18;2;17;268;Uzay-le-Venon;401;9;410
24;Centre-Val de Loire;18;1;16;269;Vailly-sur-Sauldre;654;21;675
24;Centre-Val de Loire;18;2;17;270;Vallenay;741;12;753
24;Centre-Val de Loire;18;1;15;271;Vasselay;1447;27;1474
24;Centre-Val de Loire;18;1;16;272;Veaugues;633;22;655
24;Centre-Val de Loire;18;2;17;273;Venesmes;821;16;837
24;Centre-Val de Loire;18;1;16;274;Verdigny;309;3;312
24;Centre-Val de Loire;18;2;09;275;Vereaux;140;7;147
24;Centre-Val de Loire;18;2;09;276;Vernais;193;1;194
24;Centre-Val de Loire;18;2;09;277;Verneuil;34;0;34
24;Centre-Val de Loire;18;2;08;278;Vesdun;564;10;574
24;Centre-Val de Loire;18;3;99;279;Vierzon;25903;538;26441
24;Centre-Val de Loire;18;1;15;280;Vignoux-sous-les-Aix;719;22;741
24;Centre-Val de Loire;18;3;15;281;Vignoux-sur-Barangeon;2119;37;2156
24;Centre-Val de Loire;18;1;02;282;Villabon;577;10;587
24;Centre-Val de Loire;18;2;08;283;Villecelin;94;0;94
24;Centre-Val de Loire;18;1;16;284;Villegenon;218;7;225
24;Centre-Val de Loire;18;1;07;285;Villeneuve-sur-Cher;444;6;450
24;Centre-Val de Loire;18;1;02;286;Villequiers;479;9;488
24;Centre-Val de Loire;18;1;16;287;Vinon;297;9;306
24;Centre-Val de Loire;18;1;17;288;Vorly;232;7;239
24;Centre-Val de Loire;18;1;02;289;Vornay;593;14;607
24;Centre-Val de Loire;18;3;15;290;Vouzeron;566;10;576
75;Nouvelle-Aquitaine;19;2;15;001;Affieux;359;13;372
75;Nouvelle-Aquitaine;19;3;17;002;Aix;392;6;398
75;Nouvelle-Aquitaine;19;1;10;003;Albignac;254;2;256
75;Nouvelle-Aquitaine;19;2;02;004;Albussac;731;9;740
75;Nouvelle-Aquitaine;19;1;01;005;Allassac;3903;103;4006
75;Nouvelle-Aquitaine;19;3;12;006;Alleyrat;98;0;98
75;Nouvelle-Aquitaine;19;1;02;007;Altillac;861;31;892
75;Nouvelle-Aquitaine;19;3;12;008;Ambrugeat;205;4;209
75;Nouvelle-Aquitaine;19;2;11;009;Les Angles-sur-Corrèze;112;1;113
75;Nouvelle-Aquitaine;19;2;89;010;Argentat-sur-Dordogne;3016;120;3136
75;Nouvelle-Aquitaine;19;1;18;011;Arnac-Pompadour;1133;14;1147
75;Nouvelle-Aquitaine;19;1;10;012;Astaillac;232;6;238
75;Nouvelle-Aquitaine;19;1;10;013;Aubazines;914;16;930
75;Nouvelle-Aquitaine;19;2;02;014;Auriac;229;6;235
75;Nouvelle-Aquitaine;19;1;19;015;Ayen;714;7;721
75;Nouvelle-Aquitaine;19;2;11;016;Bar;308;8;316
75;Nouvelle-Aquitaine;19;2;02;017;Bassignac-le-Bas;91;1;92
75;Nouvelle-Aquitaine;19;2;02;018;Bassignac-le-Haut;179;5;184
75;Nouvelle-Aquitaine;19;1;10;019;Beaulieu-sur-Dordogne;1299;22;1321
75;Nouvelle-Aquitaine;19;2;15;020;Beaumont;114;7;121
75;Nouvelle-Aquitaine;19;3;12;021;Bellechassagne;89;4;93
75;Nouvelle-Aquitaine;19;1;18;022;Benayes;228;5;233
75;Nouvelle-Aquitaine;19;1;10;023;Beynat;1258;20;1278
75;Nouvelle-Aquitaine;19;1;18;024;Beyssac;615;24;639
75;Nouvelle-Aquitaine;19;1;18;025;Beyssenac;368;4;372
75;Nouvelle-Aquitaine;19;1;10;026;Bilhac;246;4;250
75;Nouvelle-Aquitaine;19;2;12;027;Bonnefond;113;0;113
75;Nouvelle-Aquitaine;19;3;08;028;Bort-les-Orgues;2677;103;2780
75;Nouvelle-Aquitaine;19;1;10;029;Branceilles;279;5;284
75;Nouvelle-Aquitaine;19;1;19;030;Brignac-la-Plaine;980;17;997
75;Nouvelle-Aquitaine;19;1;99;031;Brive-la-Gaillarde;46916;1286;48202
75;Nouvelle-Aquitaine;19;3;12;033;Bugeat;803;10;813
75;Nouvelle-Aquitaine;19;2;02;034;Camps-Saint-Mathurin-Léobazel;237;6;243
75;Nouvelle-Aquitaine;19;1;19;035;Chabrignac;572;20;592
75;Nouvelle-Aquitaine;19;2;15;036;Chamberet;1372;13;1385
75;Nouvelle-Aquitaine;19;2;15;037;Chamboulive;1209;31;1240
75;Nouvelle-Aquitaine;19;2;11;038;Chameyrat;1535;51;1586
75;Nouvelle-Aquitaine;19;3;07;039;Champagnac-la-Noaille;233;5;238
75;Nouvelle-Aquitaine;19;2;14;040;Champagnac-la-Prune;163;6;169
75;Nouvelle-Aquitaine;19;2;14;041;Chanac-les-Mines;485;20;505
75;Nouvelle-Aquitaine;19;2;15;042;Chanteix;610;13;623
75;Nouvelle-Aquitaine;19;1;05;043;La Chapelle-aux-Brocs;427;9;436
75;Nouvelle-Aquitaine;19;1;10;044;La Chapelle-aux-Saints;266;10;276
75;Nouvelle-Aquitaine;19;2;02;045;La Chapelle-Saint-Géraud;198;9;207
75;Nouvelle-Aquitaine;19;3;07;046;Chapelle-Spinasse;115;1;116
75;Nouvelle-Aquitaine;19;1;13;047;Chartrier-Ferrière;369;4;373
75;Nouvelle-Aquitaine;19;2;14;048;Le Chastang;365;11;376
75;Nouvelle-Aquitaine;19;1;13;049;Chasteaux;762;21;783
75;Nouvelle-Aquitaine;19;1;10;050;Chauffour-sur-Vell;419;9;428
75;Nouvelle-Aquitaine;19;3;07;051;Chaumeil;158;4;162
75;Nouvelle-Aquitaine;19;3;12;052;Chavanac;51;1;52
75;Nouvelle-Aquitaine;19;3;12;053;Chaveroche;233;4;237
75;Nouvelle-Aquitaine;19;1;10;054;Chenailler-Mascheix;208;6;214
75;Nouvelle-Aquitaine;19;3;08;055;Chirac-Bellevue;294;11;305
75;Nouvelle-Aquitaine;19;2;14;056;Clergoux;412;11;423
75;Nouvelle-Aquitaine;19;1;10;057;Collonges-la-Rouge;486;19;505
75;Nouvelle-Aquitaine;19;3;12;058;Combressol;346;16;362
75;Nouvelle-Aquitaine;19;1;19;059;Concèze;413;9;422
75;Nouvelle-Aquitaine;19;2;18;060;Condat-sur-Ganaveix;672;12;684
75;Nouvelle-Aquitaine;19;3;08;167;Confolent-Port-Dieu;40;0;40
75;Nouvelle-Aquitaine;19;2;14;061;Cornil;1340;12;1352
75;Nouvelle-Aquitaine;19;2;11;062;Corrèze;1128;46;1174
75;Nouvelle-Aquitaine;19;1;05;063;Cosnac;2981;78;3059
75;Nouvelle-Aquitaine;19;3;17;064;Couffy-sur-Sarsonne;76;2;78
75;Nouvelle-Aquitaine;19;3;17;065;Courteix;66;0;66
75;Nouvelle-Aquitaine;19;1;13;066;Cublac;1695;34;1729
75;Nouvelle-Aquitaine;19;1;10;067;Curemonte;209;10;219
75;Nouvelle-Aquitaine;19;1;09;068;Dampniat;727;6;733
75;Nouvelle-Aquitaine;19;2;02;069;Darazac;138;3;141
75;Nouvelle-Aquitaine;19;3;12;070;Darnets;361;8;369
75;Nouvelle-Aquitaine;19;3;12;071;Davignac;208;3;211
75;Nouvelle-Aquitaine;19;1;01;072;Donzenac;2651;64;2715
75;Nouvelle-Aquitaine;19;3;07;073;Égletons;4298;788;5086
75;Nouvelle-Aquitaine;19;2;15;074;L' Église-aux-Bois;55;0;55
75;Nouvelle-Aquitaine;19;2;14;075;Espagnac;377;8;385
75;Nouvelle-Aquitaine;19;2;18;076;Espartignac;441;7;448
75;Nouvelle-Aquitaine;19;1;13;077;Estivals;127;2;129
75;Nouvelle-Aquitaine;19;1;01;078;Estivaux;434;1;435
75;Nouvelle-Aquitaine;19;2;18;079;Eyburie;497;8;505
75;Nouvelle-Aquitaine;19;3;17;080;Eygurande;685;11;696
75;Nouvelle-Aquitaine;19;2;14;081;Eyrein;500;13;513
75;Nouvelle-Aquitaine;19;2;11;082;Favars;1072;23;1095
75;Nouvelle-Aquitaine;19;3;17;083;Feyt;132;2;134
75;Nouvelle-Aquitaine;19;2;02;084;Forgès;286;12;298
75;Nouvelle-Aquitaine;19;2;11;085;Gimel-les-Cascades;794;7;801
75;Nouvelle-Aquitaine;19;2;02;086;Goulles;332;6;338
75;Nouvelle-Aquitaine;19;2;12;087;Gourdon-Murat;108;4;112
75;Nouvelle-Aquitaine;19;2;12;088;Grandsaigne;52;1;53
75;Nouvelle-Aquitaine;19;2;14;089;Gros-Chastang;181;3;184
75;Nouvelle-Aquitaine;19;2;14;090;Gumond;95;6;101
75;Nouvelle-Aquitaine;19;2;02;091;Hautefage;313;13;326
75;Nouvelle-Aquitaine;19;3;07;092;Le Jardin;81;1;82
75;Nouvelle-Aquitaine;19;1;13;093;Jugeals-Nazareth;972;24;996
75;Nouvelle-Aquitaine;19;1;19;094;Juillac;1126;25;1151
75;Nouvelle-Aquitaine;19;2;15;095;Lacelle;137;1;138
75;Nouvelle-Aquitaine;19;2;14;096;Ladignac-sur-Rondelles;406;9;415
75;Nouvelle-Aquitaine;19;3;07;097;Lafage-sur-Sombre;124;1;125
75;Nouvelle-Aquitaine;19;2;14;098;Lagarde-Marc-la-Tour;978;18;996
75;Nouvelle-Aquitaine;19;1;10;099;Lagleygeolle;220;10;230
75;Nouvelle-Aquitaine;19;2;15;100;Lagraulière;1100;19;1119
75;Nouvelle-Aquitaine;19;2;14;101;Laguenne-sur-Avalouze;1548;38;1586
75;Nouvelle-Aquitaine;19;3;08;102;Lamazière-Basse;299;3;302
75;Nouvelle-Aquitaine;19;3;17;103;Lamazière-Haute;67;1;68
75;Nouvelle-Aquitaine;19;2;18;104;Lamongerie;117;2;119
75;Nouvelle-Aquitaine;19;1;10;105;Lanteuil;507;14;521
75;Nouvelle-Aquitaine;19;3;07;106;Lapleau;381;2;383
75;Nouvelle-Aquitaine;19;1;13;107;Larche;1583;44;1627
75;Nouvelle-Aquitaine;19;3;17;108;Laroche-près-Feyt;63;2;65
75;Nouvelle-Aquitaine;19;1;19;109;Lascaux;218;7;225
75;Nouvelle-Aquitaine;19;3;08;110;Latronche;134;0;134
75;Nouvelle-Aquitaine;19;3;07;111;Laval-sur-Luzège;99;0;99
75;Nouvelle-Aquitaine;19;2;12;112;Lestards;106;0;106
75;Nouvelle-Aquitaine;19;3;08;113;Liginiac;606;43;649
75;Nouvelle-Aquitaine;19;3;12;114;Lignareix;164;10;174
75;Nouvelle-Aquitaine;19;1;10;115;Ligneyrac;299;8;307
75;Nouvelle-Aquitaine;19;1;10;116;Liourdres;248;5;253
75;Nouvelle-Aquitaine;19;1;13;117;Lissac-sur-Couze;730;21;751
75;Nouvelle-Aquitaine;19;2;15;118;Le Lonzac;805;13;818
75;Nouvelle-Aquitaine;19;1;10;119;Lostanges;139;1;140
75;Nouvelle-Aquitaine;19;1;19;120;Louignac;236;1;237
75;Nouvelle-Aquitaine;19;1;18;121;Lubersac;2230;41;2271
75;Nouvelle-Aquitaine;19;2;15;122;Madranges;193;11;204
75;Nouvelle-Aquitaine;19;1;09;123;Malemort;7985;166;8151
75;Nouvelle-Aquitaine;19;1;13;124;Mansac;1427;23;1450
75;Nouvelle-Aquitaine;19;3;07;125;Marcillac-la-Croisille;794;16;810
75;Nouvelle-Aquitaine;19;1;10;126;Marcillac-la-Croze;178;1;179
75;Nouvelle-Aquitaine;19;3;08;128;Margerides;305;6;311
75;Nouvelle-Aquitaine;19;2;18;129;Masseret;676;9;685
75;Nouvelle-Aquitaine;19;3;12;130;Maussac;439;9;448
75;Nouvelle-Aquitaine;19;2;18;131;Meilhards;517;23;540
75;Nouvelle-Aquitaine;19;1;10;132;Ménoire;118;1;119
75;Nouvelle-Aquitaine;19;2;02;133;Mercœur;245;1;246
75;Nouvelle-Aquitaine;19;3;17;134;Merlines;718;20;738
75;Nouvelle-Aquitaine;19;3;08;135;Mestes;355;4;359
75;Nouvelle-Aquitaine;19;3;12;136;Meymac;2366;196;2562
75;Nouvelle-Aquitaine;19;3;11;137;Meyrignac-l'Église;62;0;62
75;Nouvelle-Aquitaine;19;1;10;138;Meyssac;1275;53;1328
75;Nouvelle-Aquitaine;19;3;12;139;Millevaches;81;1;82
75;Nouvelle-Aquitaine;19;2;02;140;Monceaux-sur-Dordogne;636;19;655
75;Nouvelle-Aquitaine;19;3;17;141;Monestier-Merlines;299;6;305
75;Nouvelle-Aquitaine;19;3;08;142;Monestier-Port-Dieu;103;2;105
75;Nouvelle-Aquitaine;19;3;07;143;Montaignac-Saint-Hippolyte;581;11;592
75;Nouvelle-Aquitaine;19;1;18;144;Montgibaud;239;5;244
75;Nouvelle-Aquitaine;19;3;07;145;Moustier-Ventadour;451;75;526
75;Nouvelle-Aquitaine;19;2;11;146;Naves;2320;230;2550
75;Nouvelle-Aquitaine;19;1;13;147;Nespouls;635;14;649
75;Nouvelle-Aquitaine;19;3;08;148;Neuvic;1648;254;1902
75;Nouvelle-Aquitaine;19;2;02;149;Neuville;189;5;194
75;Nouvelle-Aquitaine;19;1;10;150;Noailhac;378;6;384
75;Nouvelle-Aquitaine;19;1;13;151;Noailles;910;18;928
75;Nouvelle-Aquitaine;19;1;10;152;Nonards;447;8;455
75;Nouvelle-Aquitaine;19;1;19;153;Objat;3640;95;3735
75;Nouvelle-Aquitaine;19;2;01;154;Orgnac-sur-Vézère;313;5;318
75;Nouvelle-Aquitaine;19;2;11;155;Orliac-de-Bar;283;4;287
75;Nouvelle-Aquitaine;19;1;10;156;Palazinges;153;2;155
75;Nouvelle-Aquitaine;19;3;08;157;Palisse;225;2;227
75;Nouvelle-Aquitaine;19;2;14;158;Pandrignes;166;4;170
75;Nouvelle-Aquitaine;19;3;12;159;Péret-Bel-Air;91;2;93
75;Nouvelle-Aquitaine;19;3;12;160;Pérols-sur-Vézère;185;2;187
75;Nouvelle-Aquitaine;19;1;19;161;Perpezac-le-Blanc;468;6;474
75;Nouvelle-Aquitaine;19;2;01;162;Perpezac-le-Noir;1166;19;1185
75;Nouvelle-Aquitaine;19;1;10;163;Le Pescher;288;7;295
75;Nouvelle-Aquitaine;19;3;12;164;Peyrelevade;850;11;861
75;Nouvelle-Aquitaine;19;2;15;165;Peyrissac;127;3;130
75;Nouvelle-Aquitaine;19;2;15;166;Pierrefitte;91;0;91
75;Nouvelle-Aquitaine;19;2;12;168;Pradines;91;3;94
75;Nouvelle-Aquitaine;19;1;10;169;Puy-d'Arnac;288;4;292
75;Nouvelle-Aquitaine;19;1;10;170;Queyssac-les-Vignes;203;8;211
75;Nouvelle-Aquitaine;19;2;02;171;Reygade;189;4;193
75;Nouvelle-Aquitaine;19;2;15;172;Rilhac-Treignac;110;7;117
75;Nouvelle-Aquitaine;19;2;02;173;Rilhac-Xaintrie;300;6;306
75;Nouvelle-Aquitaine;19;2;14;174;La Roche-Canillac;142;4;146
75;Nouvelle-Aquitaine;19;3;08;175;Roche-le-Peyroux;96;0;96
75;Nouvelle-Aquitaine;19;3;07;176;Rosiers-d'Égletons;1070;39;1109
75;Nouvelle-Aquitaine;19;1;19;177;Rosiers-de-Juillac;181;4;185
75;Nouvelle-Aquitaine;19;1;01;178;Sadroc;937;16;953
75;Nouvelle-Aquitaine;19;1;10;179;Saillac;205;6;211
75;Nouvelle-Aquitaine;19;3;12;180;Saint-Angel;709;14;723
75;Nouvelle-Aquitaine;19;2;11;181;Saint-Augustin;423;7;430
75;Nouvelle-Aquitaine;19;1;19;182;Saint-Aulaire;779;23;802
75;Nouvelle-Aquitaine;19;1;10;184;Saint-Bazile-de-Meyssac;130;4;134
75;Nouvelle-Aquitaine;19;2;02;186;Saint-Bonnet-Elvert;207;5;212
75;Nouvelle-Aquitaine;19;1;01;188;Saint-Bonnet-l'Enfantier;400;5;405
75;Nouvelle-Aquitaine;19;1;19;187;Saint-Bonnet-la-Rivière;387;5;392
75;Nouvelle-Aquitaine;19;2;02;189;Saint-Bonnet-les-Tours-de-Merle;48;1;49
75;Nouvelle-Aquitaine;19;3;08;190;Saint-Bonnet-près-Bort;192;4;196
75;Nouvelle-Aquitaine;19;1;13;191;Saint-Cernin-de-Larche;648;12;660
75;Nouvelle-Aquitaine;19;2;02;192;Saint-Chamant;486;6;492
75;Nouvelle-Aquitaine;19;2;02;193;Saint-Cirgues-la-Loutre;176;5;181
75;Nouvelle-Aquitaine;19;2;15;194;Saint-Clément;1323;35;1358
75;Nouvelle-Aquitaine;19;1;19;195;Saint-Cyprien;384;6;390
75;Nouvelle-Aquitaine;19;1;19;196;Saint-Cyr-la-Roche;505;8;513
75;Nouvelle-Aquitaine;19;1;18;198;Saint-Éloy-les-Tuileries;102;0;102
75;Nouvelle-Aquitaine;19;3;08;199;Saint-Étienne-aux-Clos;229;3;232
75;Nouvelle-Aquitaine;19;3;08;200;Saint-Étienne-la-Geneste;93;7;100
75;Nouvelle-Aquitaine;19;3;08;201;Saint-Exupéry-les-Roches;596;12;608
75;Nouvelle-Aquitaine;19;3;08;204;Saint-Fréjoux;291;6;297
75;Nouvelle-Aquitaine;19;2;02;205;Saint-Geniez-ô-Merle;90;2;92
75;Nouvelle-Aquitaine;19;3;12;206;Saint-Germain-Lavolps;87;1;88
75;Nouvelle-Aquitaine;19;2;11;207;Saint-Germain-les-Vergnes;1114;31;1145
75;Nouvelle-Aquitaine;19;3;07;208;Saint-Hilaire-Foissac;188;3;191
75;Nouvelle-Aquitaine;19;2;15;209;Saint-Hilaire-les-Courbes;158;2;160
75;Nouvelle-Aquitaine;19;3;08;210;Saint-Hilaire-Luc;70;0;70
75;Nouvelle-Aquitaine;19;2;11;211;Saint-Hilaire-Peyroux;978;20;998
75;Nouvelle-Aquitaine;19;2;02;212;Saint-Hilaire-Taurieux;103;6;109
75;Nouvelle-Aquitaine;19;2;15;213;Saint-Jal;629;17;646
75;Nouvelle-Aquitaine;19;2;02;214;Saint-Julien-aux-Bois;466;8;474
75;Nouvelle-Aquitaine;19;2;02;215;Saint-Julien-le-Pèlerin;129;3;132
75;Nouvelle-Aquitaine;19;1;18;216;Saint-Julien-le-Vendômois;249;3;252
75;Nouvelle-Aquitaine;19;1;10;217;Saint-Julien-Maumont;157;4;161
75;Nouvelle-Aquitaine;19;2;14;220;Saint-Martial-de-Gimel;487;7;494
75;Nouvelle-Aquitaine;19;2;02;221;Saint-Martial-Entraygues;84;2;86
75;Nouvelle-Aquitaine;19;2;14;222;Saint-Martin-la-Méanne;340;12;352
75;Nouvelle-Aquitaine;19;1;18;223;Saint-Martin-Sepert;274;2;276
75;Nouvelle-Aquitaine;19;3;07;225;Saint-Merd-de-Lapleau;174;2;176
75;Nouvelle-Aquitaine;19;3;12;226;Saint-Merd-les-Oussines;129;3;132
75;Nouvelle-Aquitaine;19;2;11;227;Saint-Mexant;1307;33;1340
75;Nouvelle-Aquitaine;19;3;08;228;Saint-Pantaléon-de-Lapleau;67;1;68
75;Nouvelle-Aquitaine;19;1;13;229;Saint-Pantaléon-de-Larche;4777;91;4868
75;Nouvelle-Aquitaine;19;1;18;230;Saint-Pardoux-Corbier;418;3;421
75;Nouvelle-Aquitaine;19;1;01;234;Saint-Pardoux-l'Ortigier;480;7;487
75;Nouvelle-Aquitaine;19;2;14;231;Saint-Pardoux-la-Croisille;177;2;179
75;Nouvelle-Aquitaine;19;3;17;232;Saint-Pardoux-le-Neuf;76;3;79
75;Nouvelle-Aquitaine;19;3;12;233;Saint-Pardoux-le-Vieux;297;12;309
75;Nouvelle-Aquitaine;19;2;14;235;Saint-Paul;221;6;227
75;Nouvelle-Aquitaine;19;2;14;236;Saint-Priest-de-Gimel;495;4;499
75;Nouvelle-Aquitaine;19;2;02;237;Saint-Privat;1075;21;1096
75;Nouvelle-Aquitaine;19;3;12;238;Saint-Rémy;227;6;233
75;Nouvelle-Aquitaine;19;1;19;239;Saint-Robert;301;8;309
75;Nouvelle-Aquitaine;19;2;15;240;Saint-Salvadour;300;12;312
75;Nouvelle-Aquitaine;19;3;12;241;Saint-Setiers;285;5;290
75;Nouvelle-Aquitaine;19;1;19;242;Saint-Solve;460;17;477
75;Nouvelle-Aquitaine;19;1;18;243;Saint-Sornin-Lavolps;858;17;875
75;Nouvelle-Aquitaine;19;3;12;244;Saint-Sulpice-les-Bois;84;0;84
75;Nouvelle-Aquitaine;19;2;02;245;Saint-Sylvain;135;5;140
75;Nouvelle-Aquitaine;19;1;01;246;Saint-Viance;1853;42;1895
75;Nouvelle-Aquitaine;19;3;08;247;Saint-Victour;186;9;195
75;Nouvelle-Aquitaine;19;2;18;248;Saint-Ybard;685;13;698
75;Nouvelle-Aquitaine;19;3;07;249;Saint-Yrieix-le-Déjalat;344;8;352
75;Nouvelle-Aquitaine;19;1;01;202;Sainte-Féréole;1941;40;1981
75;Nouvelle-Aquitaine;19;2;14;203;Sainte-Fortunade;1784;91;1875
75;Nouvelle-Aquitaine;19;3;08;219;Sainte-Marie-Lapanouze;59;1;60
75;Nouvelle-Aquitaine;19;2;18;250;Salon-la-Tour;658;5;663
75;Nouvelle-Aquitaine;19;3;07;251;Sarran;275;7;282
75;Nouvelle-Aquitaine;19;3;08;252;Sarroux - Saint Julien;851;17;868
75;Nouvelle-Aquitaine;19;1;19;253;Segonzac;222;2;224
75;Nouvelle-Aquitaine;19;1;18;254;Ségur-le-Château;174;4;178
75;Nouvelle-Aquitaine;19;2;15;255;Seilhac;1737;32;1769
75;Nouvelle-Aquitaine;19;3;08;256;Sérandon;349;5;354
75;Nouvelle-Aquitaine;19;1;10;257;Sérilhac;268;7;275
75;Nouvelle-Aquitaine;19;2;02;258;Servières-le-Château;613;9;622
75;Nouvelle-Aquitaine;19;2;02;259;Sexcles;234;5;239
75;Nouvelle-Aquitaine;19;1;10;260;Sioniac;220;6;226
75;Nouvelle-Aquitaine;19;3;12;261;Sornac;759;15;774
75;Nouvelle-Aquitaine;19;2;15;262;Soudaine-Lavinadière;176;18;194
75;Nouvelle-Aquitaine;19;3;12;263;Soudeilles;301;11;312
75;Nouvelle-Aquitaine;19;3;07;264;Soursac;505;3;508
75;Nouvelle-Aquitaine;19;2;12;265;Tarnac;339;8;347
75;Nouvelle-Aquitaine;19;3;08;266;Thalamy;97;4;101
75;Nouvelle-Aquitaine;19;2;12;268;Toy-Viam;37;0;37
75;Nouvelle-Aquitaine;19;2;15;269;Treignac;1361;67;1428
75;Nouvelle-Aquitaine;19;1;01;270;Troche;557;8;565
75;Nouvelle-Aquitaine;19;1;10;271;Tudeils;245;3;248
75;Nouvelle-Aquitaine;19;2;16;272;Tulle;14836;628;15464
75;Nouvelle-Aquitaine;19;1;13;273;Turenne;838;21;859
75;Nouvelle-Aquitaine;19;1;09;274;Ussac;4178;116;4294
75;Nouvelle-Aquitaine;19;3;17;275;Ussel;9736;388;10124
75;Nouvelle-Aquitaine;19;2;18;276;Uzerche;2806;64;2870
75;Nouvelle-Aquitaine;19;3;08;277;Valiergues;144;5;149
75;Nouvelle-Aquitaine;19;1;09;278;Varetz;2425;42;2467
75;Nouvelle-Aquitaine;19;1;19;279;Vars-sur-Roseix;374;6;380
75;Nouvelle-Aquitaine;19;1;10;280;Végennes;181;4;185
75;Nouvelle-Aquitaine;19;2;15;281;Veix;67;8;75
75;Nouvelle-Aquitaine;19;3;08;283;Veyrières;73;1;74
75;Nouvelle-Aquitaine;19;2;12;284;Viam;93;3;96
75;Nouvelle-Aquitaine;19;2;01;285;Vigeois;1195;27;1222
75;Nouvelle-Aquitaine;19;1;19;286;Vignols;550;9;559
75;Nouvelle-Aquitaine;19;2;07;287;Vitrac-sur-Montane;267;6;273
75;Nouvelle-Aquitaine;19;1;19;288;Voutezac;1259;151;1410
75;Nouvelle-Aquitaine;19;1;19;289;Yssandon;682;7;689
94;Corse;2A;1;08;001;Afa;3133;65;3198
94;Corse;2A;1;98;004;Ajaccio;70659;849;71508
94;Corse;2A;1;05;006;Alata;3244;85;3329
94;Corse;2A;1;11;008;Albitreccia;1705;25;1730
94;Corse;2A;4;09;011;Altagène;49;2;51
94;Corse;2A;1;10;014;Ambiegna;68;1;69
94;Corse;2A;1;08;017;Appietto;1825;40;1865
94;Corse;2A;4;09;018;Arbellara;156;2;158
94;Corse;2A;1;10;019;Arbori;54;0;54
94;Corse;2A;4;11;021;Argiusta-Moriccio;76;2;78
94;Corse;2A;1;10;022;Arro;83;1;84
94;Corse;2A;4;09;024;Aullène;187;2;189
94;Corse;2A;1;11;026;Azilone-Ampaza;184;3;187
94;Corse;2A;1;10;027;Azzana;54;0;54
94;Corse;2A;1;10;028;Balogna;137;5;142
94;Corse;2A;1;08;031;Bastelica;533;7;540
94;Corse;2A;1;05;032;Bastelicaccia;3983;108;4091
94;Corse;2A;4;09;035;Belvédère-Campomoro;165;2;167
94;Corse;2A;4;09;038;Bilia;46;5;51
94;Corse;2A;1;08;040;Bocognano;396;6;402
94;Corse;2A;4;07;041;Bonifacio;3118;55;3173
94;Corse;2A;1;10;048;Calcatoggio;523;3;526
94;Corse;2A;1;11;056;Campo;110;4;114
94;Corse;2A;1;10;060;Cannelle;65;1;66
94;Corse;2A;4;07;061;Carbini;103;2;105
94;Corse;2A;1;08;062;Carbuccia;393;10;403
94;Corse;2A;1;11;064;Cardo-Torgia;32;2;34
94;Corse;2A;1;10;065;Cargèse;1325;25;1350
94;Corse;2A;4;09;066;Cargiaca;55;0;55
94;Corse;2A;1;10;070;Casaglione;398;7;405
94;Corse;2A;4;11;071;Casalabriva;213;3;216
94;Corse;2A;1;11;085;Cauro;1444;37;1481
94;Corse;2A;1;11;089;Ciamannacce;133;2;135
94;Corse;2A;1;10;090;Coggia;695;16;711
94;Corse;2A;1;11;091;Cognocoli-Monticchi;169;0;169
94;Corse;2A;4;06;092;Conca;1100;21;1121
94;Corse;2A;1;11;094;Corrano;72;3;75
94;Corse;2A;1;11;098;Coti-Chiavari;728;8;736
94;Corse;2A;1;11;099;Cozzano;273;0;273
94;Corse;2A;1;10;100;Cristinacce;63;0;63
94;Corse;2A;1;08;103;Cuttoli-Corticchiato;2009;34;2043
94;Corse;2A;1;11;104;Eccica-Suarella;1179;45;1224
94;Corse;2A;1;10;108;Évisa;219;7;226
94;Corse;2A;4;07;114;Figari;1446;29;1475
94;Corse;2A;4;09;115;Foce;152;7;159
94;Corse;2A;1;11;117;Forciolo;81;0;81
94;Corse;2A;4;09;118;Fozzano;209;5;214
94;Corse;2A;1;11;119;Frasseto;122;4;126
94;Corse;2A;4;09;127;Giuncheto;86;2;88
94;Corse;2A;4;09;128;Granace;90;0;90
94;Corse;2A;4;09;129;Grossa;43;1;44
94;Corse;2A;1;11;130;Grosseto-Prugna;3124;53;3177
94;Corse;2A;1;10;131;Guagno;165;1;166
94;Corse;2A;1;11;132;Guargualé;145;1;146
94;Corse;2A;1;11;133;Guitera-les-Bains;148;5;153
94;Corse;2A;4;06;139;Lecci;1735;11;1746
94;Corse;2A;1;10;141;Letia;121;1;122
94;Corse;2A;4;07;142;Levie;687;14;701
94;Corse;2A;1;10;144;Lopigna;103;2;105
94;Corse;2A;4;09;146;Loreto-di-Tallano;53;0;53
94;Corse;2A;1;10;154;Marignana;110;3;113
94;Corse;2A;4;09;158;Mela;29;1;30
94;Corse;2A;4;11;160;Moca-Croce;252;4;256
94;Corse;2A;4;07;163;Monacia-d'Aullène;528;8;536
94;Corse;2A;1;10;174;Murzo;97;3;100
94;Corse;2A;1;08;181;Ocana;605;16;621
94;Corse;2A;1;11;186;Olivese;226;1;227
94;Corse;2A;4;09;189;Olmeto;1216;29;1245
94;Corse;2A;4;09;191;Olmiccia;122;3;125
94;Corse;2A;1;10;196;Orto;55;1;56
94;Corse;2A;1;10;197;Osani;97;1;98
94;Corse;2A;1;10;198;Ota;528;11;539
94;Corse;2A;1;11;200;Palneca;161;2;163
94;Corse;2A;1;10;203;Partinello;102;1;103
94;Corse;2A;1;10;204;Pastricciola;97;1;98
94;Corse;2A;1;08;209;Peri;1999;35;2034
94;Corse;2A;4;11;211;Petreto-Bicchisano;564;17;581
94;Corse;2A;1;10;212;Piana;482;4;486
94;Corse;2A;4;07;215;Pianottoli-Caldarello;912;7;919
94;Corse;2A;1;11;228;Pietrosella;1685;16;1701
94;Corse;2A;1;11;232;Pila-Canale;284;4;288
94;Corse;2A;1;10;240;Poggiolo;111;2;113
94;Corse;2A;4;99;247;Porto-Vecchio;12042;229;12271
94;Corse;2A;4;09;249;Propriano;3747;40;3787
94;Corse;2A;1;11;253;Quasquara;51;0;51
94;Corse;2A;4;09;254;Quenza;190;5;195
94;Corse;2A;1;10;258;Renno;59;3;62
94;Corse;2A;1;10;259;Rezza;54;1;55
94;Corse;2A;1;10;262;Rosazia;49;3;52
94;Corse;2A;4;09;308;Sainte-Lucie-de-Tallano;424;10;434
94;Corse;2A;1;10;266;Salice;91;4;95
94;Corse;2A;1;11;268;Sampolo;80;0;80
94;Corse;2A;4;06;300;San-Gavino-di-Carbini;1110;21;1131
94;Corse;2A;1;10;295;Sant'Andréa-d'Orcino;110;0;110
94;Corse;2A;4;09;310;Santa-Maria-Figaniella;100;0;100
94;Corse;2A;1;11;312;Santa-Maria-Siché;439;9;448
94;Corse;2A;1;10;270;Sari-d'Orcino;329;5;334
94;Corse;2A;4;06;269;Sari-Solenzara;1345;30;1375
94;Corse;2A;1;08;271;Sarrola-Carcopino;3267;62;3329
94;Corse;2A;4;09;272;Sartène;3259;132;3391
94;Corse;2A;1;11;276;Serra-di-Ferro;482;11;493
94;Corse;2A;4;09;278;Serra-di-Scopamène;89;2;91
94;Corse;2A;1;10;279;Serriera;127;0;127
94;Corse;2A;1;10;282;Soccia;146;4;150
94;Corse;2A;4;11;284;Sollacaro;363;5;368
94;Corse;2A;4;09;285;Sorbollano;78;0;78
94;Corse;2A;4;07;288;Sotta;1371;23;1394
94;Corse;2A;1;11;322;Tasso;110;0;110
94;Corse;2A;1;08;323;Tavaco;369;8;377
94;Corse;2A;1;08;324;Tavera;401;5;406
94;Corse;2A;1;08;326;Tolla;125;0;125
94;Corse;2A;1;08;330;Ucciani;501;4;505
94;Corse;2A;1;11;331;Urbalacone;65;0;65
94;Corse;2A;1;08;336;Valle-di-Mezzana;444;9;453
94;Corse;2A;1;08;345;Vero;579;3;582
94;Corse;2A;1;10;348;Vico;912;14;926
94;Corse;2A;4;09;349;Viggianello;814;17;831
94;Corse;2A;1;05;351;Villanova;362;10;372
94;Corse;2A;4;09;357;Zérubia;43;3;46
94;Corse;2A;1;11;358;Zévaco;59;2;61
94;Corse;2A;1;11;359;Zicavo;229;2;231
94;Corse;2A;1;11;360;Zigliara;130;7;137
94;Corse;2A;4;06;362;Zonza;2722;35;2757
94;Corse;2A;4;09;363;Zoza;54;0;54
94;Corse;2B;3;13;002;Aghione;241;4;245
94;Corse;2B;3;14;003;Aiti;30;0;30
94;Corse;2B;3;14;005;Alando;35;2;37
94;Corse;2B;3;14;007;Albertacce;200;1;201
94;Corse;2B;3;13;009;Aléria;2162;25;2187
94;Corse;2B;5;07;010;Algajola;358;7;365
94;Corse;2B;3;13;012;Altiani;48;0;48
94;Corse;2B;3;14;013;Alzi;26;0;26
94;Corse;2B;3;13;015;Ampriani;24;0;24
94;Corse;2B;3;13;016;Antisanti;546;0;546
94;Corse;2B;5;07;020;Aregno;598;16;614
94;Corse;2B;3;14;023;Asco;119;2;121
94;Corse;2B;5;07;025;Avapessa;82;3;85
94;Corse;2B;5;05;029;Barbaggio;303;3;306
94;Corse;2B;2;08;030;Barrettali;133;4;137
94;Corse;2B;2;99;033;Bastia;45715;719;46434
94;Corse;2B;5;15;034;Belgodère;623;9;632
94;Corse;2B;3;14;036;Bigorno;90;0;90
94;Corse;2B;2;05;037;Biguglia;7923;127;8050
94;Corse;2B;3;14;039;Bisinchi;220;2;222
94;Corse;2B;2;06;042;Borgo;8760;140;8900
94;Corse;2B;2;08;043;Brando;1630;40;1670
94;Corse;2B;3;14;045;Bustanico;64;1;65
94;Corse;2B;2;08;046;Cagnano;169;3;172
94;Corse;2B;3;14;047;Calacuccia;280;6;286
94;Corse;2B;5;07;049;Calenzana;2342;30;2372
94;Corse;2B;5;07;050;Calvi;5559;79;5638
94;Corse;2B;3;14;051;Cambia;80;0;80
94;Corse;2B;3;10;052;Campana;18;0;18
94;Corse;2B;3;13;053;Campi;20;2;22
94;Corse;2B;3;14;054;Campile;195;2;197
94;Corse;2B;3;14;055;Campitello;119;1;120
94;Corse;2B;3;10;057;Canale-di-Verde;321;10;331
94;Corse;2B;2;08;058;Canari;312;1;313
94;Corse;2B;3;14;059;Canavaggia;103;1;104
94;Corse;2B;3;10;063;Carcheto-Brustico;31;1;32
94;Corse;2B;3;10;067;Carpineto;33;0;33
94;Corse;2B;3;14;068;Carticasi;27;0;27
94;Corse;2B;3;09;069;Casabianca;84;2;86
94;Corse;2B;3;09;072;Casalta;53;0;53
94;Corse;2B;3;14;073;Casamaccioli;106;0;106
94;Corse;2B;3;11;074;Casanova;391;6;397
94;Corse;2B;3;13;075;Casevecchie;67;2;69
94;Corse;2B;3;09;077;Castellare-di-Casinca;666;6;672
94;Corse;2B;3;14;078;Castellare-di-Mercurio;31;1;32
94;Corse;2B;3;14;079;Castello-di-Rostino;471;5;476
94;Corse;2B;3;14;080;Castifao;152;1;153
94;Corse;2B;3;14;081;Castiglione;42;0;42
94;Corse;2B;3;14;082;Castineta;41;1;42
94;Corse;2B;3;14;083;Castirla;168;2;170
94;Corse;2B;5;07;084;Cateri;215;6;221
94;Corse;2B;2;08;086;Centuri;210;1;211
94;Corse;2B;3;10;087;Cervione;2189;26;2215
94;Corse;2B;3;10;088;Chiatra;222;5;227
94;Corse;2B;3;12;366;Chisa;100;2;102
94;Corse;2B;5;15;093;Corbara;907;32;939
94;Corse;2B;3;14;095;Corscia;129;3;132
94;Corse;2B;3;11;096;Corte;7446;117;7563
94;Corse;2B;5;15;097;Costa;62;1;63
94;Corse;2B;3;09;101;Croce;75;3;78
94;Corse;2B;3;14;102;Crocicchia;70;0;70
94;Corse;2B;3;14;105;Erbajolo;110;0;110
94;Corse;2B;3;14;106;Érone;11;0;11
94;Corse;2B;2;08;107;Ersa;154;1;155
94;Corse;2B;5;08;109;Farinole;228;1;229
94;Corse;2B;3;14;110;Favalello;76;3;79
94;Corse;2B;3;10;111;Felce;51;0;51
94;Corse;2B;5;15;112;Feliceto;225;4;229
94;Corse;2B;3;09;113;Ficaja;53;1;54
94;Corse;2B;3;14;116;Focicchia;26;1;27
94;Corse;2B;2;04;120;Furiani;5628;126;5754
94;Corse;2B;5;07;121;Galéria;338;9;347
94;Corse;2B;3;14;122;Gavignano;53;0;53
94;Corse;2B;3;13;123;Ghisonaccia;4225;66;4291
94;Corse;2B;3;12;124;Ghisoni;212;6;218
94;Corse;2B;3;09;125;Giocatojo;49;0;49
94;Corse;2B;3;13;126;Giuncaggio;62;0;62
94;Corse;2B;5;15;134;L' Île-Rousse;3043;78;3121
94;Corse;2B;3;12;135;Isolaccio-di-Fiumorbo;311;2;313
94;Corse;2B;5;15;136;Lama;151;2;153
94;Corse;2B;3;14;137;Lano;25;0;25
94;Corse;2B;5;07;138;Lavatoggio;150;3;153
94;Corse;2B;3;14;140;Lento;103;0;103
94;Corse;2B;3;13;143;Linguizzetta;1107;9;1116
94;Corse;2B;3;09;145;Loreto-di-Casinca;212;6;218
94;Corse;2B;3;14;147;Lozzi;118;2;120
94;Corse;2B;2;06;148;Lucciana;5780;49;5829
94;Corse;2B;3;12;149;Lugo-di-Nazza;78;3;81
94;Corse;2B;5;07;150;Lumio;1180;35;1215
94;Corse;2B;2;08;152;Luri;835;9;844
94;Corse;2B;5;07;153;Manso;114;2;116
94;Corse;2B;3;13;155;Matra;44;0;44
94;Corse;2B;5;15;156;Mausoléo;17;0;17
94;Corse;2B;3;14;157;Mazzola;28;0;28
94;Corse;2B;2;08;159;Meria;98;1;99
94;Corse;2B;3;13;161;Moïta;75;0;75
94;Corse;2B;3;14;162;Moltifao;682;11;693
94;Corse;2B;3;10;164;Monacia-d'Orezza;25;0;25
94;Corse;2B;5;07;165;Moncale;321;8;329
94;Corse;2B;3;14;166;Monte;607;5;612
94;Corse;2B;5;07;167;Montegrosso;426;5;431
94;Corse;2B;5;15;168;Monticello;1923;46;1969
94;Corse;2B;3;14;169;Morosaglia;1043;9;1052
94;Corse;2B;2;08;170;Morsiglia;119;2;121
94;Corse;2B;3;11;171;Muracciole;34;1;35
94;Corse;2B;5;05;172;Murato;600;15;615
94;Corse;2B;5;15;173;Muro;238;4;242
94;Corse;2B;5;15;175;Nessa;109;2;111
94;Corse;2B;3;10;176;Nocario;66;3;69
94;Corse;2B;3;12;177;Noceta;62;2;64
94;Corse;2B;2;08;178;Nonza;74;2;76
94;Corse;2B;3;10;179;Novale;62;0;62
94;Corse;2B;5;15;180;Novella;83;2;85
94;Corse;2B;5;15;182;Occhiatana;246;1;247
94;Corse;2B;2;08;183;Ogliastro;99;2;101
94;Corse;2B;2;08;184;Olcani;82;1;83
94;Corse;2B;5;05;185;Oletta;1696;13;1709
94;Corse;2B;2;08;187;Olmeta-di-Capocorso;142;1;143
94;Corse;2B;5;05;188;Olmeta-di-Tuda;488;9;497
94;Corse;2B;5;15;190;Olmi-Cappella;180;7;187
94;Corse;2B;3;14;192;Olmo;160;1;161
94;Corse;2B;3;14;193;Omessa;587;4;591
94;Corse;2B;3;10;194;Ortale;25;1;26
94;Corse;2B;3;14;195;Ortiporio;127;1;128
94;Corse;2B;5;15;199;Palasca;170;4;174
94;Corse;2B;3;13;201;Pancheraccia;187;3;190
94;Corse;2B;3;10;202;Parata;24;0;24
94;Corse;2B;5;08;205;Patrimonio;807;11;818
94;Corse;2B;3;14;206;Penta-Acquatella;34;0;34
94;Corse;2B;3;09;207;Penta-di-Casinca;3396;40;3436
94;Corse;2B;3;10;208;Perelli;110;0;110
94;Corse;2B;3;09;210;Pero-Casevecchie;123;1;124
94;Corse;2B;3;13;213;Pianello;70;0;70
94;Corse;2B;3;09;214;Piano;28;1;29
94;Corse;2B;3;10;216;Piazzali;17;0;17
94;Corse;2B;3;10;217;Piazzole;41;3;44
94;Corse;2B;3;10;222;Pie-d'Orezza;37;0;37
94;Corse;2B;3;13;218;Piedicorte-di-Gaggio;97;3;100
94;Corse;2B;3;10;219;Piedicroce;100;1;101
94;Corse;2B;3;14;220;Piedigriggio;138;2;140
94;Corse;2B;3;10;221;Piedipartino;17;0;17
94;Corse;2B;3;10;225;Pietra-di-Verde;102;6;108
94;Corse;2B;2;08;224;Pietracorbara;652;11;663
94;Corse;2B;5;14;223;Pietralba;504;3;507
94;Corse;2B;3;13;226;Pietraserena;72;1;73
94;Corse;2B;3;10;227;Pietricaggio;35;1;36
94;Corse;2B;3;12;229;Pietroso;289;0;289
94;Corse;2B;5;05;230;Piève;109;5;114
94;Corse;2B;5;15;231;Pigna;95;6;101
94;Corse;2B;2;08;233;Pino;164;2;166
94;Corse;2B;3;10;234;Piobetta;20;0;20
94;Corse;2B;5;15;235;Pioggiola;88;2;90
94;Corse;2B;5;05;239;Poggio-d'Oletta;213;6;219
94;Corse;2B;3;12;236;Poggio-di-Nazza;176;2;178
94;Corse;2B;3;11;238;Poggio-di-Venaco;214;2;216
94;Corse;2B;3;09;241;Poggio-Marinaccio;30;1;31
94;Corse;2B;3;10;242;Poggio-Mezzana;680;13;693
94;Corse;2B;3;09;243;Polveroso;42;0;42
94;Corse;2B;3;14;244;Popolasca;45;1;46
94;Corse;2B;3;09;245;Porri;43;1;44
94;Corse;2B;3;09;246;La Porta;193;1;194
94;Corse;2B;3;14;248;Prato-di-Giovellina;42;1;43
94;Corse;2B;3;14;250;Prunelli-di-Casacconi;150;0;150
94;Corse;2B;3;12;251;Prunelli-di-Fiumorbo;3660;40;3700
94;Corse;2B;3;09;252;Pruno;175;2;177
94;Corse;2B;3;09;255;Quercitello;44;0;44
94;Corse;2B;3;10;256;Rapaggio;25;0;25
94;Corse;2B;5;05;257;Rapale;151;0;151
94;Corse;2B;3;11;260;Riventosa;157;3;160
94;Corse;2B;2;08;261;Rogliano;563;11;574
94;Corse;2B;3;12;263;Rospigliani;71;5;76
94;Corse;2B;3;14;264;Rusio;71;1;72
94;Corse;2B;5;05;265;Rutali;377;6;383
94;Corse;2B;5;05;298;Saint-Florent;1655;36;1691
94;Corse;2B;3;14;267;Saliceto;50;3;53
94;Corse;2B;3;09;297;San-Damiano;58;0;58
94;Corse;2B;3;09;299;San-Gavino-d'Ampugnani;107;1;108
94;Corse;2B;3;12;365;San-Gavino-di-Fiumorbo;121;2;123
94;Corse;2B;5;05;301;San-Gavino-di-Tenda;66;1;67
94;Corse;2B;3;10;302;San-Giovanni-di-Moriani;94;2;96
94;Corse;2B;3;10;303;San-Giuliano;726;6;732
94;Corse;2B;3;14;304;San-Lorenzo;143;0;143
94;Corse;2B;2;08;305;San-Martino-di-Lota;2901;42;2943
94;Corse;2B;3;10;313;San-Nicolao;1987;22;2009
94;Corse;2B;3;14;292;Sant'Andréa-di-Bozio;72;2;74
94;Corse;2B;3;10;293;Sant'Andréa-di-Cotone;229;2;231
94;Corse;2B;5;07;296;Sant'Antonino;127;5;132
94;Corse;2B;3;14;306;Santa-Lucia-di-Mercurio;111;0;111
94;Corse;2B;3;10;307;Santa-Lucia-di-Moriani;1428;14;1442
94;Corse;2B;2;08;309;Santa-Maria-di-Lota;1722;53;1775
94;Corse;2B;3;10;311;Santa-Maria-Poggio;743;11;754
94;Corse;2B;5;15;316;Santa-Reparata-di-Balagna;1012;20;1032
94;Corse;2B;3;10;317;Santa-Reparata-di-Moriani;54;0;54
94;Corse;2B;5;05;314;Santo-Pietro-di-Tenda;361;4;365
94;Corse;2B;3;11;315;Santo-Pietro-di-Venaco;277;5;282
94;Corse;2B;3;09;273;Scata;46;5;51
94;Corse;2B;3;14;274;Scolca;101;1;102
94;Corse;2B;3;14;275;Sermano;63;2;65
94;Corse;2B;3;12;277;Serra-di-Fiumorbo;335;3;338
94;Corse;2B;3;09;280;Silvareccio;131;0;131
94;Corse;2B;2;08;281;Sisco;1169;9;1178
94;Corse;2B;3;12;283;Solaro;706;13;719
94;Corse;2B;3;09;286;Sorbo-Ocagnano;832;8;840
94;Corse;2B;5;05;287;Sorio;142;0;142
94;Corse;2B;3;14;289;Soveria;117;0;117
94;Corse;2B;5;15;290;Speloncato;276;4;280
94;Corse;2B;3;10;291;Stazzona;39;1;40
94;Corse;2B;3;09;318;Taglio-Isolaccio;572;12;584
94;Corse;2B;3;09;319;Talasani;772;7;779
94;Corse;2B;3;13;320;Tallone;315;2;317
94;Corse;2B;3;10;321;Tarrano;16;0;16
94;Corse;2B;2;08;327;Tomino;208;3;211
94;Corse;2B;3;13;328;Tox;96;0;96
94;Corse;2B;3;14;329;Tralonca;110;1;111
94;Corse;2B;5;15;332;Urtaca;230;3;233
94;Corse;2B;3;10;334;Valle-d'Alesani;109;1;110
94;Corse;2B;3;10;338;Valle-d'Orezza;43;0;43
94;Corse;2B;3;10;335;Valle-di-Campoloro;344;7;351
94;Corse;2B;3;14;337;Valle-di-Rostino;132;0;132
94;Corse;2B;5;05;333;Vallecalle;137;3;140
94;Corse;2B;5;15;339;Vallica;26;0;26
94;Corse;2B;3;10;340;Velone-Orneto;117;0;117
94;Corse;2B;3;11;341;Venaco;711;17;728
94;Corse;2B;3;12;342;Ventiseri;2481;46;2527
94;Corse;2B;3;09;343;Venzolasca;1796;14;1810
94;Corse;2B;3;10;344;Verdèse;37;2;39
94;Corse;2B;3;09;346;Vescovato;2836;31;2867
94;Corse;2B;3;12;347;Vezzani;265;1;266
94;Corse;2B;2;06;350;Vignale;160;1;161
94;Corse;2B;5;15;352;Ville-di-Paraso;213;4;217
94;Corse;2B;2;01;353;Ville-di-Pietrabugno;3323;85;3408
94;Corse;2B;3;11;354;Vivario;432;4;436
94;Corse;2B;3;14;355;Volpajola;390;7;397
94;Corse;2B;3;13;356;Zalana;141;1;142
94;Corse;2B;5;07;361;Zilia;286;5;291
94;Corse;2B;3;13;364;Zuani;30;0;30
27;Bourgogne-Franche-Comté;21;1;20;001;Agencourt;460;53;513
27;Bourgogne-Franche-Comté;21;2;23;002;Agey;278;3;281
27;Bourgogne-Franche-Comté;21;2;14;003;Ahuy;1210;24;1234
27;Bourgogne-Franche-Comté;21;3;05;004;Aignay-le-Duc;282;7;289
27;Bourgogne-Franche-Comté;21;2;15;005;Aiserey;1400;13;1413
27;Bourgogne-Franche-Comté;21;3;05;006;Aisey-sur-Seine;176;1;177
27;Bourgogne-Franche-Comté;21;3;22;007;Aisy-sous-Thil;224;30;254
27;Bourgogne-Franche-Comté;21;3;19;008;Alise-Sainte-Reine;579;7;586
27;Bourgogne-Franche-Comté;21;1;01;009;Allerey;170;2;172
27;Bourgogne-Franche-Comté;21;1;17;010;Aloxe-Corton;134;5;139
27;Bourgogne-Franche-Comté;21;3;05;012;Ampilly-le-Sec;348;12;360
27;Bourgogne-Franche-Comté;21;3;05;011;Ampilly-les-Bordes;84;0;84
27;Bourgogne-Franche-Comté;21;2;23;013;Ancey;442;7;449
27;Bourgogne-Franche-Comté;21;1;01;014;Antheuil;60;2;62
27;Bourgogne-Franche-Comté;21;1;01;015;Antigny-la-Ville;102;0;102
27;Bourgogne-Franche-Comté;21;2;21;021;Arc-sur-Tille;2670;59;2729
27;Bourgogne-Franche-Comté;21;2;21;016;Arceau;897;17;914
27;Bourgogne-Franche-Comté;21;1;20;017;Arcenant;507;19;526
27;Bourgogne-Franche-Comté;21;2;23;018;Arcey;53;1;54
27;Bourgogne-Franche-Comté;21;1;01;020;Arconcey;222;8;230
27;Bourgogne-Franche-Comté;21;1;20;022;Argilly;513;12;525
27;Bourgogne-Franche-Comté;21;1;01;023;Arnay-le-Duc;1425;39;1464
27;Bourgogne-Franche-Comté;21;3;22;024;Arnay-sous-Vitteaux;111;0;111
27;Bourgogne-Franche-Comté;21;3;19;025;Arrans;73;2;75
27;Bourgogne-Franche-Comté;21;3;19;026;Asnières-en-Montagne;191;9;200
27;Bourgogne-Franche-Comté;21;2;14;027;Asnières-lès-Dijon;1184;25;1209
27;Bourgogne-Franche-Comté;21;2;02;028;Athée;781;10;791
27;Bourgogne-Franche-Comté;21;3;19;029;Athie;75;1;76
27;Bourgogne-Franche-Comté;21;1;01;030;Aubaine;95;3;98
27;Bourgogne-Franche-Comté;21;1;04;031;Aubigny-en-Plaine;507;5;512
27;Bourgogne-Franche-Comté;21;1;01;032;Aubigny-la-Ronce;167;4;171
27;Bourgogne-Franche-Comté;21;2;23;033;Aubigny-lès-Sombernon;150;5;155
27;Bourgogne-Franche-Comté;21;3;05;034;Autricourt;127;2;129
27;Bourgogne-Franche-Comté;21;1;04;035;Auvillars-sur-Saône;331;5;336
27;Bourgogne-Franche-Comté;21;1;01;036;Auxant;74;4;78
27;Bourgogne-Franche-Comté;21;1;17;037;Auxey-Duresses;304;13;317
27;Bourgogne-Franche-Comté;21;2;02;038;Auxonne;7622;86;7708
27;Bourgogne-Franche-Comté;21;2;16;039;Avelanges;35;0;35
27;Bourgogne-Franche-Comté;21;3;22;040;Avosnes;89;5;94
27;Bourgogne-Franche-Comté;21;2;16;041;Avot;187;2;189
27;Bourgogne-Franche-Comté;21;1;04;042;Bagnot;161;4;165
27;Bourgogne-Franche-Comté;21;3;05;043;Baigneux-les-Juifs;242;46;288
27;Bourgogne-Franche-Comté;21;3;05;044;Balot;90;1;91
27;Bourgogne-Franche-Comté;21;2;23;045;Barbirey-sur-Ouche;216;9;225
27;Bourgogne-Franche-Comté;21;1;01;046;Bard-le-Régulier;72;2;74
27;Bourgogne-Franche-Comté;21;3;22;047;Bard-lès-Époisses;70;2;72
27;Bourgogne-Franche-Comté;21;1;20;048;Barges;621;10;631
27;Bourgogne-Franche-Comté;21;2;16;049;Barjon;41;2;43
27;Bourgogne-Franche-Comté;21;1;01;050;Baubigny;202;6;208
27;Bourgogne-Franche-Comté;21;2;23;051;Baulme-la-Roche;90;3;93
27;Bourgogne-Franche-Comté;21;3;05;052;Beaulieu;27;4;31
27;Bourgogne-Franche-Comté;21;2;21;053;Beaumont-sur-Vingeanne;199;4;203
27;Bourgogne-Franche-Comté;21;1;03;054;Beaune;21031;716;21747
27;Bourgogne-Franche-Comté;21;3;05;055;Beaunotte;19;0;19
27;Bourgogne-Franche-Comté;21;2;21;056;Beire-le-Châtel;860;10;870
27;Bourgogne-Franche-Comté;21;2;15;057;Beire-le-Fort;346;5;351
27;Bourgogne-Franche-Comté;21;3;05;058;Belan-sur-Ource;252;5;257
27;Bourgogne-Franche-Comté;21;2;14;059;Bellefond;866;17;883
27;Bourgogne-Franche-Comté;21;2;21;060;Belleneuve;1618;17;1635
27;Bourgogne-Franche-Comté;21;3;05;061;Bellenod-sur-Seine;76;2;78
27;Bourgogne-Franche-Comté;21;1;01;062;Bellenot-sous-Pouilly;224;9;233
27;Bourgogne-Franche-Comté;21;3;05;063;Beneuvre;91;5;96
27;Bourgogne-Franche-Comté;21;3;19;064;Benoisey;109;0;109
27;Bourgogne-Franche-Comté;21;1;01;065;Bessey-en-Chaume;145;5;150
27;Bourgogne-Franche-Comté;21;1;01;066;Bessey-la-Cour;57;1;58
27;Bourgogne-Franche-Comté;21;2;15;067;Bessey-lès-Cîteaux;696;7;703
27;Bourgogne-Franche-Comté;21;1;01;068;Beurey-Bauguay;110;7;117
27;Bourgogne-Franche-Comté;21;3;22;069;Beurizot;121;1;122
27;Bourgogne-Franche-Comté;21;1;18;070;Bévy;139;4;143
27;Bourgogne-Franche-Comté;21;2;21;071;Bèze;714;21;735
27;Bourgogne-Franche-Comté;21;2;21;072;Bézouotte;202;3;205
27;Bourgogne-Franche-Comté;21;2;02;074;Billey;264;4;268
27;Bourgogne-Franche-Comté;21;3;05;075;Billy-lès-Chanceaux;61;1;62
27;Bourgogne-Franche-Comté;21;2;02;076;Binges;790;11;801
27;Bourgogne-Franche-Comté;21;3;05;077;Bissey-la-Côte;124;2;126
27;Bourgogne-Franche-Comté;21;3;05;078;Bissey-la-Pierre;74;2;76
27;Bourgogne-Franche-Comté;21;2;21;079;Blagny-sur-Vingeanne;132;0;132
27;Bourgogne-Franche-Comté;21;2;23;080;Blaisy-Bas;669;11;680
27;Bourgogne-Franche-Comté;21;2;23;081;Blaisy-Haut;131;1;132
27;Bourgogne-Franche-Comté;21;1;01;082;Blancey;75;0;75
27;Bourgogne-Franche-Comté;21;1;01;083;Blanot;127;1;128
27;Bourgogne-Franche-Comté;21;2;14;085;Bligny-le-Sec;148;3;151
27;Bourgogne-Franche-Comté;21;1;17;086;Bligny-lès-Beaune;1238;30;1268
27;Bourgogne-Franche-Comté;21;1;01;087;Bligny-sur-Ouche;831;11;842
27;Bourgogne-Franche-Comté;21;1;20;088;Boncourt-le-Bois;283;7;290
27;Bourgogne-Franche-Comté;21;1;04;089;Bonnencontre;445;6;451
27;Bourgogne-Franche-Comté;21;3;05;090;Boudreville;66;3;69
27;Bourgogne-Franche-Comté;21;1;01;091;Bouhey;38;1;39
27;Bourgogne-Franche-Comté;21;1;17;092;Bouilland;210;9;219
27;Bourgogne-Franche-Comté;21;3;05;093;Bouix;156;4;160
27;Bourgogne-Franche-Comté;21;2;21;094;Bourberain;394;4;398
27;Bourgogne-Franche-Comté;21;1;04;095;Bousselange;51;2;53
27;Bourgogne-Franche-Comté;21;2;16;096;Boussenois;118;1;119
27;Bourgogne-Franche-Comté;21;3;22;097;Boussey;35;2;37
27;Bourgogne-Franche-Comté;21;3;19;098;Boux-sous-Salmaise;125;4;129
27;Bourgogne-Franche-Comté;21;1;17;099;Bouze-lès-Beaune;314;7;321
27;Bourgogne-Franche-Comté;21;3;22;100;Brain;35;0;35
27;Bourgogne-Franche-Comté;21;3;22;101;Braux;168;4;172
27;Bourgogne-Franche-Comté;21;1;01;102;Brazey-en-Morvan;139;3;142
27;Bourgogne-Franche-Comté;21;1;04;103;Brazey-en-Plaine;2379;43;2422
27;Bourgogne-Franche-Comté;21;3;05;104;Brémur-et-Vaurois;49;3;52
27;Bourgogne-Franche-Comté;21;2;07;105;Bressey-sur-Tille;1113;8;1121
27;Bourgogne-Franche-Comté;21;2;18;106;Bretenière;913;13;926
27;Bourgogne-Franche-Comté;21;2;14;107;Bretigny;904;24;928
27;Bourgogne-Franche-Comté;21;3;22;108;Brianny;121;1;122
27;Bourgogne-Franche-Comté;21;3;05;109;Brion-sur-Ource;238;7;245
27;Bourgogne-Franche-Comté;21;1;18;110;Brochon;645;131;776
27;Bourgogne-Franche-Comté;21;2;14;111;Brognon;307;3;310
27;Bourgogne-Franche-Comté;21;1;04;112;Broin;429;10;439
27;Bourgogne-Franche-Comté;21;1;20;113;Broindon;207;2;209
27;Bourgogne-Franche-Comté;21;3;19;114;Buffon;176;1;177
27;Bourgogne-Franche-Comté;21;3;05;115;Buncey;378;7;385
27;Bourgogne-Franche-Comté;21;3;05;116;Bure-les-Templiers;134;0;134
27;Bourgogne-Franche-Comté;21;3;05;117;Busseaut;48;2;50
27;Bourgogne-Franche-Comté;21;2;16;118;Busserotte-et-Montenaille;24;4;28
27;Bourgogne-Franche-Comté;21;1;01;120;La Bussière-sur-Ouche;159;2;161
27;Bourgogne-Franche-Comté;21;2;16;119;Bussières;41;0;41
27;Bourgogne-Franche-Comté;21;2;23;121;Bussy-la-Pesle;77;1;78
27;Bourgogne-Franche-Comté;21;3;19;122;Bussy-le-Grand;316;8;324
27;Bourgogne-Franche-Comté;21;3;05;123;Buxerolles;31;5;36
27;Bourgogne-Franche-Comté;21;1;01;124;Censerey;171;2;173
27;Bourgogne-Franche-Comté;21;3;05;125;Cérilly;231;8;239
27;Bourgogne-Franche-Comté;21;2;15;126;Cessey-sur-Tille;622;7;629
27;Bourgogne-Franche-Comté;21;2;16;127;Chaignay;517;8;525
27;Bourgogne-Franche-Comté;21;1;01;128;Chailly-sur-Armançon;244;11;255
27;Bourgogne-Franche-Comté;21;3;05;129;Chambain;27;0;27
27;Bourgogne-Franche-Comté;21;2;15;130;Chambeire;386;4;390
27;Bourgogne-Franche-Comté;21;1;04;131;Chamblanc;459;69;528
27;Bourgogne-Franche-Comté;21;1;18;133;Chambolle-Musigny;295;7;302
27;Bourgogne-Franche-Comté;21;1;18;132;Chambœuf;382;6;388
27;Bourgogne-Franche-Comté;21;3;05;134;Chamesson;268;10;278
27;Bourgogne-Franche-Comté;21;3;19;137;Champ-d'Oiseau;90;1;91
27;Bourgogne-Franche-Comté;21;2;21;135;Champagne-sur-Vingeanne;315;1;316
27;Bourgogne-Franche-Comté;21;2;14;136;Champagny;27;0;27
27;Bourgogne-Franche-Comté;21;2;02;138;Champdôtre;606;8;614
27;Bourgogne-Franche-Comté;21;3;22;139;Champeau-en-Morvan;228;5;233
27;Bourgogne-Franche-Comté;21;1;01;140;Champignolles;76;1;77
27;Bourgogne-Franche-Comté;21;3;22;141;Champrenault;34;1;35
27;Bourgogne-Franche-Comté;21;2;16;142;Chanceaux;218;4;222
27;Bourgogne-Franche-Comté;21;3;05;143;Channay;64;3;67
27;Bourgogne-Franche-Comté;21;3;19;144;Charencey;33;0;33
27;Bourgogne-Franche-Comté;21;3;22;145;Charigny;34;1;35
27;Bourgogne-Franche-Comté;21;2;21;146;Charmes;135;3;138
27;Bourgogne-Franche-Comté;21;3;22;147;Charny;34;0;34
27;Bourgogne-Franche-Comté;21;1;04;148;Charrey-sur-Saône;351;1;352
27;Bourgogne-Franche-Comté;21;3;05;149;Charrey-sur-Seine;145;8;153
27;Bourgogne-Franche-Comté;21;1;17;150;Chassagne-Montrachet;305;11;316
27;Bourgogne-Franche-Comté;21;3;22;151;Chassey;88;5;93
27;Bourgogne-Franche-Comté;21;1;01;152;Châteauneuf;85;3;88
27;Bourgogne-Franche-Comté;21;1;01;153;Châtellenot;151;6;157
27;Bourgogne-Franche-Comté;21;3;05;154;Châtillon-sur-Seine;5373;349;5722
27;Bourgogne-Franche-Comté;21;1;01;155;Chaudenay-la-Ville;44;7;51
27;Bourgogne-Franche-Comté;21;1;01;156;Chaudenay-le-Château;49;0;49
27;Bourgogne-Franche-Comté;21;3;05;157;Chaugey;17;0;17
27;Bourgogne-Franche-Comté;21;3;05;159;La Chaume;102;2;104
27;Bourgogne-Franche-Comté;21;2;21;158;Chaume-et-Courchamp;180;5;185
27;Bourgogne-Franche-Comté;21;3;05;160;Chaume-lès-Baigneux;93;1;94
27;Bourgogne-Franche-Comté;21;3;05;161;Chaumont-le-Bois;81;5;86
27;Bourgogne-Franche-Comté;21;1;20;162;Chaux;485;9;494
27;Bourgogne-Franche-Comté;21;2;16;163;Chazeuil;197;5;202
27;Bourgogne-Franche-Comté;21;1;01;164;Chazilly;139;3;142
27;Bourgogne-Franche-Comté;21;3;05;165;Chemin-d'Aisey;71;4;75
27;Bourgogne-Franche-Comté;21;2;06;166;Chenôve;13910;196;14106
27;Bourgogne-Franche-Comté;21;2;21;167;Cheuge;126;4;130
27;Bourgogne-Franche-Comté;21;3;22;168;Chevannay;45;1;46
27;Bourgogne-Franche-Comté;21;1;18;169;Chevannes;160;4;164
27;Bourgogne-Franche-Comté;21;1;17;170;Chevigny-en-Valière;358;4;362
27;Bourgogne-Franche-Comté;21;2;07;171;Chevigny-Saint-Sauveur;11326;213;11539
27;Bourgogne-Franche-Comté;21;1;04;172;Chivres;299;5;304
27;Bourgogne-Franche-Comté;21;1;17;173;Chorey-les-Beaune;633;17;650
27;Bourgogne-Franche-Comté;21;2;02;175;Cirey-lès-Pontailler;206;2;208
27;Bourgogne-Franche-Comté;21;1;01;176;Civry-en-Montagne;129;2;131
27;Bourgogne-Franche-Comté;21;3;22;177;Clamerey;184;1;185
27;Bourgogne-Franche-Comté;21;2;14;179;Clénay;855;10;865
27;Bourgogne-Franche-Comté;21;2;02;180;Cléry;142;3;145
27;Bourgogne-Franche-Comté;21;1;01;181;Clomot;137;2;139
27;Bourgogne-Franche-Comté;21;1;18;182;Collonges-lès-Bévy;94;1;95
27;Bourgogne-Franche-Comté;21;2;15;183;Collonges-lès-Premières;896;19;915
27;Bourgogne-Franche-Comté;21;1;01;184;Colombier;64;0;64
27;Bourgogne-Franche-Comté;21;1;17;185;Combertault;553;21;574
27;Bourgogne-Franche-Comté;21;1;20;186;Comblanchien;637;17;654
27;Bourgogne-Franche-Comté;21;1;01;187;Commarin;123;4;127
27;Bourgogne-Franche-Comté;21;1;17;189;Corberon;449;7;456
27;Bourgogne-Franche-Comté;21;1;17;190;Corcelles-les-Arts;462;18;480
27;Bourgogne-Franche-Comté;21;1;20;191;Corcelles-lès-Cîteaux;811;14;825
27;Bourgogne-Franche-Comté;21;2;13;192;Corcelles-les-Monts;640;10;650
27;Bourgogne-Franche-Comté;21;1;17;193;Corgengoux;368;16;384
27;Bourgogne-Franche-Comté;21;1;20;194;Corgoloin;906;12;918
27;Bourgogne-Franche-Comté;21;1;01;195;Cormot-Vauchignon;210;4;214
27;Bourgogne-Franche-Comté;21;1;17;196;Corpeau;968;15;983
27;Bourgogne-Franche-Comté;21;3;19;197;Corpoyer-la-Chapelle;29;0;29
27;Bourgogne-Franche-Comté;21;3;22;198;Corrombles;246;3;249
27;Bourgogne-Franche-Comté;21;3;22;199;Corsaint;160;2;162
27;Bourgogne-Franche-Comté;21;1;18;200;Couchey;1130;24;1154
27;Bourgogne-Franche-Comté;21;3;05;201;Coulmier-le-Sec;260;6;266
27;Bourgogne-Franche-Comté;21;3;05;202;Courban;168;1;169
27;Bourgogne-Franche-Comté;21;3;22;203;Courcelles-Frémoy;124;2;126
27;Bourgogne-Franche-Comté;21;3;19;204;Courcelles-lès-Montbard;80;1;81
27;Bourgogne-Franche-Comté;21;3;22;205;Courcelles-lès-Semur;245;6;251
27;Bourgogne-Franche-Comté;21;2;16;207;Courlon;81;4;85
27;Bourgogne-Franche-Comté;21;2;16;208;Courtivron;168;3;171
27;Bourgogne-Franche-Comté;21;2;21;209;Couternon;1889;39;1928
27;Bourgogne-Franche-Comté;21;1;01;210;Créancey;528;6;534
27;Bourgogne-Franche-Comté;21;2;16;211;Crécey-sur-Tille;142;2;144
27;Bourgogne-Franche-Comté;21;3;19;212;Crépand;324;4;328
27;Bourgogne-Franche-Comté;21;2;07;213;Crimolois;807;11;818
27;Bourgogne-Franche-Comté;21;1;01;214;Crugey;175;5;180
27;Bourgogne-Franche-Comté;21;2;21;215;Cuiserey;182;1;183
27;Bourgogne-Franche-Comté;21;1;01;216;Culètre;99;2;101
27;Bourgogne-Franche-Comté;21;1;18;217;Curley;135;4;139
27;Bourgogne-Franche-Comté;21;2;14;218;Curtil-Saint-Seine;117;0;117
27;Bourgogne-Franche-Comté;21;1;18;219;Curtil-Vergy;136;0;136
27;Bourgogne-Franche-Comté;21;2;16;220;Cussey-les-Forges;138;3;141
27;Bourgogne-Franche-Comté;21;1;01;221;Cussy-la-Colonne;42;2;44
27;Bourgogne-Franche-Comté;21;1;01;222;Cussy-le-Châtel;109;3;112
27;Bourgogne-Franche-Comté;21;2;14;223;Daix;1471;34;1505
27;Bourgogne-Franche-Comté;21;3;22;224;Dampierre-en-Montagne;73;4;77
27;Bourgogne-Franche-Comté;21;2;21;225;Dampierre-et-Flée;135;2;137
27;Bourgogne-Franche-Comté;21;3;19;226;Darcey;338;11;349
27;Bourgogne-Franche-Comté;21;2;14;227;Darois;493;7;500
27;Bourgogne-Franche-Comté;21;1;18;228;Détain-et-Bruant;141;0;141
27;Bourgogne-Franche-Comté;21;1;01;229;Diancey;84;4;88
27;Bourgogne-Franche-Comté;21;2;16;230;Diénay;376;4;380
27;Bourgogne-Franche-Comté;21;2;99;231;Dijon;156920;3284;160204
27;Bourgogne-Franche-Comté;21;3;22;232;Dompierre-en-Morvan;211;5;216
27;Bourgogne-Franche-Comté;21;2;02;233;Drambon;186;1;187
27;Bourgogne-Franche-Comté;21;2;23;234;Drée;59;3;62
27;Bourgogne-Franche-Comté;21;3;05;235;Duesme;53;1;54
27;Bourgogne-Franche-Comté;21;1;17;236;Ébaty;256;8;264
27;Bourgogne-Franche-Comté;21;3;05;237;Échalot;95;3;98
27;Bourgogne-Franche-Comté;21;2;23;238;Échannay;128;2;130
27;Bourgogne-Franche-Comté;21;1;04;239;Échenon;775;11;786
27;Bourgogne-Franche-Comté;21;2;16;240;Échevannes;299;2;301
27;Bourgogne-Franche-Comté;21;1;17;241;Échevronne;284;13;297
27;Bourgogne-Franche-Comté;21;2;15;242;Échigey;288;3;291
27;Bourgogne-Franche-Comté;21;1;01;243;Écutigny;79;5;84
27;Bourgogne-Franche-Comté;21;1;01;244;Éguilly;62;0;62
27;Bourgogne-Franche-Comté;21;2;16;245;Épagny;313;3;316
27;Bourgogne-Franche-Comté;21;1;20;246;Épernay-sous-Gevrey;183;3;186
27;Bourgogne-Franche-Comté;21;3;22;247;Époisses;796;14;810
27;Bourgogne-Franche-Comté;21;3;19;248;Éringes;68;0;68
27;Bourgogne-Franche-Comté;21;1;04;249;Esbarres;690;20;710
27;Bourgogne-Franche-Comté;21;3;05;250;Essarois;91;2;93
27;Bourgogne-Franche-Comté;21;1;01;251;Essey;275;27;302
27;Bourgogne-Franche-Comté;21;3;19;252;Étais;85;2;87
27;Bourgogne-Franche-Comté;21;3;05;253;Étalante;156;5;161
27;Bourgogne-Franche-Comté;21;1;18;254;L' Étang-Vergy;213;12;225
27;Bourgogne-Franche-Comté;21;2;14;255;Étaules;300;3;303
27;Bourgogne-Franche-Comté;21;2;02;256;Étevaux;315;7;322
27;Bourgogne-Franche-Comté;21;3;05;257;Étormay;67;5;72
27;Bourgogne-Franche-Comté;21;3;05;258;Étrochey;226;3;229
27;Bourgogne-Franche-Comté;21;3;19;259;Fain-lès-Montbard;300;6;306
27;Bourgogne-Franche-Comté;21;3;19;260;Fain-lès-Moutiers;155;0;155
27;Bourgogne-Franche-Comté;21;2;15;261;Fauverney;625;27;652
27;Bourgogne-Franche-Comté;21;3;05;262;Faverolles-lès-Lucey;31;0;31
27;Bourgogne-Franche-Comté;21;2;18;263;Fénay;1616;43;1659
27;Bourgogne-Franche-Comté;21;1;01;264;Le Fête;48;0;48
27;Bourgogne-Franche-Comté;21;1;18;265;Fixin;754;21;775
27;Bourgogne-Franche-Comté;21;2;14;266;Flacey;185;1;186
27;Bourgogne-Franche-Comté;21;1;20;267;Flagey-Echézeaux;473;13;486
27;Bourgogne-Franche-Comté;21;2;02;268;Flagey-lès-Auxonne;194;3;197
27;Bourgogne-Franche-Comté;21;2;02;269;Flammerans;428;9;437
27;Bourgogne-Franche-Comté;21;2;13;270;Flavignerot;184;6;190
27;Bourgogne-Franche-Comté;21;3;19;271;Flavigny-sur-Ozerain;302;7;309
27;Bourgogne-Franche-Comté;21;2;23;273;Fleurey-sur-Ouche;1326;24;1350
27;Bourgogne-Franche-Comté;21;1;01;274;Foissy;165;3;168
27;Bourgogne-Franche-Comté;21;2;16;275;Foncegrive;135;3;138
27;Bourgogne-Franche-Comté;21;2;21;277;Fontaine-Française;893;19;912
27;Bourgogne-Franche-Comté;21;2;14;278;Fontaine-lès-Dijon;8888;184;9072
27;Bourgogne-Franche-Comté;21;3;05;276;Fontaines-en-Duesmois;120;4;124
27;Bourgogne-Franche-Comté;21;3;19;279;Fontaines-les-Sèches;26;1;27
27;Bourgogne-Franche-Comté;21;3;22;280;Fontangy;139;6;145
27;Bourgogne-Franche-Comté;21;2;21;281;Fontenelle;165;2;167
27;Bourgogne-Franche-Comté;21;3;22;282;Forléans;103;2;105
27;Bourgogne-Franche-Comté;21;2;16;283;Fraignot-et-Vesvrotte;62;1;63
27;Bourgogne-Franche-Comté;21;2;16;284;Francheville;285;4;289
27;Bourgogne-Franche-Comté;21;1;04;285;Franxault;476;6;482
27;Bourgogne-Franche-Comté;21;2;16;286;Frénois;85;2;87
27;Bourgogne-Franche-Comté;21;3;19;287;Fresnes;168;5;173
27;Bourgogne-Franche-Comté;21;3;19;288;Frôlois;167;1;168
27;Bourgogne-Franche-Comté;21;1;20;289;Fussey;118;7;125
27;Bourgogne-Franche-Comté;21;2;16;290;Gemeaux;872;11;883
27;Bourgogne-Franche-Comté;21;3;22;291;Genay;374;10;384
27;Bourgogne-Franche-Comté;21;2;15;292;Genlis;5315;71;5386
27;Bourgogne-Franche-Comté;21;2;23;293;Gergueil;117;0;117
27;Bourgogne-Franche-Comté;21;1;20;294;Gerland;431;5;436
27;Bourgogne-Franche-Comté;21;1;18;295;Gevrey-Chambertin;3087;40;3127
27;Bourgogne-Franche-Comté;21;3;05;296;Gevrolles;178;1;179
27;Bourgogne-Franche-Comté;21;1;20;297;Gilly-lès-Cîteaux;705;6;711
27;Bourgogne-Franche-Comté;21;3;22;298;Gissey-le-Vieil;113;3;116
27;Bourgogne-Franche-Comté;21;3;19;299;Gissey-sous-Flavigny;88;1;89
27;Bourgogne-Franche-Comté;21;2;23;300;Gissey-sur-Ouche;354;9;363
27;Bourgogne-Franche-Comté;21;1;04;301;Glanon;248;2;250
27;Bourgogne-Franche-Comté;21;3;05;302;Gomméville;133;2;135
27;Bourgogne-Franche-Comté;21;3;05;303;Les Goulles;12;0;12
27;Bourgogne-Franche-Comté;21;2;16;304;Grancey-le-Château-Neuvelle;252;9;261
27;Bourgogne-Franche-Comté;21;3;05;305;Grancey-sur-Ource;200;1;201
27;Bourgogne-Franche-Comté;21;2;23;306;Grenant-lès-Sombernon;212;3;215
27;Bourgogne-Franche-Comté;21;3;19;307;Grésigny-Sainte-Reine;142;2;144
27;Bourgogne-Franche-Comté;21;3;19;308;Grignon;207;12;219
27;Bourgogne-Franche-Comté;21;3;05;309;Griselles;89;3;92
27;Bourgogne-Franche-Comté;21;2;23;310;Grosbois-en-Montagne;108;2;110
27;Bourgogne-Franche-Comté;21;1;04;311;Grosbois-lès-Tichey;77;1;78
27;Bourgogne-Franche-Comté;21;3;05;312;Gurgy-la-Ville;33;4;37
27;Bourgogne-Franche-Comté;21;3;05;313;Gurgy-le-Château;44;0;44
27;Bourgogne-Franche-Comté;21;3;19;314;Hauteroche;80;2;82
27;Bourgogne-Franche-Comté;21;2;14;315;Hauteville-lès-Dijon;1219;16;1235
27;Bourgogne-Franche-Comté;21;2;02;316;Heuilley-sur-Saône;333;5;338
27;Bourgogne-Franche-Comté;21;2;16;317;Is-sur-Tille;4402;56;4458
27;Bourgogne-Franche-Comté;21;2;15;319;Izeure;869;14;883
27;Bourgogne-Franche-Comté;21;2;15;320;Izier;794;14;808
27;Bourgogne-Franche-Comté;21;3;19;321;Jailly-les-Moulins;82;2;84
27;Bourgogne-Franche-Comté;21;1;04;322;Jallanges;323;14;337
27;Bourgogne-Franche-Comté;21;2;21;323;Jancigny;141;3;144
27;Bourgogne-Franche-Comté;21;3;22;324;Jeux-lès-Bard;52;1;53
27;Bourgogne-Franche-Comté;21;1;01;325;Jouey;185;2;187
27;Bourgogne-Franche-Comté;21;3;05;326;Jours-lès-Baigneux;76;4;80
27;Bourgogne-Franche-Comté;21;3;22;328;Juillenay;43;3;46
27;Bourgogne-Franche-Comté;21;3;22;329;Juilly;47;3;50
27;Bourgogne-Franche-Comté;21;2;15;330;Labergement-Foigney;368;12;380
27;Bourgogne-Franche-Comté;21;2;02;331;Labergement-lès-Auxonne;328;3;331
27;Bourgogne-Franche-Comté;21;1;04;332;Labergement-lès-Seurre;995;22;1017
27;Bourgogne-Franche-Comté;21;1;04;333;Labruyère;227;5;232
27;Bourgogne-Franche-Comté;21;1;01;334;Lacanche;561;10;571
27;Bourgogne-Franche-Comté;21;3;22;335;Lacour-d'Arcenay;122;3;125
27;Bourgogne-Franche-Comté;21;1;17;606;Ladoix-Serrigny;1834;31;1865
27;Bourgogne-Franche-Comté;21;3;05;336;Laignes;692;20;712
27;Bourgogne-Franche-Comté;21;2;02;337;Lamarche-sur-Saône;1341;13;1354
27;Bourgogne-Franche-Comté;21;2;16;338;Lamargelle;158;3;161
27;Bourgogne-Franche-Comté;21;2;23;339;Lantenay;510;16;526
27;Bourgogne-Franche-Comté;21;1;04;340;Lanthes;264;4;268
27;Bourgogne-Franche-Comté;21;3;22;341;Lantilly;109;3;112
27;Bourgogne-Franche-Comté;21;1;04;342;Laperrière-sur-Saône;436;9;445
27;Bourgogne-Franche-Comté;21;3;05;343;Larrey;92;2;94
27;Bourgogne-Franche-Comté;21;1;04;344;Lechâtelet;225;5;230
27;Bourgogne-Franche-Comté;21;2;16;345;Léry;196;3;199
27;Bourgogne-Franche-Comté;21;3;05;346;Leuglay;306;3;309
27;Bourgogne-Franche-Comté;21;1;17;347;Levernois;327;18;345
27;Bourgogne-Franche-Comté;21;2;21;348;Licey-sur-Vingeanne;104;1;105
27;Bourgogne-Franche-Comté;21;1;01;349;Liernais;514;27;541
27;Bourgogne-Franche-Comté;21;3;05;350;Lignerolles;50;1;51
27;Bourgogne-Franche-Comté;21;2;15;351;Longchamp;1168;121;1289
27;Bourgogne-Franche-Comté;21;2;15;352;Longeault-Pluvault;1126;17;1143
27;Bourgogne-Franche-Comté;21;2;15;353;Longecourt-en-Plaine;1228;25;1253
27;Bourgogne-Franche-Comté;21;1;01;354;Longecourt-lès-Culêtre;50;2;52
27;Bourgogne-Franche-Comté;21;2;18;355;Longvic;8604;135;8739
27;Bourgogne-Franche-Comté;21;1;04;356;Losne;1606;36;1642
27;Bourgogne-Franche-Comté;21;3;05;357;Louesme;106;3;109
27;Bourgogne-Franche-Comté;21;3;19;358;Lucenay-le-Duc;187;3;190
27;Bourgogne-Franche-Comté;21;3;05;359;Lucey;60;1;61
27;Bourgogne-Franche-Comté;21;1;01;360;Lusigny-sur-Ouche;111;0;111
27;Bourgogne-Franche-Comté;21;2;16;361;Lux;524;11;535
27;Bourgogne-Franche-Comté;21;1;01;362;Maconge;132;3;135
27;Bourgogne-Franche-Comté;21;1;01;363;Magnien;315;6;321
27;Bourgogne-Franche-Comté;21;3;22;365;Magny-la-Ville;80;0;80
27;Bourgogne-Franche-Comté;21;3;05;364;Magny-Lambert;86;6;92
27;Bourgogne-Franche-Comté;21;1;04;366;Magny-lès-Aubigny;207;3;210
27;Bourgogne-Franche-Comté;21;1;20;368;Magny-lès-Villers;243;12;255
27;Bourgogne-Franche-Comté;21;2;02;367;Magny-Montarlot;265;2;267
27;Bourgogne-Franche-Comté;21;2;21;369;Magny-Saint-Médard;311;4;315
27;Bourgogne-Franche-Comté;21;2;07;370;Magny-sur-Tille;868;17;885
27;Bourgogne-Franche-Comté;21;2;02;371;Les Maillys;820;19;839
27;Bourgogne-Franche-Comté;21;3;05;372;Maisey-le-Duc;85;5;90
27;Bourgogne-Franche-Comté;21;2;23;373;Mâlain;747;15;762
27;Bourgogne-Franche-Comté;21;1;01;374;Maligny;212;7;219
27;Bourgogne-Franche-Comté;21;1;01;375;Manlay;170;3;173
27;Bourgogne-Franche-Comté;21;2;02;376;Marandeuil;113;1;114
27;Bourgogne-Franche-Comté;21;3;22;377;Marcellois;49;0;49
27;Bourgogne-Franche-Comté;21;3;05;378;Marcenay;98;2;100
27;Bourgogne-Franche-Comté;21;1;01;379;Marcheseuil;156;1;157
27;Bourgogne-Franche-Comté;21;3;22;380;Marcigny-sous-Thil;61;2;63
27;Bourgogne-Franche-Comté;21;3;22;381;Marcilly-et-Dracy;99;4;103
27;Bourgogne-Franche-Comté;21;1;01;382;Marcilly-Ogny;195;3;198
27;Bourgogne-Franche-Comté;21;2;16;383;Marcilly-sur-Tille;1666;20;1686
27;Bourgogne-Franche-Comté;21;1;20;384;Marey-lès-Fussey;56;5;61
27;Bourgogne-Franche-Comté;21;2;16;385;Marey-sur-Tille;323;13;336
27;Bourgogne-Franche-Comté;21;3;19;386;Marigny-le-Cahouët;319;12;331
27;Bourgogne-Franche-Comté;21;1;17;387;Marigny-lès-Reullée;216;5;221
27;Bourgogne-Franche-Comté;21;2;15;388;Marliens;595;3;598
27;Bourgogne-Franche-Comté;21;3;19;389;Marmagne;212;1;213
27;Bourgogne-Franche-Comté;21;2;06;390;Marsannay-la-Côte;5348;77;5425
27;Bourgogne-Franche-Comté;21;2;16;391;Marsannay-le-Bois;840;10;850
27;Bourgogne-Franche-Comté;21;1;01;392;Martrois;62;1;63
27;Bourgogne-Franche-Comté;21;3;05;393;Massingy;152;9;161
27;Bourgogne-Franche-Comté;21;3;22;394;Massingy-lès-Semur;163;4;167
27;Bourgogne-Franche-Comté;21;3;22;395;Massingy-lès-Vitteaux;96;1;97
27;Bourgogne-Franche-Comté;21;3;05;396;Mauvilly;68;2;70
27;Bourgogne-Franche-Comté;21;1;17;397;Mavilly-Mandelot;178;3;181
27;Bourgogne-Franche-Comté;21;2;02;398;Maxilly-sur-Saône;348;8;356
27;Bourgogne-Franche-Comté;21;1;01;399;Meilly-sur-Rouvres;197;2;199
27;Bourgogne-Franche-Comté;21;2;16;400;Le Meix;50;0;50
27;Bourgogne-Franche-Comté;21;1;17;401;Meloisey;326;6;332
27;Bourgogne-Franche-Comté;21;3;05;402;Menesble;10;0;10
27;Bourgogne-Franche-Comté;21;1;01;403;Ménessaire;86;1;87
27;Bourgogne-Franche-Comté;21;3;19;404;Ménétreux-le-Pitois;427;16;443
27;Bourgogne-Franche-Comté;21;1;17;405;Merceuil;812;22;834
27;Bourgogne-Franche-Comté;21;2;23;406;Mesmont;247;2;249
27;Bourgogne-Franche-Comté;21;1;18;407;Messanges;236;11;247
27;Bourgogne-Franche-Comté;21;2;14;408;Messigny-et-Vantoux;1660;30;1690
27;Bourgogne-Franche-Comté;21;1;20;409;Meuilley;465;13;478
27;Bourgogne-Franche-Comté;21;3;05;410;Meulson;33;0;33
27;Bourgogne-Franche-Comté;21;1;17;411;Meursanges;557;20;577
27;Bourgogne-Franche-Comté;21;1;17;412;Meursault;1425;47;1472
27;Bourgogne-Franche-Comté;21;3;22;413;Millery;386;15;401
27;Bourgogne-Franche-Comté;21;1;01;414;Mimeure;309;10;319
27;Bourgogne-Franche-Comté;21;3;05;415;Minot;180;5;185
27;Bourgogne-Franche-Comté;21;2;21;416;Mirebeau-sur-Bèze;2083;29;2112
27;Bourgogne-Franche-Comté;21;3;22;417;Missery;105;0;105
27;Bourgogne-Franche-Comté;21;3;05;418;Moitron;62;4;66
27;Bourgogne-Franche-Comté;21;3;05;419;Molesme;265;4;269
27;Bourgogne-Franche-Comté;21;1;01;420;Molinot;158;4;162
27;Bourgogne-Franche-Comté;21;2;16;421;Moloy;233;3;236
27;Bourgogne-Franche-Comté;21;3;22;422;Molphey;130;6;136
27;Bourgogne-Franche-Comté;21;1;01;441;Mont-Saint-Jean;241;7;248
27;Bourgogne-Franche-Comté;21;1;17;423;Montagny-lès-Beaune;682;18;700
27;Bourgogne-Franche-Comté;21;1;04;424;Montagny-lès-Seurre;104;2;106
27;Bourgogne-Franche-Comté;21;3;19;425;Montbard;5160;122;5282
27;Bourgogne-Franche-Comté;21;3;22;426;Montberthault;211;3;214
27;Bourgogne-Franche-Comté;21;1;01;427;Montceau-et-Écharnant;180;4;184
27;Bourgogne-Franche-Comté;21;1;17;428;Monthelie;162;5;167
27;Bourgogne-Franche-Comté;21;3;19;429;Montigny-Montfort;300;6;306
27;Bourgogne-Franche-Comté;21;2;21;433;Montigny-Mornay-Villeneuve-sur-Vingeanne;394;4;398
27;Bourgogne-Franche-Comté;21;3;22;430;Montigny-Saint-Barthélemy;86;2;88
27;Bourgogne-Franche-Comté;21;3;22;431;Montigny-sur-Armançon;152;5;157
27;Bourgogne-Franche-Comté;21;3;05;432;Montigny-sur-Aube;264;4;268
27;Bourgogne-Franche-Comté;21;3;22;434;Montlay-en-Auxois;185;1;186
27;Bourgogne-Franche-Comté;21;3;05;435;Montliot-et-Courcelles;303;6;309
27;Bourgogne-Franche-Comté;21;1;04;436;Montmain;152;3;155
27;Bourgogne-Franche-Comté;21;2;02;437;Montmançon;248;5;253
27;Bourgogne-Franche-Comté;21;3;05;438;Montmoyen;78;3;81
27;Bourgogne-Franche-Comté;21;2;23;439;Montoillot;80;0;80
27;Bourgogne-Franche-Comté;21;1;04;440;Montot;197;6;203
27;Bourgogne-Franche-Comté;21;1;18;442;Morey-Saint-Denis;666;12;678
27;Bourgogne-Franche-Comté;21;3;05;444;Mosson;72;0;72
27;Bourgogne-Franche-Comté;21;3;22;445;La Motte-Ternant;148;2;150
27;Bourgogne-Franche-Comté;21;3;19;446;Moutiers-Saint-Jean;256;5;261
27;Bourgogne-Franche-Comté;21;1;01;447;Musigny;83;0;83
27;Bourgogne-Franche-Comté;21;3;19;448;Mussy-la-Fosse;86;1;87
27;Bourgogne-Franche-Comté;21;3;22;449;Nan-sous-Thil;185;3;188
27;Bourgogne-Franche-Comté;21;1;17;450;Nantoux;167;5;172
27;Bourgogne-Franche-Comté;21;3;19;451;Nesle-et-Massoult;75;3;78
27;Bourgogne-Franche-Comté;21;2;07;452;Neuilly-lès-Dijon;1857;17;1874
27;Bourgogne-Franche-Comté;21;3;05;454;Nicey;110;0;110
27;Bourgogne-Franche-Comté;21;3;05;455;Nod-sur-Seine;210;10;220
27;Bourgogne-Franche-Comté;21;3;19;456;Nogent-lès-Montbard;155;8;163
27;Bourgogne-Franche-Comté;21;3;22;457;Noidan;74;5;79
27;Bourgogne-Franche-Comté;21;1;20;458;Noiron-sous-Gevrey;1106;13;1119
27;Bourgogne-Franche-Comté;21;2;21;459;Noiron-sur-Bèze;238;5;243
27;Bourgogne-Franche-Comté;21;3;05;460;Noiron-sur-Seine;72;1;73
27;Bourgogne-Franche-Comté;21;1;01;461;Nolay;1465;21;1486
27;Bourgogne-Franche-Comté;21;2;14;462;Norges-la-Ville;949;17;966
27;Bourgogne-Franche-Comté;21;3;22;463;Normier;47;1;48
27;Bourgogne-Franche-Comté;21;1;20;464;Nuits-Saint-Georges;5481;96;5577
27;Bourgogne-Franche-Comté;21;3;05;465;Obtrée;76;3;79
27;Bourgogne-Franche-Comté;21;3;05;466;Oigny;36;2;38
27;Bourgogne-Franche-Comté;21;2;21;467;Oisilly;129;4;133
27;Bourgogne-Franche-Comté;21;2;21;468;Orain;94;1;95
27;Bourgogne-Franche-Comté;21;2;14;469;Orgeux;465;14;479
27;Bourgogne-Franche-Comté;21;3;05;470;Origny;51;3;54
27;Bourgogne-Franche-Comté;21;3;05;471;Orret;16;0;16
27;Bourgogne-Franche-Comté;21;2;16;472;Orville;171;1;172
27;Bourgogne-Franche-Comté;21;2;18;473;Ouges;1523;10;1533
27;Bourgogne-Franche-Comté;21;1;04;474;Pagny-la-Ville;411;10;421
27;Bourgogne-Franche-Comté;21;1;04;475;Pagny-le-Château;514;9;523
27;Bourgogne-Franche-Comté;21;1;01;476;Painblanc;161;5;166
27;Bourgogne-Franche-Comté;21;2;14;477;Panges;88;2;90
27;Bourgogne-Franche-Comté;21;2;23;478;Pasques;289;5;294
27;Bourgogne-Franche-Comté;21;2;16;479;Pellerey;105;0;105
27;Bourgogne-Franche-Comté;21;1;17;480;Pernand-Vergelesses;244;9;253
27;Bourgogne-Franche-Comté;21;2;18;481;Perrigny-lès-Dijon;1915;30;1945
27;Bourgogne-Franche-Comté;21;2;02;482;Perrigny-sur-l'Ognon;646;13;659
27;Bourgogne-Franche-Comté;21;2;16;483;Pichanges;293;5;298
27;Bourgogne-Franche-Comté;21;3;19;484;Planay;67;5;72
27;Bourgogne-Franche-Comté;21;2;23;485;Plombières-lès-Dijon;2556;46;2602
27;Bourgogne-Franche-Comté;21;2;15;487;Pluvet;412;4;416
27;Bourgogne-Franche-Comté;21;3;05;488;Poinçon-lès-Larrey;194;3;197
27;Bourgogne-Franche-Comté;21;2;16;489;Poiseul-la-Grange;58;4;62
27;Bourgogne-Franche-Comté;21;3;05;490;Poiseul-la-Ville-et-Laperrière;160;6;166
27;Bourgogne-Franche-Comté;21;2;16;491;Poiseul-lès-Saulx;67;1;68
27;Bourgogne-Franche-Comté;21;1;17;492;Pommard;500;13;513
27;Bourgogne-Franche-Comté;21;2;02;493;Poncey-lès-Athée;581;7;588
27;Bourgogne-Franche-Comté;21;2;16;494;Poncey-sur-l'Ignon;78;0;78
27;Bourgogne-Franche-Comté;21;2;02;495;Pont;141;1;142
27;Bourgogne-Franche-Comté;21;3;22;497;Pont-et-Massène;175;15;190
27;Bourgogne-Franche-Comté;21;2;02;496;Pontailler-sur-Saône;1308;22;1330
27;Bourgogne-Franche-Comté;21;3;22;498;Posanges;58;2;60
27;Bourgogne-Franche-Comté;21;3;05;499;Pothières;207;4;211
27;Bourgogne-Franche-Comté;21;3;19;500;Pouillenay;555;9;564
27;Bourgogne-Franche-Comté;21;1;01;501;Pouilly-en-Auxois;1481;120;1601
27;Bourgogne-Franche-Comté;21;1;04;502;Pouilly-sur-Saône;615;7;622
27;Bourgogne-Franche-Comté;21;2;21;503;Pouilly-sur-Vingeanne;121;4;125
27;Bourgogne-Franche-Comté;21;2;23;504;Prâlon;89;3;92
27;Bourgogne-Franche-Comté;21;3;22;505;Précy-sous-Thil;714;10;724
27;Bourgogne-Franche-Comté;21;1;20;506;Premeaux-Prissey;393;5;398
27;Bourgogne-Franche-Comté;21;2;15;507;Premières;141;1;142
27;Bourgogne-Franche-Comté;21;2;14;508;Prenois;419;8;427
27;Bourgogne-Franche-Comté;21;3;05;510;Prusly-sur-Ource;159;1;160
27;Bourgogne-Franche-Comté;21;3;05;511;Puits;122;5;127
27;Bourgogne-Franche-Comté;21;1;17;512;Puligny-Montrachet;389;11;400
27;Bourgogne-Franche-Comté;21;3;05;514;Quemigny-sur-Seine;98;3;101
27;Bourgogne-Franche-Comté;21;2;07;515;Quetigny;9557;378;9935
27;Bourgogne-Franche-Comté;21;3;19;516;Quincerot;76;4;80
27;Bourgogne-Franche-Comté;21;1;20;517;Quincey;512;11;523
27;Bourgogne-Franche-Comté;21;3;19;518;Quincy-le-Vicomte;211;5;216
27;Bourgogne-Franche-Comté;21;3;05;519;Recey-sur-Ource;363;9;372
27;Bourgogne-Franche-Comté;21;2;23;520;Remilly-en-Montagne;149;0;149
27;Bourgogne-Franche-Comté;21;2;21;521;Remilly-sur-Tille;878;14;892
27;Bourgogne-Franche-Comté;21;2;21;522;Renève;438;5;443
27;Bourgogne-Franche-Comté;21;1;18;523;Reulle-Vergy;134;4;138
27;Bourgogne-Franche-Comté;21;3;05;524;Riel-les-Eaux;94;2;96
27;Bourgogne-Franche-Comté;21;3;22;525;La Roche-en-Brenil;869;11;880
27;Bourgogne-Franche-Comté;21;3;19;528;La Roche-Vanneau;146;2;148
27;Bourgogne-Franche-Comté;21;3;05;526;Rochefort-sur-Brévon;39;1;40
27;Bourgogne-Franche-Comté;21;1;01;527;La Rochepot;291;8;299
27;Bourgogne-Franche-Comté;21;3;22;529;Roilly;49;1;50
27;Bourgogne-Franche-Comté;21;3;19;530;Rougemont;156;1;157
27;Bourgogne-Franche-Comté;21;3;22;531;Rouvray;492;6;498
27;Bourgogne-Franche-Comté;21;2;15;532;Rouvres-en-Plaine;1128;10;1138
27;Bourgogne-Franche-Comté;21;1;01;533;Rouvres-sous-Meilly;89;3;92
27;Bourgogne-Franche-Comté;21;1;17;534;Ruffey-lès-Beaune;714;49;763
27;Bourgogne-Franche-Comté;21;2;14;535;Ruffey-lès-Echirey;1309;10;1319
27;Bourgogne-Franche-Comté;21;2;16;536;Sacquenay;286;11;297
27;Bourgogne-Franche-Comté;21;3;22;537;Saffres;115;2;117
27;Bourgogne-Franche-Comté;21;3;22;538;Saint-Andeux;131;4;135
27;Bourgogne-Franche-Comté;21;2;23;539;Saint-Anthot;59;1;60
27;Bourgogne-Franche-Comté;21;2;21;540;Saint-Apollinaire;7463;104;7567
27;Bourgogne-Franche-Comté;21;1;17;541;Saint-Aubin;223;8;231
27;Bourgogne-Franche-Comté;21;1;20;542;Saint-Bernard;453;0;453
27;Bourgogne-Franche-Comté;21;3;05;543;Saint-Broing-les-Moines;195;8;203
27;Bourgogne-Franche-Comté;21;3;22;546;Saint-Didier;207;4;211
27;Bourgogne-Franche-Comté;21;3;22;547;Saint-Euphrône;178;9;187
27;Bourgogne-Franche-Comté;21;3;22;548;Saint-Germain-de-Modéon;172;3;175
27;Bourgogne-Franche-Comté;21;3;05;549;Saint-Germain-le-Rocheux;80;4;84
27;Bourgogne-Franche-Comté;21;3;19;550;Saint-Germain-lès-Senailly;125;5;130
27;Bourgogne-Franche-Comté;21;3;22;552;Saint-Hélier;35;1;36
27;Bourgogne-Franche-Comté;21;2;23;553;Saint-Jean-de-Bœuf;112;3;115
27;Bourgogne-Franche-Comté;21;1;04;554;Saint-Jean-de-Losne;1092;6;1098
27;Bourgogne-Franche-Comté;21;2;14;555;Saint-Julien;1477;20;1497
27;Bourgogne-Franche-Comté;21;2;02;556;Saint-Léger-Triey;252;3;255
27;Bourgogne-Franche-Comté;21;3;05;557;Saint-Marc-sur-Seine;107;3;110
27;Bourgogne-Franche-Comté;21;1;01;560;Saint-Martin-de-la-Mer;296;2;298
27;Bourgogne-Franche-Comté;21;2;14;561;Saint-Martin-du-Mont;435;9;444
27;Bourgogne-Franche-Comté;21;2;21;562;Saint-Maurice-sur-Vingeanne;213;6;219
27;Bourgogne-Franche-Comté;21;3;22;563;Saint-Mesmin;128;1;129
27;Bourgogne-Franche-Comté;21;1;20;564;Saint-Nicolas-lès-Cîteaux;427;14;441
27;Bourgogne-Franche-Comté;21;1;20;565;Saint-Philibert;473;8;481
27;Bourgogne-Franche-Comté;21;1;01;566;Saint-Pierre-en-Vaux;148;2;150
27;Bourgogne-Franche-Comté;21;1;01;567;Saint-Prix-lès-Arnay;227;6;233
27;Bourgogne-Franche-Comté;21;3;19;568;Saint-Rémy;702;11;713
27;Bourgogne-Franche-Comté;21;1;17;569;Saint-Romain;220;5;225
27;Bourgogne-Franche-Comté;21;2;02;571;Saint-Sauveur;251;2;253
27;Bourgogne-Franche-Comté;21;1;04;572;Saint-Seine-en-Bâche;408;6;414
27;Bourgogne-Franche-Comté;21;2;14;573;Saint-Seine-l'Abbaye;375;3;378
27;Bourgogne-Franche-Comté;21;2;21;574;Saint-Seine-sur-Vingeanne;393;14;407
27;Bourgogne-Franche-Comté;21;1;04;575;Saint-Symphorien-sur-Saône;350;5;355
27;Bourgogne-Franche-Comté;21;3;22;576;Saint-Thibault;164;1;165
27;Bourgogne-Franche-Comté;21;1;04;577;Saint-Usage;1345;25;1370
27;Bourgogne-Franche-Comté;21;2;23;578;Saint-Victor-sur-Ouche;303;4;307
27;Bourgogne-Franche-Comté;21;3;22;544;Sainte-Colombe-en-Auxois;57;5;62
27;Bourgogne-Franche-Comté;21;3;05;545;Sainte-Colombe-sur-Seine;943;15;958
27;Bourgogne-Franche-Comté;21;1;17;558;Sainte-Marie-la-Blanche;882;31;913
27;Bourgogne-Franche-Comté;21;2;23;559;Sainte-Marie-sur-Ouche;693;11;704
27;Bourgogne-Franche-Comté;21;1;01;570;Sainte-Sabine;174;15;189
27;Bourgogne-Franche-Comté;21;2;16;579;Salives;206;6;212
27;Bourgogne-Franche-Comté;21;3;19;580;Salmaise;137;2;139
27;Bourgogne-Franche-Comté;21;1;04;581;Samerey;155;2;157
27;Bourgogne-Franche-Comté;21;1;17;582;Santenay;892;12;904
27;Bourgogne-Franche-Comté;21;1;01;583;Santosse;51;2;53
27;Bourgogne-Franche-Comté;21;3;22;584;Saulieu;2413;105;2518
27;Bourgogne-Franche-Comté;21;1;20;585;Saulon-la-Chapelle;968;15;983
27;Bourgogne-Franche-Comté;21;1;20;586;Saulon-la-Rue;703;10;713
27;Bourgogne-Franche-Comté;21;2;16;587;Saulx-le-Duc;239;6;245
27;Bourgogne-Franche-Comté;21;1;01;588;Saussey;72;2;74
27;Bourgogne-Franche-Comté;21;2;14;589;Saussy;103;1;104
27;Bourgogne-Franche-Comté;21;2;14;591;Savigny-le-Sec;844;14;858
27;Bourgogne-Franche-Comté;21;1;17;590;Savigny-lès-Beaune;1305;41;1346
27;Bourgogne-Franche-Comté;21;2;23;592;Savigny-sous-Mâlain;223;7;230
27;Bourgogne-Franche-Comté;21;1;01;593;Savilly;80;3;83
27;Bourgogne-Franche-Comté;21;3;05;594;Savoisy;200;3;203
27;Bourgogne-Franche-Comté;21;2;21;595;Savolles;161;4;165
27;Bourgogne-Franche-Comté;21;1;20;596;Savouges;376;6;382
27;Bourgogne-Franche-Comté;21;1;18;597;Segrois;46;1;47
27;Bourgogne-Franche-Comté;21;3;19;598;Seigny;172;2;174
27;Bourgogne-Franche-Comté;21;2;16;599;Selongey;2403;33;2436
27;Bourgogne-Franche-Comté;21;1;01;600;Semarey;122;1;123
27;Bourgogne-Franche-Comté;21;1;18;601;Semezanges;92;4;96
27;Bourgogne-Franche-Comté;21;3;05;602;Semond;23;0;23
27;Bourgogne-Franche-Comté;21;3;22;603;Semur-en-Auxois;4139;353;4492
27;Bourgogne-Franche-Comté;21;3;19;604;Senailly;139;4;143
27;Bourgogne-Franche-Comté;21;2;07;605;Sennecey-lès-Dijon;2041;53;2094
27;Bourgogne-Franche-Comté;21;1;04;607;Seurre;2353;23;2376
27;Bourgogne-Franche-Comté;21;3;22;608;Sincey-lès-Rouvray;101;4;105
27;Bourgogne-Franche-Comté;21;2;02;609;Soirans;485;7;492
27;Bourgogne-Franche-Comté;21;2;02;610;Soissons-sur-Nacey;360;7;367
27;Bourgogne-Franche-Comté;21;2;23;611;Sombernon;926;12;938
27;Bourgogne-Franche-Comté;21;3;22;612;Souhey;91;0;91
27;Bourgogne-Franche-Comté;21;3;19;084;Source-Seine;63;4;67
27;Bourgogne-Franche-Comté;21;3;22;613;Soussey-sur-Brionne;153;8;161
27;Bourgogne-Franche-Comté;21;2;16;614;Spoy;392;4;396
27;Bourgogne-Franche-Comté;21;1;01;615;Sussey;248;8;256
27;Bourgogne-Franche-Comté;21;1;17;616;Tailly;177;8;185
27;Bourgogne-Franche-Comté;21;2;23;617;Talant;11689;235;11924
27;Bourgogne-Franche-Comté;21;2;02;618;Talmay;576;6;582
27;Bourgogne-Franche-Comté;21;2;21;619;Tanay;228;4;232
27;Bourgogne-Franche-Comté;21;2;16;620;Tarsul;150;5;155
27;Bourgogne-Franche-Comté;21;2;15;623;Tart;1588;32;1620
27;Bourgogne-Franche-Comté;21;2;15;622;Tart-le-Bas;248;4;252
27;Bourgogne-Franche-Comté;21;2;02;624;Tellecey;141;1;142
27;Bourgogne-Franche-Comté;21;1;18;625;Ternant;83;5;88
27;Bourgogne-Franche-Comté;21;3;05;626;Terrefondrée;62;2;64
27;Bourgogne-Franche-Comté;21;3;19;627;Thenissey;105;10;115
27;Bourgogne-Franche-Comté;21;3;05;628;Thoires;64;0;64
27;Bourgogne-Franche-Comté;21;3;22;629;Thoisy-la-Berchère;309;5;314
27;Bourgogne-Franche-Comté;21;1;01;630;Thoisy-le-Désert;207;1;208
27;Bourgogne-Franche-Comté;21;1;01;631;Thomirey;50;0;50
27;Bourgogne-Franche-Comté;21;2;15;632;Thorey-en-Plaine;1051;29;1080
27;Bourgogne-Franche-Comté;21;3;22;633;Thorey-sous-Charny;179;1;180
27;Bourgogne-Franche-Comté;21;1;01;634;Thorey-sur-Ouche;144;0;144
27;Bourgogne-Franche-Comté;21;3;22;635;Thoste;108;6;114
27;Bourgogne-Franche-Comté;21;1;01;636;Thury;275;8;283
27;Bourgogne-Franche-Comté;21;1;04;637;Tichey;212;3;215
27;Bourgogne-Franche-Comté;21;2;16;638;Til-Châtel;1110;7;1117
27;Bourgogne-Franche-Comté;21;2;02;639;Tillenay;762;16;778
27;Bourgogne-Franche-Comté;21;3;22;640;Torcy-et-Pouligny;204;5;209
27;Bourgogne-Franche-Comté;21;3;19;641;Touillon;466;12;478
27;Bourgogne-Franche-Comté;21;3;22;642;Toutry;442;8;450
27;Bourgogne-Franche-Comté;21;2;02;643;Tréclun;470;3;473
27;Bourgogne-Franche-Comté;21;2;21;644;Trochères;169;4;173
27;Bourgogne-Franche-Comté;21;1;04;645;Trouhans;606;15;621
27;Bourgogne-Franche-Comté;21;2;14;646;Trouhaut;117;3;120
27;Bourgogne-Franche-Comté;21;1;04;647;Trugny;125;1;126
27;Bourgogne-Franche-Comté;21;2;14;648;Turcey;183;1;184
27;Bourgogne-Franche-Comté;21;3;22;649;Uncey-le-Franc;54;0;54
27;Bourgogne-Franche-Comté;21;1;18;650;Urcy;153;1;154
27;Bourgogne-Franche-Comté;21;3;22;272;Le Val-Larrey;264;4;268
27;Bourgogne-Franche-Comté;21;1;01;327;Val-Mont;258;6;264
27;Bourgogne-Franche-Comté;21;2;14;651;Val-Suzon;207;4;211
27;Bourgogne-Franche-Comté;21;1;18;178;Valforêt;320;10;330
27;Bourgogne-Franche-Comté;21;1;01;652;Vandenesse-en-Auxois;302;8;310
27;Bourgogne-Franche-Comté;21;3;05;653;Vannaire;54;2;56
27;Bourgogne-Franche-Comté;21;3;05;655;Vanvey;233;4;237
27;Bourgogne-Franche-Comté;21;2;15;656;Varanges;716;11;727
27;Bourgogne-Franche-Comté;21;2;21;657;Varois-et-Chaignot;1913;48;1961
27;Bourgogne-Franche-Comté;21;2;16;659;Vaux-Saules;168;10;178
27;Bourgogne-Franche-Comté;21;1;01;660;Veilly;41;0;41
27;Bourgogne-Franche-Comté;21;2;23;661;Velars-sur-Ouche;1698;29;1727
27;Bourgogne-Franche-Comté;21;3;22;662;Velogny;35;0;35
27;Bourgogne-Franche-Comté;21;3;19;663;Venarey-les-Laumes;2884;37;2921
27;Bourgogne-Franche-Comté;21;3;19;664;Verdonnet;83;4;87
27;Bourgogne-Franche-Comté;21;2;16;665;Vernois-lès-Vesvres;175;0;175
27;Bourgogne-Franche-Comté;21;2;16;666;Vernot;85;3;88
27;Bourgogne-Franche-Comté;21;2;16;667;Véronnes;396;7;403
27;Bourgogne-Franche-Comté;21;2;23;669;Verrey-sous-Drée;74;0;74
27;Bourgogne-Franche-Comté;21;3;19;670;Verrey-sous-Salmaise;289;4;293
27;Bourgogne-Franche-Comté;21;3;05;671;Vertault;56;1;57
27;Bourgogne-Franche-Comté;21;3;22;672;Vesvres;27;2;29
27;Bourgogne-Franche-Comté;21;1;01;673;Veuvey-sur-Ouche;209;2;211
27;Bourgogne-Franche-Comté;21;3;05;674;Veuxhaulles-sur-Aube;207;3;210
27;Bourgogne-Franche-Comté;21;1;01;675;Vianges;40;3;43
27;Bourgogne-Franche-Comté;21;3;22;676;Vic-de-Chassenay;222;2;224
27;Bourgogne-Franche-Comté;21;1;01;677;Vic-des-Prés;117;1;118
27;Bourgogne-Franche-Comté;21;3;22;678;Vic-sous-Thil;189;3;192
27;Bourgogne-Franche-Comté;21;2;23;679;Vieilmoulin;124;2;126
27;Bourgogne-Franche-Comté;21;2;02;680;Vielverge;496;8;504
27;Bourgogne-Franche-Comté;21;3;22;681;Vieux-Château;85;1;86
27;Bourgogne-Franche-Comté;21;2;21;682;Viévigne;259;1;260
27;Bourgogne-Franche-Comté;21;1;01;683;Viévy;357;4;361
27;Bourgogne-Franche-Comté;21;1;17;684;Vignoles;977;30;1007
27;Bourgogne-Franche-Comté;21;3;05;685;Villaines-en-Duesmois;252;6;258
27;Bourgogne-Franche-Comté;21;3;19;686;Villaines-les-Prévôtes;141;2;143
27;Bourgogne-Franche-Comté;21;3;22;687;Villargoix;143;5;148
27;Bourgogne-Franche-Comté;21;3;22;689;Villars-et-Villenotte;174;7;181
27;Bourgogne-Franche-Comté;21;1;20;688;Villars-Fontaine;118;4;122
27;Bourgogne-Franche-Comté;21;3;22;690;Villeberny;91;2;93
27;Bourgogne-Franche-Comté;21;1;20;691;Villebichot;393;6;399
27;Bourgogne-Franche-Comté;21;2;16;692;Villecomte;253;4;257
27;Bourgogne-Franche-Comté;21;3;05;693;Villedieu;69;2;71
27;Bourgogne-Franche-Comté;21;3;22;694;Villeferry;30;0;30
27;Bourgogne-Franche-Comté;21;3;19;695;La Villeneuve-les-Convers;52;1;53
27;Bourgogne-Franche-Comté;21;3;22;696;Villeneuve-sous-Charigny;94;2;96
27;Bourgogne-Franche-Comté;21;1;20;698;Villers-la-Faye;392;7;399
27;Bourgogne-Franche-Comté;21;2;02;699;Villers-les-Pots;1134;13;1147
27;Bourgogne-Franche-Comté;21;3;05;700;Villers-Patras;97;3;100
27;Bourgogne-Franche-Comté;21;2;02;701;Villers-Rotin;128;5;133
27;Bourgogne-Franche-Comté;21;2;16;702;Villey-sur-Tille;267;7;274
27;Bourgogne-Franche-Comté;21;1;01;703;Villiers-en-Morvan;47;0;47
27;Bourgogne-Franche-Comté;21;3;05;704;Villiers-le-Duc;87;0;87
27;Bourgogne-Franche-Comté;21;2;14;705;Villotte-Saint-Seine;76;1;77
27;Bourgogne-Franche-Comté;21;3;05;706;Villotte-sur-Ource;113;1;114
27;Bourgogne-Franche-Comté;21;3;22;707;Villy-en-Auxois;218;4;222
27;Bourgogne-Franche-Comté;21;1;20;708;Villy-le-Moutier;339;13;352
27;Bourgogne-Franche-Comté;21;3;19;709;Viserny;178;2;180
27;Bourgogne-Franche-Comté;21;3;22;710;Vitteaux;1074;18;1092
27;Bourgogne-Franche-Comté;21;3;05;711;Vix;107;5;112
27;Bourgogne-Franche-Comté;21;1;17;712;Volnay;241;9;250
27;Bourgogne-Franche-Comté;21;2;02;713;Vonges;342;4;346
27;Bourgogne-Franche-Comté;21;1;20;714;Vosne-Romanée;346;9;355
27;Bourgogne-Franche-Comté;21;1;01;715;Voudenay;190;1;191
27;Bourgogne-Franche-Comté;21;1;20;716;Vougeot;177;5;182
27;Bourgogne-Franche-Comté;21;3;05;717;Voulaines-les-Templiers;288;10;298
53;Bretagne;22;4;10;001;Allineuc;604;8;612
53;Bretagne;22;4;06;002;Andel;1124;35;1159
53;Bretagne;22;1;04;003;Aucaleuc;943;80;1023
53;Bretagne;22;1;19;209;Beaussais-sur-Mer;3556;62;3618
53;Bretagne;22;2;01;004;Bégard;4808;78;4886
53;Bretagne;22;2;03;005;Belle-Isle-en-Terre;1031;19;1050
53;Bretagne;22;3;01;006;Berhet;257;8;265
53;Bretagne;22;4;22;055;Binic-Étables-sur-Mer;7068;158;7226
53;Bretagne;22;1;08;008;Bobital;1100;24;1124
53;Bretagne;22;4;13;009;Le Bodéo;162;0;162
53;Bretagne;22;2;23;107;Bon Repos sur Blavet;1271;39;1310
53;Bretagne;22;2;15;011;Boqueho;1078;20;1098
53;Bretagne;22;4;17;012;La Bouillie;860;18;878
53;Bretagne;22;2;03;013;Bourbriac;2271;50;2321
53;Bretagne;22;1;14;014;Bourseul;1141;29;1170
53;Bretagne;22;4;16;015;Bréhand;1647;37;1684
53;Bretagne;22;2;01;018;Brélidy;297;5;302
53;Bretagne;22;2;15;019;Bringolo;470;13;483
53;Bretagne;22;1;02;020;Broons;2886;49;2935
53;Bretagne;22;1;08;021;Brusvily;1196;13;1209
53;Bretagne;22;2;03;023;Bulat-Pestivien;432;9;441
53;Bretagne;22;2;03;024;Calanhel;217;1;218
53;Bretagne;22;2;03;025;Callac;2213;34;2247
53;Bretagne;22;1;08;026;Calorguen;728;9;737
53;Bretagne;22;4;09;027;Le Cambout;434;13;447
53;Bretagne;22;3;27;028;Camlez;888;26;914
53;Bretagne;22;2;23;029;Canihuel;355;13;368
53;Bretagne;22;3;01;030;Caouënnec-Lanvézéac;873;21;894
53;Bretagne;22;2;03;031;Carnoët;661;9;670
53;Bretagne;22;1;02;032;Caulnes;2488;152;2640
53;Bretagne;22;4;10;033;Caurel;360;11;371
53;Bretagne;22;3;01;034;Cavan;1564;27;1591
53;Bretagne;22;1;08;035;Les Champs-Géraux;1036;19;1055
53;Bretagne;22;1;02;036;La Chapelle-Blanche;206;7;213
53;Bretagne;22;2;03;037;La Chapelle-Neuve;388;4;392
53;Bretagne;22;2;15;206;Châtelaudren-Plouagat;3868;55;3923
53;Bretagne;22;4;09;039;La Chèze;563;28;591
53;Bretagne;22;2;03;040;Coadout;580;9;589
53;Bretagne;22;3;01;041;Coatascorn;262;3;265
53;Bretagne;22;3;27;042;Coatréven;495;15;510
53;Bretagne;22;4;09;043;Coëtlogon;213;5;218
53;Bretagne;22;4;06;044;Coëtmieux;1772;49;1821
53;Bretagne;22;2;15;045;Cohiniac;357;7;364
53;Bretagne;22;4;10;047;Corlay;957;15;972
53;Bretagne;22;1;14;048;Corseul;2184;47;2231
53;Bretagne;22;1;14;049;Créhen;1640;42;1682
53;Bretagne;22;1;04;050;Dinan;14166;575;14741
53;Bretagne;22;2;03;052;Duault;362;7;369
53;Bretagne;22;4;02;053;Éréac;682;8;690
53;Bretagne;22;4;17;054;Erquy;3910;94;4004
53;Bretagne;22;1;08;056;Évran;1712;35;1747
53;Bretagne;22;2;22;057;Le Faouët;396;9;405
53;Bretagne;22;1;17;179;Fréhel;1567;26;1593
53;Bretagne;22;4;15;059;Le Fœil;1429;39;1468
53;Bretagne;22;4;10;060;Gausson;616;21;637
53;Bretagne;22;2;23;061;Glomel;1380;42;1422
53;Bretagne;22;4;02;062;Gomené;546;11;557
53;Bretagne;22;2;22;063;Gommenec'h;558;15;573
53;Bretagne;22;2;23;064;Gouarec;925;32;957
53;Bretagne;22;2;05;065;Goudelin;1746;36;1782
53;Bretagne;22;4;10;068;Grâce-Uzel;432;9;441
53;Bretagne;22;2;05;067;Grâces;2528;58;2586
53;Bretagne;22;1;02;069;Guenroc;220;2;222
53;Bretagne;22;4;10;158;Guerlédan;2444;64;2508
53;Bretagne;22;2;05;070;Guingamp;6895;566;7461
53;Bretagne;22;1;02;071;Guitté;706;9;715
53;Bretagne;22;2;03;072;Gurunhuel;421;9;430
53;Bretagne;22;4;15;073;La Harmoye;377;14;391
53;Bretagne;22;4;10;074;Le Haut-Corlay;659;19;678
53;Bretagne;22;4;10;075;Hémonstoir;715;7;722
53;Bretagne;22;4;17;076;Hénanbihen;1314;36;1350
53;Bretagne;22;4;06;077;Hénansal;1173;15;1188
53;Bretagne;22;4;13;079;Hénon;2242;45;2287
53;Bretagne;22;4;26;081;Hillion;4137;98;4235
53;Bretagne;22;1;08;082;Le Hinglé;903;20;923
53;Bretagne;22;4;11;016;Île-de-Bréhat;361;7;368
53;Bretagne;22;4;02;083;Illifaut;690;16;706
53;Bretagne;22;4;16;084;Jugon-les-Lacs - Commune nouvelle;2493;51;2544
53;Bretagne;22;3;27;085;Kerbors;305;7;312
53;Bretagne;22;2;11;086;Kerfot;695;13;708
53;Bretagne;22;2;23;087;Kergrist-Moëlou;657;26;683
53;Bretagne;22;2;03;088;Kerien;254;4;258
53;Bretagne;22;3;12;090;Kermaria-Sulard;1049;20;1069
53;Bretagne;22;2;01;091;Kermoroc'h;456;10;466
53;Bretagne;22;2;03;092;Kerpert;270;10;280
53;Bretagne;22;4;89;093;Lamballe-Armor;16578;459;17037
53;Bretagne;22;1;19;094;Lancieux;1510;54;1564
53;Bretagne;22;2;01;095;Landebaëron;189;0;189
53;Bretagne;22;1;14;096;Landébia;481;3;484
53;Bretagne;22;1;14;097;La Landec;723;19;742
53;Bretagne;22;4;06;098;Landéhen;1415;36;1451
53;Bretagne;22;4;15;099;Lanfains;1091;18;1109
53;Bretagne;22;3;27;101;Langoat;1154;25;1179
53;Bretagne;22;1;19;103;Langrolay-sur-Rance;925;24;949
53;Bretagne;22;1;14;104;Languédias;515;29;544
53;Bretagne;22;1;14;105;Languenan;1155;23;1178
53;Bretagne;22;4;26;106;Langueux;7692;260;7952
53;Bretagne;22;2;11;108;Lanleff;121;5;126
53;Bretagne;22;2;11;109;Lanloup;222;5;227
53;Bretagne;22;3;27;110;Lanmérin;599;12;611
53;Bretagne;22;3;27;111;Lanmodez;417;7;424
53;Bretagne;22;2;22;112;Lannebert;443;5;448
53;Bretagne;22;3;07;113;Lannion;19880;972;20852
53;Bretagne;22;4;02;114;Lanrelas;837;16;853
53;Bretagne;22;2;23;115;Lanrivain;456;18;474
53;Bretagne;22;2;15;116;Lanrodec;1327;13;1340
53;Bretagne;22;4;22;117;Lantic;1672;33;1705
53;Bretagne;22;1;08;118;Lanvallay;4187;99;4286
53;Bretagne;22;3;20;119;Lanvellec;596;11;607
53;Bretagne;22;2;22;121;Lanvollon;1778;30;1808
53;Bretagne;22;4;02;122;Laurenan;736;14;750
53;Bretagne;22;2;23;124;Lescouët-Gouarec;223;3;226
53;Bretagne;22;4;15;126;Le Leslay;158;1;159
53;Bretagne;22;3;27;127;Lézardrieux;1474;38;1512
53;Bretagne;22;2;03;129;Loc-Envel;69;3;72
53;Bretagne;22;2;23;128;Locarn;407;16;423
53;Bretagne;22;3;20;131;Loguivy-Plougras;890;14;904
53;Bretagne;22;2;03;132;Lohuec;256;4;260
53;Bretagne;22;4;02;133;Loscouët-sur-Meu;629;16;645
53;Bretagne;22;3;12;134;Louannec;3068;115;3183
53;Bretagne;22;2;03;135;Louargat;2343;46;2389
53;Bretagne;22;4;09;136;Loudéac;9571;381;9952
53;Bretagne;22;2;23;137;Maël-Carhaix;1499;31;1530
53;Bretagne;22;2;03;138;Maël-Pestivien;378;5;383
53;Bretagne;22;2;03;139;Magoar;86;1;87
53;Bretagne;22;4;06;140;La Malhoure;594;15;609
53;Bretagne;22;3;01;141;Mantallot;230;6;236
53;Bretagne;22;1;17;143;Matignon;1662;23;1685
53;Bretagne;22;4;21;144;La Méaugon;1292;32;1324
53;Bretagne;22;1;02;145;Mégrit;818;11;829
53;Bretagne;22;2;23;146;Mellionnec;399;18;417
53;Bretagne;22;4;16;046;Le Mené;6417;122;6539
53;Bretagne;22;4;02;147;Merdrignac;2930;235;3165
53;Bretagne;22;4;02;148;Mérillac;233;4;237
53;Bretagne;22;4;10;149;Merléac;434;18;452
53;Bretagne;22;2;05;150;Le Merzer;959;27;986
53;Bretagne;22;3;27;152;Minihy-Tréguier;1267;38;1305
53;Bretagne;22;4;13;153;Moncontour;867;9;876
53;Bretagne;22;4;10;155;La Motte;2131;35;2166
53;Bretagne;22;2;03;156;Moustéru;660;15;675
53;Bretagne;22;2;23;157;Le Moustoir;666;17;683
53;Bretagne;22;4;06;160;Noyal;908;17;925
53;Bretagne;22;2;05;161;Pabu;2760;112;2872
53;Bretagne;22;2;11;162;Paimpol;7172;336;7508
53;Bretagne;22;2;23;163;Paule;707;24;731
53;Bretagne;22;2;01;164;Pédernec;1851;30;1881
53;Bretagne;22;4;16;165;Penguily;609;14;623
53;Bretagne;22;3;27;166;Penvénan;2538;65;2603
53;Bretagne;22;3;12;168;Perros-Guirec;7139;196;7335
53;Bretagne;22;2;23;169;Peumerit-Quintin;172;1;173
53;Bretagne;22;4;15;170;Plaine-Haute;1604;30;1634
53;Bretagne;22;4;13;171;Plaintel;4344;88;4432
53;Bretagne;22;1;14;172;Plancoët;3013;54;3067
53;Bretagne;22;1;17;174;Pléboulle;862;5;867
53;Bretagne;22;4;16;175;Plédéliac;1439;18;1457
53;Bretagne;22;4;21;176;Plédran;6666;111;6777
53;Bretagne;22;2;22;177;Pléguien;1325;28;1353
53;Bretagne;22;2;11;178;Pléhédel;1313;32;1345
53;Bretagne;22;1;14;180;Plélan-le-Petit;1910;29;1939
53;Bretagne;22;2;23;181;Plélauff;634;26;660
53;Bretagne;22;2;15;182;Plélo;3289;76;3365
53;Bretagne;22;4;09;183;Plémet;3649;128;3777
53;Bretagne;22;4;13;184;Plémy;1572;39;1611
53;Bretagne;22;4;16;185;Plénée-Jugon;2410;77;2487
53;Bretagne;22;4;17;186;Pléneuf-Val-André;4073;129;4202
53;Bretagne;22;4;18;187;Plérin;14062;483;14545
53;Bretagne;22;2;15;188;Plerneuf;1053;13;1066
53;Bretagne;22;2;03;189;Plésidy;613;13;626
53;Bretagne;22;1;19;190;Pleslin-Trigavou;3627;74;3701
53;Bretagne;22;4;16;193;Plestan;1598;26;1624
53;Bretagne;22;3;20;194;Plestin-les-Grèves;3591;89;3680
53;Bretagne;22;3;27;195;Pleubian;2322;42;2364
53;Bretagne;22;3;27;196;Pleudaniel;928;21;949
53;Bretagne;22;1;08;197;Pleudihen-sur-Rance;2909;77;2986
53;Bretagne;22;3;12;198;Pleumeur-Bodou;3925;166;4091
53;Bretagne;22;3;27;199;Pleumeur-Gautier;1217;20;1237
53;Bretagne;22;1;14;200;Pléven;582;6;588
53;Bretagne;22;1;17;201;Plévenon;781;14;795
53;Bretagne;22;2;23;202;Plévin;751;16;767
53;Bretagne;22;2;01;204;Ploëzal;1250;18;1268
53;Bretagne;22;1;14;205;Plorec-sur-Arguenon;414;2;416
53;Bretagne;22;3;20;207;Plouaret;2139;46;2185
53;Bretagne;22;1;08;208;Plouasne;1714;35;1749
53;Bretagne;22;2;11;210;Ploubazlanec;3014;125;3139
53;Bretagne;22;3;20;211;Ploubezre;3600;118;3718
53;Bretagne;22;2;01;212;Plouëc-du-Trieux;1134;28;1162
53;Bretagne;22;1;19;213;Plouër-sur-Rance;3531;107;3638
53;Bretagne;22;2;11;214;Plouézec;3182;57;3239
53;Bretagne;22;4;21;215;Ploufragan;11546;352;11898
53;Bretagne;22;2;03;216;Plougonver;733;11;744
53;Bretagne;22;3;20;217;Plougras;413;13;426
53;Bretagne;22;3;27;218;Plougrescant;1184;38;1222
53;Bretagne;22;4;10;219;Plouguenast-Langast;2487;84;2571
53;Bretagne;22;2;23;220;Plouguernével;1709;58;1767
53;Bretagne;22;3;27;221;Plouguiel;1760;38;1798
53;Bretagne;22;2;22;222;Plouha;4503;88;4591
53;Bretagne;22;2;05;223;Plouisy;1980;207;2187
53;Bretagne;22;3;07;224;Ploulec'h;1636;59;1695
53;Bretagne;22;2;05;225;Ploumagoar;5434;120;5554
53;Bretagne;22;3;20;226;Ploumilliau;2481;53;2534
53;Bretagne;22;3;20;227;Plounérin;747;11;758
53;Bretagne;22;3;20;228;Plounévez-Moëdec;1458;25;1483
53;Bretagne;22;2;23;229;Plounévez-Quintin;1091;25;1116
53;Bretagne;22;2;03;231;Plourac'h;319;4;323
53;Bretagne;22;4;22;232;Plourhan;1996;39;2035
53;Bretagne;22;2;11;233;Plourivo;2275;54;2329
53;Bretagne;22;2;15;234;Plouvara;1147;23;1170
53;Bretagne;22;3;20;235;Plouzélambre;234;4;238
53;Bretagne;22;2;22;236;Pludual;729;7;736
53;Bretagne;22;1;14;237;Pluduno;2193;65;2258
53;Bretagne;22;3;20;238;Plufur;534;12;546
53;Bretagne;22;1;02;239;Plumaudan;1288;39;1327
53;Bretagne;22;1;02;240;Plumaugat;1084;22;1106
53;Bretagne;22;4;09;241;Plumieux;1015;22;1037
53;Bretagne;22;4;17;242;Plurien;1519;22;1541
53;Bretagne;22;2;03;243;Plusquellec;527;15;542
53;Bretagne;22;4;10;244;Plussulien;487;23;510
53;Bretagne;22;3;01;245;Pluzunet;984;15;999
53;Bretagne;22;4;13;203;Plœuc-L'Hermitage;4062;77;4139
53;Bretagne;22;4;06;246;Pommeret;2075;34;2109
53;Bretagne;22;2;05;248;Pommerit-le-Vicomte;1760;50;1810
53;Bretagne;22;2;03;249;Pont-Melvez;603;19;622
53;Bretagne;22;2;01;250;Pontrieux;1028;25;1053
53;Bretagne;22;4;18;251;Pordic;7167;202;7369
53;Bretagne;22;3;01;254;Prat;1118;25;1143
53;Bretagne;22;4;09;255;La Prénessaye;887;21;908
53;Bretagne;22;2;01;256;Quemper-Guézennec;1094;26;1120
53;Bretagne;22;3;01;257;Quemperven;379;8;387
53;Bretagne;22;4;13;258;Quessoy;3786;233;4019
53;Bretagne;22;1;04;259;Quévert;3749;107;3856
53;Bretagne;22;4;10;260;Le Quillio;555;7;562
53;Bretagne;22;4;06;261;Quintenic;367;12;379
53;Bretagne;22;4;15;262;Quintin;2838;200;3038
53;Bretagne;22;1;08;263;Le Quiou;305;4;309
53;Bretagne;22;3;27;264;La Roche-Jaudy;2688;570;3258
53;Bretagne;22;3;07;265;Rospez;1758;54;1812
53;Bretagne;22;2;23;266;Rostrenen;3060;345;3405
53;Bretagne;22;4;02;267;Rouillac;395;2;397
53;Bretagne;22;1;17;268;Ruca;609;10;619
53;Bretagne;22;2;01;269;Runan;240;6;246
53;Bretagne;22;2;03;271;Saint-Adrien;353;8;361
53;Bretagne;22;2;05;272;Saint-Agathon;2273;53;2326
53;Bretagne;22;4;17;273;Saint-Alban;2154;31;2185
53;Bretagne;22;1;08;274;Saint-André-des-Eaux;339;9;348
53;Bretagne;22;4;09;275;Saint-Barnabé;1249;26;1275
53;Bretagne;22;4;15;276;Saint-Bihy;262;0;262
53;Bretagne;22;4;15;277;Saint-Brandan;2368;51;2419
53;Bretagne;22;4;99;278;Saint-Brieuc;44372;1634;46006
53;Bretagne;22;4;10;279;Saint-Caradec;1116;38;1154
53;Bretagne;22;1;08;280;Saint-Carné;998;28;1026
53;Bretagne;22;4;13;281;Saint-Carreuc;1509;28;1537
53;Bretagne;22;1;17;282;Saint-Cast-le-Guildo;3315;77;3392
53;Bretagne;22;2;01;283;Saint-Clet;875;23;898
53;Bretagne;22;2;23;284;Saint-Connan;297;6;303
53;Bretagne;22;4;10;285;Saint-Connec;255;7;262
53;Bretagne;22;4;17;286;Saint-Denoual;464;14;478
53;Bretagne;22;4;21;287;Saint-Donan;1457;35;1492
53;Bretagne;22;4;09;288;Saint-Étienne-du-Gué-de-l'Isle;356;6;362
53;Bretagne;22;2;15;289;Saint-Fiacre;212;3;215
53;Bretagne;22;4;15;291;Saint-Gildas;269;9;278
53;Bretagne;22;2;22;293;Saint-Gilles-les-Bois;432;5;437
53;Bretagne;22;2;23;294;Saint-Gilles-Pligeaux;295;6;301
53;Bretagne;22;4;10;295;Saint-Gilles-Vieux-Marché;354;8;362
53;Bretagne;22;4;16;296;Saint-Glen;621;11;632
53;Bretagne;22;1;08;299;Saint-Hélen;1481;37;1518
53;Bretagne;22;4;10;300;Saint-Hervé;400;9;409
53;Bretagne;22;2;23;334;Saint-Igeaux;135;5;140
53;Bretagne;22;1;14;302;Saint-Jacut-de-la-Mer;906;19;925
53;Bretagne;22;2;15;304;Saint-Jean-Kerdaniel;637;8;645
53;Bretagne;22;1;02;305;Saint-Jouan-de-l'Isle;496;5;501
53;Bretagne;22;1;08;306;Saint-Judoce;565;13;578
53;Bretagne;22;4;21;307;Saint-Julien;2050;50;2100
53;Bretagne;22;1;08;308;Saint-Juvat;653;20;673
53;Bretagne;22;4;02;309;Saint-Launeuc;200;4;204
53;Bretagne;22;2;01;310;Saint-Laurent;487;17;504
53;Bretagne;22;1;14;311;Saint-Lormel;860;17;877
53;Bretagne;22;1;02;312;Saint-Maden;231;9;240
53;Bretagne;22;4;10;313;Saint-Martin-des-Prés;315;10;325
53;Bretagne;22;4;09;314;Saint-Maudan;400;7;407
53;Bretagne;22;1;14;315;Saint-Maudez;284;11;295
53;Bretagne;22;4;10;316;Saint-Mayeux;470;15;485
53;Bretagne;22;1;14;317;Saint-Méloir-des-Bois;258;2;260
53;Bretagne;22;1;14;318;Saint-Michel-de-Plélan;321;8;329
53;Bretagne;22;3;20;319;Saint-Michel-en-Grève;456;13;469
53;Bretagne;22;2;03;320;Saint-Nicodème;168;3;171
53;Bretagne;22;2;23;321;Saint-Nicolas-du-Pélem;1666;43;1709
53;Bretagne;22;2;15;322;Saint-Péver;402;8;410
53;Bretagne;22;1;17;323;Saint-Pôtan;807;13;820
53;Bretagne;22;3;12;324;Saint-Quay-Perros;1303;56;1359
53;Bretagne;22;4;22;325;Saint-Quay-Portrieux;2997;220;3217
53;Bretagne;22;4;06;326;Saint-Rieul;550;5;555
53;Bretagne;22;1;19;327;Saint-Samson-sur-Rance;1607;26;1633
53;Bretagne;22;2;03;328;Saint-Servais;405;6;411
53;Bretagne;22;4;10;330;Saint-Thélo;420;6;426
53;Bretagne;22;4;16;332;Saint-Trimoël;544;6;550
53;Bretagne;22;4;02;333;Saint-Vran;759;30;789
53;Bretagne;22;2;23;331;Sainte-Tréphine;186;6;192
53;Bretagne;22;2;03;335;Senven-Léhart;234;0;234
53;Bretagne;22;4;02;337;Sévignac;1088;29;1117
53;Bretagne;22;2;01;338;Squiffiec;762;26;788
53;Bretagne;22;1;19;339;Taden;2467;76;2543
53;Bretagne;22;3;01;340;Tonquédec;1180;26;1206
53;Bretagne;22;4;16;341;Tramain;694;10;704
53;Bretagne;22;1;14;342;Trébédan;428;9;437
53;Bretagne;22;3;12;343;Trébeurden;3637;125;3762
53;Bretagne;22;2;23;344;Trébrivan;741;18;759
53;Bretagne;22;4;16;345;Trébry;798;19;817
53;Bretagne;22;4;13;346;Trédaniel;926;29;955
53;Bretagne;22;3;27;347;Trédarzec;1075;19;1094
53;Bretagne;22;4;02;348;Trédias;486;9;495
53;Bretagne;22;3;20;349;Trédrez-Locquémeau;1444;39;1483
53;Bretagne;22;3;20;350;Tréduder;195;4;199
53;Bretagne;22;2;23;351;Treffrin;548;13;561
53;Bretagne;22;1;08;352;Tréfumel;273;3;276
53;Bretagne;22;3;12;353;Trégastel;2465;71;2536
53;Bretagne;22;2;03;354;Tréglamus;1034;23;1057
53;Bretagne;22;2;15;356;Trégomeur;938;24;962
53;Bretagne;22;2;01;358;Trégonneau;576;7;583
53;Bretagne;22;3;20;359;Trégrom;426;4;430
53;Bretagne;22;4;26;360;Trégueux;8432;163;8595
53;Bretagne;22;2;22;361;Tréguidel;615;11;626
53;Bretagne;22;3;27;362;Tréguier;2419;276;2695
53;Bretagne;22;3;12;363;Trélévern;1249;32;1281
53;Bretagne;22;1;04;364;Trélivan;2782;73;2855
53;Bretagne;22;2;23;365;Trémargat;186;15;201
53;Bretagne;22;3;20;366;Trémel;411;6;417
53;Bretagne;22;1;19;368;Tréméreuc;744;28;772
53;Bretagne;22;4;02;369;Trémeur;764;19;783
53;Bretagne;22;2;22;370;Tréméven;341;8;349
53;Bretagne;22;4;02;371;Trémorel;1152;26;1178
53;Bretagne;22;4;18;372;Trémuson;2069;39;2108
53;Bretagne;22;2;23;373;Tréogan;100;4;104
53;Bretagne;22;2;22;375;Tressignaux;682;11;693
53;Bretagne;22;4;10;376;Trévé;1657;30;1687
53;Bretagne;22;4;22;377;Tréveneuc;794;25;819
53;Bretagne;22;2;22;378;Trévérec;214;7;221
53;Bretagne;22;3;12;379;Trévou-Tréguignec;1387;40;1427
53;Bretagne;22;1;08;380;Trévron;686;14;700
53;Bretagne;22;3;27;381;Trézény;356;8;364
53;Bretagne;22;3;27;383;Troguéry;249;6;255
53;Bretagne;22;4;10;384;Uzel;1046;25;1071
53;Bretagne;22;1;19;385;La Vicomté-sur-Rance;1057;14;1071
53;Bretagne;22;4;15;386;Le Vieux-Bourg;781;21;802
53;Bretagne;22;3;20;387;Le Vieux-Marché;1314;27;1341
53;Bretagne;22;1;04;388;Vildé-Guingalan;1241;21;1262
53;Bretagne;22;4;26;389;Yffiniac;5010;107;5117
53;Bretagne;22;2;11;390;Yvias;765;17;782
53;Bretagne;22;1;02;391;Yvignac-la-Tour;1166;19;1185
75;Nouvelle-Aquitaine;23;2;01;001;Ahun;1432;172;1604
75;Nouvelle-Aquitaine;23;2;14;002;Ajain;1138;26;1164
75;Nouvelle-Aquitaine;23;1;02;003;Alleyrat;143;0;143
75;Nouvelle-Aquitaine;23;2;14;004;Anzême;578;8;586
75;Nouvelle-Aquitaine;23;1;08;005;Arfeuille-Châtain;192;4;196
75;Nouvelle-Aquitaine;23;2;11;006;Arrènes;218;0;218
75;Nouvelle-Aquitaine;23;2;01;007;Ars;244;10;254
75;Nouvelle-Aquitaine;23;1;02;008;Aubusson;3366;185;3551
75;Nouvelle-Aquitaine;23;1;08;009;Auge;98;0;98
75;Nouvelle-Aquitaine;23;2;11;010;Augères;116;1;117
75;Nouvelle-Aquitaine;23;2;11;011;Aulon;154;2;156
75;Nouvelle-Aquitaine;23;2;05;012;Auriat;111;2;113
75;Nouvelle-Aquitaine;23;1;03;013;Auzances;1214;25;1239
75;Nouvelle-Aquitaine;23;2;11;014;Azat-Châtenet;115;3;118
75;Nouvelle-Aquitaine;23;2;07;015;Azerables;815;16;831
75;Nouvelle-Aquitaine;23;2;01;016;Banize;187;2;189
75;Nouvelle-Aquitaine;23;1;03;017;Basville;159;4;163
75;Nouvelle-Aquitaine;23;2;07;018;Bazelat;256;11;267
75;Nouvelle-Aquitaine;23;1;03;019;Beissat;25;0;25
75;Nouvelle-Aquitaine;23;1;02;020;Bellegarde-en-Marche;409;7;416
75;Nouvelle-Aquitaine;23;2;11;021;Bénévent-l'Abbaye;776;10;786
75;Nouvelle-Aquitaine;23;1;06;022;Bétête;365;8;373
75;Nouvelle-Aquitaine;23;1;10;023;Blaudeix;99;1;100
75;Nouvelle-Aquitaine;23;1;02;024;Blessac;533;12;545
75;Nouvelle-Aquitaine;23;2;04;025;Bonnat;1315;22;1337
75;Nouvelle-Aquitaine;23;1;06;026;Bord-Saint-Georges;353;11;364
75;Nouvelle-Aquitaine;23;2;05;027;Bosmoreau-les-Mines;244;7;251
75;Nouvelle-Aquitaine;23;1;02;028;Bosroger;110;2;112
75;Nouvelle-Aquitaine;23;2;04;029;Le Bourg-d'Hem;213;2;215
75;Nouvelle-Aquitaine;23;2;05;030;Bourganeuf;2572;215;2787
75;Nouvelle-Aquitaine;23;1;06;031;Boussac;1257;18;1275
75;Nouvelle-Aquitaine;23;1;06;032;Boussac-Bourg;717;12;729
75;Nouvelle-Aquitaine;23;2;14;033;La Brionne;440;7;447
75;Nouvelle-Aquitaine;23;1;03;034;Brousse;27;0;27
75;Nouvelle-Aquitaine;23;1;08;035;Budelière;717;10;727
75;Nouvelle-Aquitaine;23;2;14;036;Bussière-Dunoise;1038;15;1053
75;Nouvelle-Aquitaine;23;1;03;037;Bussière-Nouvelle;85;3;88
75;Nouvelle-Aquitaine;23;1;06;038;Bussière-Saint-Georges;256;3;259
75;Nouvelle-Aquitaine;23;2;07;039;La Celle-Dunoise;542;24;566
75;Nouvelle-Aquitaine;23;1;10;040;La Celle-sous-Gouzon;151;0;151
75;Nouvelle-Aquitaine;23;2;04;041;La Cellette;254;4;258
75;Nouvelle-Aquitaine;23;2;11;042;Ceyroux;127;1;128
75;Nouvelle-Aquitaine;23;2;01;043;Chamberaud;101;0;101
75;Nouvelle-Aquitaine;23;2;04;044;Chambon-Sainte-Croix;75;2;77
75;Nouvelle-Aquitaine;23;1;08;045;Chambon-sur-Voueize;892;12;904
75;Nouvelle-Aquitaine;23;1;08;046;Chambonchard;82;4;86
75;Nouvelle-Aquitaine;23;2;11;047;Chamborand;243;1;244
75;Nouvelle-Aquitaine;23;1;02;048;Champagnat;467;9;476
75;Nouvelle-Aquitaine;23;2;04;049;Champsanglard;248;6;254
75;Nouvelle-Aquitaine;23;2;07;050;La Chapelle-Baloue;135;1;136
75;Nouvelle-Aquitaine;23;2;01;051;La Chapelle-Saint-Martial;90;1;91
75;Nouvelle-Aquitaine;23;2;13;052;La Chapelle-Taillefert;424;12;436
75;Nouvelle-Aquitaine;23;1;03;053;Chard;211;2;213
75;Nouvelle-Aquitaine;23;1;03;054;Charron;232;10;242
75;Nouvelle-Aquitaine;23;1;03;055;Châtelard;32;0;32
75;Nouvelle-Aquitaine;23;2;11;056;Châtelus-le-Marcheix;314;8;322
75;Nouvelle-Aquitaine;23;2;04;057;Châtelus-Malvaleix;557;13;570
75;Nouvelle-Aquitaine;23;1;10;058;Le Chauchet;109;2;111
75;Nouvelle-Aquitaine;23;1;02;059;La Chaussade;107;6;113
75;Nouvelle-Aquitaine;23;2;01;060;Chavanat;143;3;146
75;Nouvelle-Aquitaine;23;1;10;061;Chénérailles;760;13;773
75;Nouvelle-Aquitaine;23;2;04;062;Chéniers;572;7;579
75;Nouvelle-Aquitaine;23;1;03;063;Clairavaux;156;1;157
75;Nouvelle-Aquitaine;23;1;06;064;Clugnat;645;6;651
75;Nouvelle-Aquitaine;23;2;07;065;Colondannes;265;8;273
75;Nouvelle-Aquitaine;23;1;03;066;Le Compas;212;12;224
75;Nouvelle-Aquitaine;23;1;03;067;La Courtine;769;8;777
75;Nouvelle-Aquitaine;23;1;10;068;Cressat;553;7;560
75;Nouvelle-Aquitaine;23;1;03;069;Crocq;411;6;417
75;Nouvelle-Aquitaine;23;2;07;070;Crozant;447;17;464
75;Nouvelle-Aquitaine;23;1;09;071;Croze;196;6;202
75;Nouvelle-Aquitaine;23;1;10;072;Domeyrot;225;3;228
75;Nouvelle-Aquitaine;23;1;03;073;Dontreix;415;8;423
75;Nouvelle-Aquitaine;23;2;01;074;Le Donzeil;188;4;192
75;Nouvelle-Aquitaine;23;2;07;075;Dun-le-Palestel;1116;21;1137
75;Nouvelle-Aquitaine;23;1;08;076;Évaux-les-Bains;1390;47;1437
75;Nouvelle-Aquitaine;23;1;09;077;Faux-la-Montagne;421;9;430
75;Nouvelle-Aquitaine;23;2;05;078;Faux-Mazuras;182;6;188
75;Nouvelle-Aquitaine;23;1;09;079;Felletin;1593;213;1806
75;Nouvelle-Aquitaine;23;1;09;080;Féniers;94;0;94
75;Nouvelle-Aquitaine;23;1;03;081;Flayat;309;5;314
75;Nouvelle-Aquitaine;23;2;11;082;Fleurat;309;6;315
75;Nouvelle-Aquitaine;23;1;08;083;Fontanières;249;1;250
75;Nouvelle-Aquitaine;23;2;04;084;La Forêt-du-Temple;143;1;144
75;Nouvelle-Aquitaine;23;2;01;086;Fransèches;242;4;246
75;Nouvelle-Aquitaine;23;2;07;087;Fresselines;498;13;511
75;Nouvelle-Aquitaine;23;2;11;192;Fursac;1511;23;1534
75;Nouvelle-Aquitaine;23;2;14;088;Gartempe;123;0;123
75;Nouvelle-Aquitaine;23;2;04;089;Genouillac;735;10;745
75;Nouvelle-Aquitaine;23;1;09;090;Gentioux-Pigerolles;405;3;408
75;Nouvelle-Aquitaine;23;1;09;091;Gioux;164;3;167
75;Nouvelle-Aquitaine;23;2;14;092;Glénic;666;12;678
75;Nouvelle-Aquitaine;23;1;10;093;Gouzon;1580;20;1600
75;Nouvelle-Aquitaine;23;2;11;095;Le Grand-Bourg;1220;44;1264
75;Nouvelle-Aquitaine;23;2;99;096;Guéret;13161;603;13764
75;Nouvelle-Aquitaine;23;1;10;097;Issoudun-Létrieix;299;3;302
75;Nouvelle-Aquitaine;23;2;06;098;Jalesches;90;4;94
75;Nouvelle-Aquitaine;23;2;01;099;Janaillat;330;5;335
75;Nouvelle-Aquitaine;23;1;10;100;Jarnages;452;11;463
75;Nouvelle-Aquitaine;23;2;14;101;Jouillat;401;12;413
75;Nouvelle-Aquitaine;23;1;10;102;Ladapeyre;346;3;349
75;Nouvelle-Aquitaine;23;2;07;103;Lafat;350;16;366
75;Nouvelle-Aquitaine;23;1;06;104;Lavaufranche;245;1;246
75;Nouvelle-Aquitaine;23;1;10;105;Lavaveix-les-Mines;666;5;671
75;Nouvelle-Aquitaine;23;1;08;106;Lépaud;363;4;367
75;Nouvelle-Aquitaine;23;2;01;107;Lépinas;139;5;144
75;Nouvelle-Aquitaine;23;1;06;108;Leyrat;146;1;147
75;Nouvelle-Aquitaine;23;2;04;109;Linard-Malval;210;5;215
75;Nouvelle-Aquitaine;23;1;03;110;Lioux-les-Monges;57;1;58
75;Nouvelle-Aquitaine;23;2;11;111;Lizières;268;4;272
75;Nouvelle-Aquitaine;23;2;04;112;Lourdoueix-Saint-Pierre;773;13;786
75;Nouvelle-Aquitaine;23;1;02;113;Lupersat;302;6;308
75;Nouvelle-Aquitaine;23;1;08;114;Lussat;426;7;433
75;Nouvelle-Aquitaine;23;1;03;115;Magnat-l'Étrange;242;2;244
75;Nouvelle-Aquitaine;23;1;02;116;Mainsat;564;13;577
75;Nouvelle-Aquitaine;23;2;07;117;Maison-Feyne;304;7;311
75;Nouvelle-Aquitaine;23;2;01;118;Maisonnisses;190;7;197
75;Nouvelle-Aquitaine;23;1;03;119;Malleret;44;0;44
75;Nouvelle-Aquitaine;23;1;06;120;Malleret-Boussac;193;4;197
75;Nouvelle-Aquitaine;23;2;05;122;Mansat-la-Courrière;83;2;85
75;Nouvelle-Aquitaine;23;1;03;123;Les Mars;195;2;197
75;Nouvelle-Aquitaine;23;2;11;124;Marsac;676;8;684
75;Nouvelle-Aquitaine;23;1;03;125;Le Mas-d'Artige;99;1;100
75;Nouvelle-Aquitaine;23;1;02;127;Mautes;210;6;216
75;Nouvelle-Aquitaine;23;2;01;128;Mazeirat;130;7;137
75;Nouvelle-Aquitaine;23;1;03;129;La Mazière-aux-Bons-Hommes;65;1;66
75;Nouvelle-Aquitaine;23;2;04;130;Méasnes;544;6;550
75;Nouvelle-Aquitaine;23;1;03;131;Mérinchal;720;11;731
75;Nouvelle-Aquitaine;23;2;13;132;Montaigut-le-Blanc;408;7;415
75;Nouvelle-Aquitaine;23;2;05;133;Montboucher;349;10;359
75;Nouvelle-Aquitaine;23;2;09;134;Le Monteil-au-Vicomte;201;48;249
75;Nouvelle-Aquitaine;23;2;04;136;Mortroux;285;9;294
75;Nouvelle-Aquitaine;23;2;11;137;Mourioux-Vieilleville;514;8;522
75;Nouvelle-Aquitaine;23;2;01;138;Moutier-d'Ahun;184;2;186
75;Nouvelle-Aquitaine;23;2;04;139;Moutier-Malcard;536;5;541
75;Nouvelle-Aquitaine;23;1;09;140;Moutier-Rozeille;427;9;436
75;Nouvelle-Aquitaine;23;2;07;141;Naillat;639;17;656
75;Nouvelle-Aquitaine;23;1;02;142;Néoux;287;3;290
75;Nouvelle-Aquitaine;23;2;15;143;Noth;499;11;510
75;Nouvelle-Aquitaine;23;1;09;144;La Nouaille;249;3;252
75;Nouvelle-Aquitaine;23;1;08;145;Nouhant;283;7;290
75;Nouvelle-Aquitaine;23;1;06;146;Nouzerines;248;5;253
75;Nouvelle-Aquitaine;23;2;07;147;Nouzerolles;99;2;101
75;Nouvelle-Aquitaine;23;2;04;148;Nouziers;240;1;241
75;Nouvelle-Aquitaine;23;1;10;149;Parsac-Rimondeix;701;14;715
75;Nouvelle-Aquitaine;23;2;01;150;Peyrabout;153;2;155
75;Nouvelle-Aquitaine;23;1;10;151;Peyrat-la-Nonière;426;9;435
75;Nouvelle-Aquitaine;23;1;10;152;Pierrefitte;70;0;70
75;Nouvelle-Aquitaine;23;1;10;154;Pionnat;758;11;769
75;Nouvelle-Aquitaine;23;2;01;155;Pontarion;365;8;373
75;Nouvelle-Aquitaine;23;1;03;156;Pontcharraud;79;1;80
75;Nouvelle-Aquitaine;23;2;01;157;La Pouge;90;0;90
75;Nouvelle-Aquitaine;23;1;09;158;Poussanges;155;0;155
75;Nouvelle-Aquitaine;23;1;10;159;Puy-Malsignat;159;3;162
75;Nouvelle-Aquitaine;23;1;08;160;Reterre;291;5;296
75;Nouvelle-Aquitaine;23;2;04;162;Roches;363;2;365
75;Nouvelle-Aquitaine;23;1;03;164;Rougnat;494;15;509
75;Nouvelle-Aquitaine;23;2;09;165;Royère-de-Vassivière;575;4;579
75;Nouvelle-Aquitaine;23;2;07;166;Sagnat;192;8;200
75;Nouvelle-Aquitaine;23;2;15;177;Saint-Agnant-de-Versillat;1094;29;1123
75;Nouvelle-Aquitaine;23;1;03;178;Saint-Agnant-près-Crocq;184;0;184
75;Nouvelle-Aquitaine;23;1;02;179;Saint-Alpinien;273;3;276
75;Nouvelle-Aquitaine;23;1;02;180;Saint-Amand;493;3;496
75;Nouvelle-Aquitaine;23;2;05;181;Saint-Amand-Jartoudeix;168;1;169
75;Nouvelle-Aquitaine;23;1;02;182;Saint-Avit-de-Tardes;173;2;175
75;Nouvelle-Aquitaine;23;2;01;183;Saint-Avit-le-Pauvre;78;2;80
75;Nouvelle-Aquitaine;23;1;03;184;Saint-Bard;103;3;106
75;Nouvelle-Aquitaine;23;1;10;185;Saint-Chabrais;294;4;298
75;Nouvelle-Aquitaine;23;2;13;186;Saint-Christophe;155;11;166
75;Nouvelle-Aquitaine;23;1;10;187;Saint-Dizier-la-Tour;212;3;215
75;Nouvelle-Aquitaine;23;2;04;188;Saint-Dizier-les-Domaines;195;4;199
75;Nouvelle-Aquitaine;23;2;05;189;Saint-Dizier-Masbaraud;1126;22;1148
75;Nouvelle-Aquitaine;23;1;02;190;Saint-Domet;176;4;180
75;Nouvelle-Aquitaine;23;2;13;191;Saint-Éloi;225;2;227
75;Nouvelle-Aquitaine;23;2;14;195;Saint-Fiel;1036;25;1061
75;Nouvelle-Aquitaine;23;1;09;196;Saint-Frion;254;4;258
75;Nouvelle-Aquitaine;23;2;01;197;Saint-Georges-la-Pouge;370;3;373
75;Nouvelle-Aquitaine;23;1;03;198;Saint-Georges-Nigremont;129;1;130
75;Nouvelle-Aquitaine;23;2;07;199;Saint-Germain-Beaupré;436;5;441
75;Nouvelle-Aquitaine;23;2;11;200;Saint-Goussaud;162;3;165
75;Nouvelle-Aquitaine;23;2;01;201;Saint-Hilaire-la-Plaine;210;4;214
75;Nouvelle-Aquitaine;23;2;01;202;Saint-Hilaire-le-Château;233;7;240
75;Nouvelle-Aquitaine;23;1;08;203;Saint-Julien-la-Genête;223;7;230
75;Nouvelle-Aquitaine;23;1;10;204;Saint-Julien-le-Châtel;143;3;146
75;Nouvelle-Aquitaine;23;2;05;205;Saint-Junien-la-Bregère;140;1;141
75;Nouvelle-Aquitaine;23;2;12;206;Saint-Laurent;691;13;704
75;Nouvelle-Aquitaine;23;2;15;207;Saint-Léger-Bridereix;198;3;201
75;Nouvelle-Aquitaine;23;2;14;208;Saint-Léger-le-Guérétois;429;10;439
75;Nouvelle-Aquitaine;23;1;10;209;Saint-Loup;182;1;183
75;Nouvelle-Aquitaine;23;1;02;210;Saint-Maixant;243;2;245
75;Nouvelle-Aquitaine;23;1;02;211;Saint-Marc-à-Frongier;425;9;434
75;Nouvelle-Aquitaine;23;1;09;212;Saint-Marc-à-Loubaud;136;2;138
75;Nouvelle-Aquitaine;23;1;06;213;Saint-Marien;185;1;186
75;Nouvelle-Aquitaine;23;2;01;214;Saint-Martial-le-Mont;261;5;266
75;Nouvelle-Aquitaine;23;1;03;215;Saint-Martial-le-Vieux;136;3;139
75;Nouvelle-Aquitaine;23;2;09;216;Saint-Martin-Château;144;6;150
75;Nouvelle-Aquitaine;23;2;05;217;Saint-Martin-Sainte-Catherine;343;5;348
75;Nouvelle-Aquitaine;23;2;15;219;Saint-Maurice-la-Souterraine;1223;29;1252
75;Nouvelle-Aquitaine;23;1;03;218;Saint-Maurice-près-Crocq;100;1;101
75;Nouvelle-Aquitaine;23;1;10;220;Saint-Médard-la-Rochette;583;12;595
75;Nouvelle-Aquitaine;23;1;03;221;Saint-Merd-la-Breuille;191;5;196
75;Nouvelle-Aquitaine;23;2;01;222;Saint-Michel-de-Veisse;162;4;166
75;Nouvelle-Aquitaine;23;2;05;223;Saint-Moreil;219;0;219
75;Nouvelle-Aquitaine;23;1;03;224;Saint-Oradoux-de-Chirouze;68;0;68
75;Nouvelle-Aquitaine;23;1;03;225;Saint-Oradoux-près-Crocq;97;4;101
75;Nouvelle-Aquitaine;23;1;03;226;Saint-Pardoux-d'Arnet;173;6;179
75;Nouvelle-Aquitaine;23;1;02;228;Saint-Pardoux-le-Neuf;192;5;197
75;Nouvelle-Aquitaine;23;1;10;229;Saint-Pardoux-les-Cards;287;3;290
75;Nouvelle-Aquitaine;23;2;05;227;Saint-Pardoux-Morterolles;206;5;211
75;Nouvelle-Aquitaine;23;2;05;232;Saint-Pierre-Bellevue;210;0;210
75;Nouvelle-Aquitaine;23;2;05;230;Saint-Pierre-Chérignat;168;4;172
75;Nouvelle-Aquitaine;23;1;06;233;Saint-Pierre-le-Bost;129;7;136
75;Nouvelle-Aquitaine;23;1;08;234;Saint-Priest;165;1;166
75;Nouvelle-Aquitaine;23;2;15;235;Saint-Priest-la-Feuille;771;12;783
75;Nouvelle-Aquitaine;23;2;11;236;Saint-Priest-la-Plaine;260;6;266
75;Nouvelle-Aquitaine;23;2;05;237;Saint-Priest-Palus;55;0;55
75;Nouvelle-Aquitaine;23;1;09;238;Saint-Quentin-la-Chabanne;404;10;414
75;Nouvelle-Aquitaine;23;2;07;239;Saint-Sébastien;647;13;660
75;Nouvelle-Aquitaine;23;1;06;240;Saint-Silvain-Bas-le-Roc;400;13;413
75;Nouvelle-Aquitaine;23;1;02;241;Saint-Silvain-Bellegarde;211;3;214
75;Nouvelle-Aquitaine;23;2;13;242;Saint-Silvain-Montaigut;213;2;215
75;Nouvelle-Aquitaine;23;1;10;243;Saint-Silvain-sous-Toulx;165;1;166
75;Nouvelle-Aquitaine;23;2;07;244;Saint-Sulpice-le-Dunois;607;12;619
75;Nouvelle-Aquitaine;23;2;14;245;Saint-Sulpice-le-Guérétois;1949;53;2002
75;Nouvelle-Aquitaine;23;1;02;246;Saint-Sulpice-les-Champs;355;6;361
75;Nouvelle-Aquitaine;23;2;14;247;Saint-Vaury;1753;118;1871
75;Nouvelle-Aquitaine;23;2;13;248;Saint-Victor-en-Marche;376;7;383
75;Nouvelle-Aquitaine;23;1;09;249;Saint-Yrieix-la-Montagne;224;8;232
75;Nouvelle-Aquitaine;23;2;01;250;Saint-Yrieix-les-Bois;286;5;291
75;Nouvelle-Aquitaine;23;2;12;193;Sainte-Feyre;2472;54;2526
75;Nouvelle-Aquitaine;23;1;09;194;Sainte-Feyre-la-Montagne;130;3;133
75;Nouvelle-Aquitaine;23;1;08;167;Sannat;344;8;352
75;Nouvelle-Aquitaine;23;2;01;168;Sardent;788;11;799
75;Nouvelle-Aquitaine;23;2;12;169;La Saunière;607;7;614
75;Nouvelle-Aquitaine;23;2;12;170;Savennes;214;9;223
75;Nouvelle-Aquitaine;23;1;03;171;Sermur;133;2;135
75;Nouvelle-Aquitaine;23;1;02;172;La Serre-Bussière-Vieille;122;1;123
75;Nouvelle-Aquitaine;23;2;05;173;Soubrebost;136;3;139
75;Nouvelle-Aquitaine;23;1;06;174;Soumans;601;7;608
75;Nouvelle-Aquitaine;23;2;01;175;Sous-Parsat;115;1;116
75;Nouvelle-Aquitaine;23;2;15;176;La Souterraine;5207;241;5448
75;Nouvelle-Aquitaine;23;1;08;251;Tardes;138;2;140
75;Nouvelle-Aquitaine;23;2;06;252;Tercillat;158;3;161
75;Nouvelle-Aquitaine;23;2;01;253;Thauron;174;7;181
75;Nouvelle-Aquitaine;23;1;06;254;Toulx-Sainte-Croix;263;3;266
75;Nouvelle-Aquitaine;23;1;10;255;Trois-Fonds;121;0;121
75;Nouvelle-Aquitaine;23;1;09;257;Vallière;723;20;743
75;Nouvelle-Aquitaine;23;2;15;258;Vareilles;311;9;320
75;Nouvelle-Aquitaine;23;1;08;259;Verneiges;114;1;115
75;Nouvelle-Aquitaine;23;2;01;260;Vidaillat;157;2;159
75;Nouvelle-Aquitaine;23;1;08;261;Viersat;303;2;305
75;Nouvelle-Aquitaine;23;1;10;262;Vigeville;164;2;166
75;Nouvelle-Aquitaine;23;2;07;263;Villard;366;6;372
75;Nouvelle-Aquitaine;23;1;09;264;La Villedieu;48;0;48
75;Nouvelle-Aquitaine;23;1;03;265;La Villeneuve;64;0;64
75;Nouvelle-Aquitaine;23;1;03;266;La Villetelle;169;1;170
75;Nouvelle-Aquitaine;24;2;13;001;Abjat-sur-Bandiat;620;7;627
75;Nouvelle-Aquitaine;24;3;22;002;Agonac;1761;23;1784
75;Nouvelle-Aquitaine;24;4;05;004;Ajat;317;3;320
75;Nouvelle-Aquitaine;24;4;23;006;Allas-les-Mines;204;10;214
75;Nouvelle-Aquitaine;24;3;16;007;Allemans;513;14;527
75;Nouvelle-Aquitaine;24;1;08;005;Alles-sur-Dordogne;385;9;394
75;Nouvelle-Aquitaine;24;2;06;008;Angoisse;588;10;598
75;Nouvelle-Aquitaine;24;2;06;009;Anlhiac;275;5;280
75;Nouvelle-Aquitaine;24;3;17;010;Annesse-et-Beaulieu;1436;49;1485
75;Nouvelle-Aquitaine;24;3;22;011;Antonne-et-Trigonant;1283;18;1301
75;Nouvelle-Aquitaine;24;4;20;012;Archignac;363;9;372
75;Nouvelle-Aquitaine;24;4;25;014;Aubas;609;19;628
75;Nouvelle-Aquitaine;24;4;23;015;Audrix;278;4;282
75;Nouvelle-Aquitaine;24;2;13;016;Augignac;814;18;832
75;Nouvelle-Aquitaine;24;4;05;018;Auriac-du-Périgord;383;10;393
75;Nouvelle-Aquitaine;24;4;05;019;Azerat;442;7;449
75;Nouvelle-Aquitaine;24;4;05;020;La Bachellerie;899;20;919
75;Nouvelle-Aquitaine;24;4;05;021;Badefols-d'Ans;404;9;413
75;Nouvelle-Aquitaine;24;1;08;022;Badefols-sur-Dordogne;212;5;217
75;Nouvelle-Aquitaine;24;1;08;023;Baneuil;347;12;359
75;Nouvelle-Aquitaine;24;1;19;024;Bardou;45;0;45
75;Nouvelle-Aquitaine;24;4;05;025;Bars;243;7;250
75;Nouvelle-Aquitaine;24;3;89;026;Bassillac et Auberoche;4498;82;4580
75;Nouvelle-Aquitaine;24;1;08;027;Bayac;351;1;352
75;Nouvelle-Aquitaine;24;1;08;028;Beaumontois en Périgord;1846;44;1890
75;Nouvelle-Aquitaine;24;3;24;029;Beaupouyet;492;7;499
75;Nouvelle-Aquitaine;24;4;05;030;Beauregard-de-Terrasson;703;16;719
75;Nouvelle-Aquitaine;24;3;12;031;Beauregard-et-Bassac;262;5;267
75;Nouvelle-Aquitaine;24;3;24;032;Beauronne;372;1;373
75;Nouvelle-Aquitaine;24;3;12;034;Beleymas;274;7;281
75;Nouvelle-Aquitaine;24;4;23;036;Berbiguières;182;4;186
75;Nouvelle-Aquitaine;24;1;98;037;Bergerac;26833;734;27567
75;Nouvelle-Aquitaine;24;3;16;038;Bertric-Burée;440;12;452
75;Nouvelle-Aquitaine;24;4;23;039;Besse;156;4;160
75;Nouvelle-Aquitaine;24;4;18;040;Beynac-et-Cazenac;547;9;556
75;Nouvelle-Aquitaine;24;2;03;042;Biras;664;7;671
75;Nouvelle-Aquitaine;24;1;08;043;Biron;162;10;172
75;Nouvelle-Aquitaine;24;1;19;045;Boisse;246;5;251
75;Nouvelle-Aquitaine;24;4;05;046;Boisseuilh;120;2;122
75;Nouvelle-Aquitaine;24;1;11;048;Bonneville-et-Saint-Avit-de-Fumadières;323;7;330
75;Nouvelle-Aquitaine;24;4;20;050;Borrèze;342;11;353
75;Nouvelle-Aquitaine;24;1;10;051;Bosset;215;6;221
75;Nouvelle-Aquitaine;24;1;08;052;Bouillac;122;2;124
75;Nouvelle-Aquitaine;24;3;07;053;Boulazac Isle Manoire;10635;297;10932
75;Nouvelle-Aquitaine;24;1;19;054;Bouniagues;587;19;606
75;Nouvelle-Aquitaine;24;2;03;055;Bourdeilles;743;15;758
75;Nouvelle-Aquitaine;24;2;13;056;Le Bourdeix;226;4;230
75;Nouvelle-Aquitaine;24;3;16;057;Bourg-des-Maisons;68;0;68
75;Nouvelle-Aquitaine;24;3;16;058;Bourg-du-Bost;225;3;228
75;Nouvelle-Aquitaine;24;3;24;059;Bourgnac;343;6;349
75;Nouvelle-Aquitaine;24;1;08;060;Bourniquel;69;1;70
75;Nouvelle-Aquitaine;24;3;12;061;Bourrou;128;7;135
75;Nouvelle-Aquitaine;24;3;16;062;Bouteilles-Saint-Sébastien;174;2;176
75;Nouvelle-Aquitaine;24;4;23;063;Bouzic;151;3;154
75;Nouvelle-Aquitaine;24;2;03;064;Brantôme en Périgord;3702;57;3759
75;Nouvelle-Aquitaine;24;2;06;066;Brouchaud;218;5;223
75;Nouvelle-Aquitaine;24;4;25;067;Le Bugue;2587;41;2628
75;Nouvelle-Aquitaine;24;1;08;068;Le Buisson-de-Cadouin;1954;58;2012
75;Nouvelle-Aquitaine;24;2;03;069;Bussac;397;2;399
75;Nouvelle-Aquitaine;24;2;13;070;Busserolles;503;9;512
75;Nouvelle-Aquitaine;24;2;13;071;Bussière-Badil;391;2;393
75;Nouvelle-Aquitaine;24;1;08;073;Calès;386;11;397
75;Nouvelle-Aquitaine;24;4;20;074;Calviac-en-Périgord;510;20;530
75;Nouvelle-Aquitaine;24;4;23;075;Campagnac-lès-Quercy;304;8;312
75;Nouvelle-Aquitaine;24;4;25;076;Campagne;380;10;390
75;Nouvelle-Aquitaine;24;3;12;077;Campsegret;389;7;396
75;Nouvelle-Aquitaine;24;1;08;080;Capdrot;502;4;506
75;Nouvelle-Aquitaine;24;4;20;081;Carlux;629;10;639
75;Nouvelle-Aquitaine;24;4;20;082;Carsac-Aillac;1578;29;1607
75;Nouvelle-Aquitaine;24;1;11;083;Carsac-de-Gurson;190;4;194
75;Nouvelle-Aquitaine;24;4;23;084;Carves;104;4;108
75;Nouvelle-Aquitaine;24;4;20;085;La Cassagne;151;1;152
75;Nouvelle-Aquitaine;24;4;23;086;Castelnaud-la-Chapelle;457;7;464
75;Nouvelle-Aquitaine;24;4;23;087;Castels et Bézenac;809;18;827
75;Nouvelle-Aquitaine;24;1;08;088;Cause-de-Clérans;345;7;352
75;Nouvelle-Aquitaine;24;4;20;089;Cazoulès;456;13;469
75;Nouvelle-Aquitaine;24;3;16;090;Celles;587;11;598
75;Nouvelle-Aquitaine;24;4;23;091;Cénac-et-Saint-Julien;1206;33;1239
75;Nouvelle-Aquitaine;24;3;12;094;Chalagnac;435;9;444
75;Nouvelle-Aquitaine;24;2;21;095;Chalais;404;9;413
75;Nouvelle-Aquitaine;24;2;03;096;Champagnac-de-Belair;752;14;766
75;Nouvelle-Aquitaine;24;3;16;097;Champagne-et-Fontaine;387;11;398
75;Nouvelle-Aquitaine;24;3;22;098;Champcevinel;2880;86;2966
75;Nouvelle-Aquitaine;24;2;13;100;Champniers-et-Reilhac;455;4;459
75;Nouvelle-Aquitaine;24;2;13;101;Champs-Romain;286;8;294
75;Nouvelle-Aquitaine;24;3;04;102;Chancelade;4262;82;4344
75;Nouvelle-Aquitaine;24;3;24;104;Chantérac;616;7;623
75;Nouvelle-Aquitaine;24;3;03;105;Chapdeuil;130;3;133
75;Nouvelle-Aquitaine;24;4;25;106;La Chapelle-Aubareil;541;13;554
75;Nouvelle-Aquitaine;24;2;03;107;La Chapelle-Faucher;414;6;420
75;Nouvelle-Aquitaine;24;3;17;108;La Chapelle-Gonaguet;1069;16;1085
75;Nouvelle-Aquitaine;24;3;16;109;La Chapelle-Grésignac;108;4;112
75;Nouvelle-Aquitaine;24;3;16;110;La Chapelle-Montabourlet;62;4;66
75;Nouvelle-Aquitaine;24;2;03;111;La Chapelle-Montmoreau;68;2;70
75;Nouvelle-Aquitaine;24;4;05;113;La Chapelle-Saint-Jean;91;1;92
75;Nouvelle-Aquitaine;24;3;16;114;Chassaignes;68;2;70
75;Nouvelle-Aquitaine;24;3;22;115;Château-l'Évêque;2170;36;2206
75;Nouvelle-Aquitaine;24;4;05;116;Châtres;194;1;195
75;Nouvelle-Aquitaine;24;3;16;119;Cherval;274;8;282
75;Nouvelle-Aquitaine;24;2;06;120;Cherveix-Cubas;569;12;581
75;Nouvelle-Aquitaine;24;4;05;121;Chourgnac;60;2;62
75;Nouvelle-Aquitaine;24;4;23;122;Cladech;105;1;106
75;Nouvelle-Aquitaine;24;2;06;124;Clermont-d'Excideuil;232;5;237
75;Nouvelle-Aquitaine;24;3;12;123;Clermont-de-Beauregard;105;1;106
75;Nouvelle-Aquitaine;24;1;19;126;Colombier;257;12;269
75;Nouvelle-Aquitaine;24;4;87;364;Coly-Saint-Amand;592;20;612
75;Nouvelle-Aquitaine;24;3;16;128;Comberanche-et-Épeluche;168;3;171
75;Nouvelle-Aquitaine;24;2;03;129;Condat-sur-Trincou;480;8;488
75;Nouvelle-Aquitaine;24;4;20;130;Condat-sur-Vézère;882;16;898
75;Nouvelle-Aquitaine;24;1;19;132;Conne-de-Labarde;246;4;250
75;Nouvelle-Aquitaine;24;2;13;131;Connezac;74;0;74
75;Nouvelle-Aquitaine;24;2;21;133;La Coquille;1324;17;1341
75;Nouvelle-Aquitaine;24;2;21;134;Corgnac-sur-l'Isle;835;13;848
75;Nouvelle-Aquitaine;24;3;22;135;Cornille;676;13;689
75;Nouvelle-Aquitaine;24;4;20;117;Les Coteaux Périgourdins;590;9;599
75;Nouvelle-Aquitaine;24;4;05;136;Coubjours;128;1;129
75;Nouvelle-Aquitaine;24;2;06;137;Coulaures;733;88;821
75;Nouvelle-Aquitaine;24;3;04;138;Coulounieix-Chamiers;7703;305;8008
75;Nouvelle-Aquitaine;24;1;02;140;Cours-de-Pile;1578;33;1611
75;Nouvelle-Aquitaine;24;3;17;139;Coursac;2149;44;2193
75;Nouvelle-Aquitaine;24;3;16;141;Coutures;185;1;186
75;Nouvelle-Aquitaine;24;4;23;142;Coux et Bigaroque-Mouzens;1220;40;1260
75;Nouvelle-Aquitaine;24;1;08;143;Couze-et-Saint-Front;716;10;726
75;Nouvelle-Aquitaine;24;3;03;144;Creyssac;99;0;99
75;Nouvelle-Aquitaine;24;1;02;145;Creysse;1740;32;1772
75;Nouvelle-Aquitaine;24;3;12;146;Creyssensac-et-Pissot;262;9;271
75;Nouvelle-Aquitaine;24;2;06;147;Cubjac-Auvézère-Val d'Ans;1083;9;1092
75;Nouvelle-Aquitaine;24;1;19;148;Cunèges;290;5;295
75;Nouvelle-Aquitaine;24;4;23;150;Daglan;538;19;557
75;Nouvelle-Aquitaine;24;4;23;151;Doissat;105;5;110
75;Nouvelle-Aquitaine;24;4;23;152;Domme;911;22;933
75;Nouvelle-Aquitaine;24;4;20;153;La Dornac;397;11;408
75;Nouvelle-Aquitaine;24;3;03;154;Douchapt;359;9;368
75;Nouvelle-Aquitaine;24;3;12;155;Douville;451;10;461
75;Nouvelle-Aquitaine;24;3;07;156;La Douze;1150;16;1166
75;Nouvelle-Aquitaine;24;3;24;157;Douzillac;795;12;807
75;Nouvelle-Aquitaine;24;2;06;158;Dussac;404;4;408
75;Nouvelle-Aquitaine;24;3;09;159;Échourgnac;392;7;399
75;Nouvelle-Aquitaine;24;3;12;161;Église-Neuve-d'Issac;140;3;143
75;Nouvelle-Aquitaine;24;3;12;160;Église-Neuve-de-Vergt;552;2;554
75;Nouvelle-Aquitaine;24;3;22;162;Escoire;418;9;427
75;Nouvelle-Aquitaine;24;2;13;163;Étouars;155;1;156
75;Nouvelle-Aquitaine;24;2;06;164;Excideuil;1177;41;1218
75;Nouvelle-Aquitaine;24;3;09;165;Eygurande-et-Gardedeuil;403;7;410
75;Nouvelle-Aquitaine;24;1;19;167;Eymet;2630;44;2674
75;Nouvelle-Aquitaine;24;3;12;259;Eyraud-Crempse-Maurens;1595;30;1625
75;Nouvelle-Aquitaine;24;2;21;171;Eyzerac;560;9;569
75;Nouvelle-Aquitaine;24;4;25;172;Les Eyzies;1100;16;1116
75;Nouvelle-Aquitaine;24;4;25;174;Fanlac;139;1;140
75;Nouvelle-Aquitaine;24;4;25;175;Les Farges;319;17;336
75;Nouvelle-Aquitaine;24;1;19;176;Faurilles;36;0;36
75;Nouvelle-Aquitaine;24;1;19;177;Faux;630;10;640
75;Nouvelle-Aquitaine;24;4;20;179;La Feuillade;732;21;753
75;Nouvelle-Aquitaine;24;2;21;180;Firbeix;307;9;316
75;Nouvelle-Aquitaine;24;1;10;182;Le Fleix;1485;52;1537
75;Nouvelle-Aquitaine;24;4;25;183;Fleurac;244;11;255
75;Nouvelle-Aquitaine;24;4;23;184;Florimont-Gaumier;142;2;144
75;Nouvelle-Aquitaine;24;1;19;186;Fonroque;326;2;328
75;Nouvelle-Aquitaine;24;1;10;222;La Force;2674;124;2798
75;Nouvelle-Aquitaine;24;4;05;188;Fossemagne;537;13;550
75;Nouvelle-Aquitaine;24;1;11;189;Fougueyrolles;479;17;496
75;Nouvelle-Aquitaine;24;3;12;190;Fouleix;248;8;256
75;Nouvelle-Aquitaine;24;1;10;191;Fraisse;172;1;173
75;Nouvelle-Aquitaine;24;4;05;192;Gabillou;94;3;97
75;Nouvelle-Aquitaine;24;1;19;193;Gageac-et-Rouillac;465;9;474
75;Nouvelle-Aquitaine;24;1;10;194;Gardonne;1592;25;1617
75;Nouvelle-Aquitaine;24;1;08;195;Gaugeac;112;1;113
75;Nouvelle-Aquitaine;24;2;06;196;Génis;478;4;482
75;Nouvelle-Aquitaine;24;1;10;197;Ginestet;729;14;743
75;Nouvelle-Aquitaine;24;3;16;199;Gout-Rossignol;379;7;386
75;Nouvelle-Aquitaine;24;3;03;200;Grand-Brassac;535;11;546
75;Nouvelle-Aquitaine;24;4;05;202;Granges-d'Ans;152;4;156
75;Nouvelle-Aquitaine;24;3;17;205;Grignols;672;10;682
75;Nouvelle-Aquitaine;24;4;23;206;Grives;120;4;124
75;Nouvelle-Aquitaine;24;4;23;207;Groléjac;654;16;670
75;Nouvelle-Aquitaine;24;3;12;208;Grun-Bordas;227;4;231
75;Nouvelle-Aquitaine;24;2;13;209;Hautefaye;136;1;137
75;Nouvelle-Aquitaine;24;4;05;210;Hautefort;928;16;944
75;Nouvelle-Aquitaine;24;3;12;211;Issac;445;5;450
75;Nouvelle-Aquitaine;24;1;19;212;Issigeac;757;10;767
75;Nouvelle-Aquitaine;24;3;17;213;Jaure;170;2;172
75;Nouvelle-Aquitaine;24;2;13;214;Javerlhac-et-la-Chapelle-Saint-Robert;846;10;856
75;Nouvelle-Aquitaine;24;4;20;215;Jayac;175;3;178
75;Nouvelle-Aquitaine;24;3;16;216;La Jemaye-Ponteyraud;154;3;157
75;Nouvelle-Aquitaine;24;4;25;217;Journiac;437;8;445
75;Nouvelle-Aquitaine;24;2;21;218;Jumilhac-le-Grand;1237;52;1289
75;Nouvelle-Aquitaine;24;3;12;220;Lacropte;651;13;664
75;Nouvelle-Aquitaine;24;1;08;223;Lalinde;2794;37;2831
75;Nouvelle-Aquitaine;24;1;02;224;Lamonzie-Montastruc;709;13;722
75;Nouvelle-Aquitaine;24;1;10;225;Lamonzie-Saint-Martin;2532;35;2567
75;Nouvelle-Aquitaine;24;1;11;226;Lamothe-Montravel;1330;21;1351
75;Nouvelle-Aquitaine;24;2;06;227;Lanouaille;1017;12;1029
75;Nouvelle-Aquitaine;24;1;08;228;Lanquais;496;14;510
75;Nouvelle-Aquitaine;24;4;05;229;Le Lardin-Saint-Lazare;1753;38;1791
75;Nouvelle-Aquitaine;24;4;23;230;Larzac;144;1;145
75;Nouvelle-Aquitaine;24;1;08;231;Lavalade;81;2;83
75;Nouvelle-Aquitaine;24;4;23;232;Lavaur;70;2;72
75;Nouvelle-Aquitaine;24;3;24;234;Les Lèches;368;2;370
75;Nouvelle-Aquitaine;24;3;17;236;Léguillac-de-l'Auche;994;14;1008
75;Nouvelle-Aquitaine;24;1;02;237;Lembras;1142;36;1178
75;Nouvelle-Aquitaine;24;2;21;238;Lempzours;134;5;139
75;Nouvelle-Aquitaine;24;4;12;240;Limeuil;336;12;348
75;Nouvelle-Aquitaine;24;4;05;241;Limeyrat;445;10;455
75;Nouvelle-Aquitaine;24;1;08;242;Liorac-sur-Louyre;245;1;246
75;Nouvelle-Aquitaine;24;3;03;243;Lisle;859;11;870
75;Nouvelle-Aquitaine;24;1;08;244;Lolme;197;2;199
75;Nouvelle-Aquitaine;24;4;23;245;Loubejac;264;3;267
75;Nouvelle-Aquitaine;24;1;10;246;Lunas;386;5;391
75;Nouvelle-Aquitaine;24;3;16;247;Lusignac;180;1;181
75;Nouvelle-Aquitaine;24;2;13;248;Lussas-et-Nontronneau;300;7;307
75;Nouvelle-Aquitaine;24;3;17;251;Manzac-sur-Vern;593;13;606
75;Nouvelle-Aquitaine;24;4;18;252;Marcillac-Saint-Quentin;792;19;811
75;Nouvelle-Aquitaine;24;2;03;253;Mareuil en Périgord;2342;48;2390
75;Nouvelle-Aquitaine;24;4;23;254;Marnac;188;1;189
75;Nouvelle-Aquitaine;24;4;18;255;Marquay;577;9;586
75;Nouvelle-Aquitaine;24;3;04;256;Marsac-sur-l'Isle;3104;74;3178
75;Nouvelle-Aquitaine;24;1;08;257;Marsalès;234;3;237
75;Nouvelle-Aquitaine;24;1;08;260;Mauzac-et-Grand-Castang;864;9;873
75;Nouvelle-Aquitaine;24;4;25;261;Mauzens-et-Miremont;301;11;312
75;Nouvelle-Aquitaine;24;2;06;262;Mayac;342;7;349
75;Nouvelle-Aquitaine;24;4;23;263;Mazeyrolles;305;11;316
75;Nouvelle-Aquitaine;24;3;09;264;Ménesplet;1817;15;1832
75;Nouvelle-Aquitaine;24;3;17;266;Mensignac;1521;26;1547
75;Nouvelle-Aquitaine;24;1;19;267;Mescoules;176;1;177
75;Nouvelle-Aquitaine;24;4;23;268;Meyrals;641;13;654
75;Nouvelle-Aquitaine;24;2;21;269;Mialet;613;9;622
75;Nouvelle-Aquitaine;24;2;13;271;Milhac-de-Nontron;505;13;518
75;Nouvelle-Aquitaine;24;1;11;272;Minzac;458;5;463
75;Nouvelle-Aquitaine;24;1;08;273;Molières;330;10;340
75;Nouvelle-Aquitaine;24;1;19;274;Monbazillac;829;90;919
75;Nouvelle-Aquitaine;24;1;19;276;Monestier;390;4;394
75;Nouvelle-Aquitaine;24;1;10;277;Monfaucon;294;4;298
75;Nouvelle-Aquitaine;24;1;19;278;Monmadalès;82;1;83
75;Nouvelle-Aquitaine;24;1;19;279;Monmarvès;64;0;64
75;Nouvelle-Aquitaine;24;1;08;280;Monpazier;473;6;479
75;Nouvelle-Aquitaine;24;4;23;293;Monplaisant;296;4;300
75;Nouvelle-Aquitaine;24;1;08;281;Monsac;192;7;199
75;Nouvelle-Aquitaine;24;1;19;282;Monsaguel;152;7;159
75;Nouvelle-Aquitaine;24;4;05;284;Montagnac-d'Auberoche;146;5;151
75;Nouvelle-Aquitaine;24;3;12;285;Montagnac-la-Crempse;392;13;405
75;Nouvelle-Aquitaine;24;3;03;286;Montagrier;516;10;526
75;Nouvelle-Aquitaine;24;1;19;287;Montaut;130;2;132
75;Nouvelle-Aquitaine;24;1;11;288;Montazeau;296;4;300
75;Nouvelle-Aquitaine;24;1;11;289;Montcaret;1455;20;1475
75;Nouvelle-Aquitaine;24;1;08;290;Montferrand-du-Périgord;157;4;161
75;Nouvelle-Aquitaine;24;4;25;291;Montignac;2770;53;2823
75;Nouvelle-Aquitaine;24;1;11;292;Montpeyroux;442;7;449
75;Nouvelle-Aquitaine;24;3;09;294;Montpon-Ménestérol;5498;80;5578
75;Nouvelle-Aquitaine;24;3;17;295;Montrem;1250;28;1278
75;Nouvelle-Aquitaine;24;1;02;296;Mouleydier;1132;18;1150
75;Nouvelle-Aquitaine;24;3;09;297;Moulin-Neuf;926;14;940
75;Nouvelle-Aquitaine;24;3;24;299;Mussidan;2710;54;2764
75;Nouvelle-Aquitaine;24;4;23;300;Nabirat;370;10;380
75;Nouvelle-Aquitaine;24;4;20;301;Nadaillac;376;4;380
75;Nouvelle-Aquitaine;24;4;05;302;Nailhac;333;2;335
75;Nouvelle-Aquitaine;24;3;16;303;Nanteuil-Auriac-de-Bourzac;224;3;227
75;Nouvelle-Aquitaine;24;2;21;304;Nantheuil;966;22;988
75;Nouvelle-Aquitaine;24;2;21;305;Nanthiat;239;2;241
75;Nouvelle-Aquitaine;24;1;11;306;Nastringues;117;4;121
75;Nouvelle-Aquitaine;24;1;08;307;Naussannes;253;5;258
75;Nouvelle-Aquitaine;24;2;21;308;Négrondes;815;10;825
75;Nouvelle-Aquitaine;24;3;24;309;Neuvic;3589;66;3655
75;Nouvelle-Aquitaine;24;2;13;311;Nontron;3050;110;3160
75;Nouvelle-Aquitaine;24;4;23;313;Orliac;60;2;62
75;Nouvelle-Aquitaine;24;4;20;314;Orliaguet;106;9;115
75;Nouvelle-Aquitaine;24;3;09;316;Parcoul-Chenaud;775;17;792
75;Nouvelle-Aquitaine;24;4;20;317;Paulin;259;4;263
75;Nouvelle-Aquitaine;24;3;12;318;Paunat;308;6;314
75;Nouvelle-Aquitaine;24;3;03;319;Paussac-et-Saint-Vivien;468;7;475
75;Nouvelle-Aquitaine;24;4;23;035;Pays de Belvès;1419;34;1453
75;Nouvelle-Aquitaine;24;2;06;320;Payzac;980;18;998
75;Nouvelle-Aquitaine;24;4;20;321;Pazayac;880;13;893
75;Nouvelle-Aquitaine;24;3;99;322;Périgueux;29966;1586;31552
75;Nouvelle-Aquitaine;24;3;16;323;Petit-Bersac;181;4;185
75;Nouvelle-Aquitaine;24;4;05;324;Peyrignac;580;9;589
75;Nouvelle-Aquitaine;24;4;20;325;Peyrillac-et-Millac;223;3;226
75;Nouvelle-Aquitaine;24;4;25;326;Peyzac-le-Moustier;174;3;177
75;Nouvelle-Aquitaine;24;1;08;327;Pezuls;122;3;125
75;Nouvelle-Aquitaine;24;2;13;328;Piégut-Pluviers;1166;34;1200
75;Nouvelle-Aquitaine;24;3;09;329;Le Pizou;1317;16;1333
75;Nouvelle-Aquitaine;24;1;19;168;Plaisance;423;12;435
75;Nouvelle-Aquitaine;24;4;25;330;Plazac;691;27;718
75;Nouvelle-Aquitaine;24;1;19;331;Pomport;739;23;762
75;Nouvelle-Aquitaine;24;1;08;334;Pontours;191;5;196
75;Nouvelle-Aquitaine;24;1;11;335;Port-Sainte-Foy-et-Ponchapt;2498;46;2544
75;Nouvelle-Aquitaine;24;4;20;336;Prats-de-Carlux;547;20;567
75;Nouvelle-Aquitaine;24;4;23;337;Prats-du-Périgord;147;2;149
75;Nouvelle-Aquitaine;24;1;08;338;Pressignac-Vicq;432;11;443
75;Nouvelle-Aquitaine;24;2;06;339;Preyssac-d'Excideuil;161;0;161
75;Nouvelle-Aquitaine;24;1;10;340;Prigonrieux;4157;78;4235
75;Nouvelle-Aquitaine;24;4;18;341;Proissans;1022;20;1042
75;Nouvelle-Aquitaine;24;1;02;345;Queyssac;466;14;480
75;Nouvelle-Aquitaine;24;2;03;346;Quinsac;362;8;370
75;Nouvelle-Aquitaine;24;1;08;347;Rampieux;150;0;150
75;Nouvelle-Aquitaine;24;1;19;348;Razac-d'Eymet;289;4;293
75;Nouvelle-Aquitaine;24;1;19;349;Razac-de-Saussignac;332;17;349
75;Nouvelle-Aquitaine;24;3;04;350;Razac-sur-l'Isle;2395;41;2436
75;Nouvelle-Aquitaine;24;1;19;351;Ribagnac;308;6;314
75;Nouvelle-Aquitaine;24;3;16;352;Ribérac;3861;147;4008
75;Nouvelle-Aquitaine;24;3;09;354;La Roche-Chalais;2999;53;3052
75;Nouvelle-Aquitaine;24;2;03;353;La Rochebeaucourt-et-Argentine;322;9;331
75;Nouvelle-Aquitaine;24;4;18;355;La Roque-Gageac;440;4;444
75;Nouvelle-Aquitaine;24;1;19;357;Rouffignac-de-Sigoulès;311;6;317
75;Nouvelle-Aquitaine;24;4;25;356;Rouffignac-Saint-Cernin-de-Reilhac;1603;35;1638
75;Nouvelle-Aquitaine;24;2;03;221;Rudeau-Ladosse;160;2;162
75;Nouvelle-Aquitaine;24;1;19;359;Sadillac;119;0;119
75;Nouvelle-Aquitaine;24;4;23;360;Sagelat;313;6;319
75;Nouvelle-Aquitaine;24;1;08;361;Saint-Agne;441;7;448
75;Nouvelle-Aquitaine;24;3;12;365;Saint-Amand-de-Vergt;243;8;251
75;Nouvelle-Aquitaine;24;4;18;366;Saint-André-d'Allas;833;19;852
75;Nouvelle-Aquitaine;24;3;16;367;Saint-André-de-Double;173;2;175
75;Nouvelle-Aquitaine;24;1;11;370;Saint-Antoine-de-Breuilh;1877;40;1917
75;Nouvelle-Aquitaine;24;3;24;371;Saint-Aquilin;479;3;482
75;Nouvelle-Aquitaine;24;3;17;372;Saint-Astier;5492;98;5590
75;Nouvelle-Aquitaine;24;1;19;373;Saint-Aubin-de-Cadelech;336;4;340
75;Nouvelle-Aquitaine;24;1;19;374;Saint-Aubin-de-Lanquais;343;4;347
75;Nouvelle-Aquitaine;24;4;23;375;Saint-Aubin-de-Nabirat;143;3;146
75;Nouvelle-Aquitaine;24;3;09;376;Saint Aulaye-Puymangou;1434;17;1451
75;Nouvelle-Aquitaine;24;4;25;377;Saint-Avit-de-Vialard;160;7;167
75;Nouvelle-Aquitaine;24;1;08;378;Saint-Avit-Rivière;78;4;82
75;Nouvelle-Aquitaine;24;1;08;379;Saint-Avit-Sénieur;439;4;443
75;Nouvelle-Aquitaine;24;3;09;380;Saint-Barthélemy-de-Bellegarde;505;2;507
75;Nouvelle-Aquitaine;24;2;13;381;Saint-Barthélemy-de-Bussière;214;8;222
75;Nouvelle-Aquitaine;24;1;19;383;Saint-Capraise-d'Eymet;156;2;158
75;Nouvelle-Aquitaine;24;1;08;382;Saint-Capraise-de-Lalinde;531;11;542
75;Nouvelle-Aquitaine;24;1;08;384;Saint-Cassien;34;2;36
75;Nouvelle-Aquitaine;24;4;23;386;Saint-Cernin-de-l'Herm;234;4;238
75;Nouvelle-Aquitaine;24;1;19;385;Saint-Cernin-de-Labarde;211;2;213
75;Nouvelle-Aquitaine;24;4;25;388;Saint-Chamassy;514;16;530
75;Nouvelle-Aquitaine;24;3;07;390;Saint-Crépin-d'Auberoche;356;5;361
75;Nouvelle-Aquitaine;24;4;20;392;Saint-Crépin-et-Carlucet;520;10;530
75;Nouvelle-Aquitaine;24;4;23;395;Saint-Cybranet;385;6;391
75;Nouvelle-Aquitaine;24;4;23;396;Saint-Cyprien;1561;34;1595
75;Nouvelle-Aquitaine;24;2;06;397;Saint-Cyr-les-Champagnes;244;7;251
75;Nouvelle-Aquitaine;24;2;13;398;Saint-Estèphe;613;19;632
75;Nouvelle-Aquitaine;24;3;24;399;Saint-Étienne-de-Puycorbier;106;4;110
75;Nouvelle-Aquitaine;24;2;03;403;Saint-Félix-de-Bourdeilles;62;0;62
75;Nouvelle-Aquitaine;24;4;25;404;Saint-Félix-de-Reillac-et-Mortemart;184;5;189
75;Nouvelle-Aquitaine;24;1;08;405;Saint-Félix-de-Villadeix;327;9;336
75;Nouvelle-Aquitaine;24;2;21;408;Saint-Front-d'Alemps;262;4;266
75;Nouvelle-Aquitaine;24;3;24;409;Saint-Front-de-Pradoux;1160;15;1175
75;Nouvelle-Aquitaine;24;2;13;410;Saint-Front-la-Rivière;518;8;526
75;Nouvelle-Aquitaine;24;2;13;411;Saint-Front-sur-Nizonne;157;2;159
75;Nouvelle-Aquitaine;24;4;20;412;Saint-Geniès;939;26;965
75;Nouvelle-Aquitaine;24;1;10;413;Saint-Georges-Blancaneix;252;0;252
75;Nouvelle-Aquitaine;24;3;12;414;Saint-Georges-de-Montclard;291;5;296
75;Nouvelle-Aquitaine;24;1;11;415;Saint-Géraud-de-Corps;243;2;245
75;Nouvelle-Aquitaine;24;4;23;416;Saint-Germain-de-Belvès;176;9;185
75;Nouvelle-Aquitaine;24;2;06;417;Saint-Germain-des-Prés;498;8;506
75;Nouvelle-Aquitaine;24;3;24;418;Saint-Germain-du-Salembre;941;7;948
75;Nouvelle-Aquitaine;24;1;02;419;Saint-Germain-et-Mons;829;18;847
75;Nouvelle-Aquitaine;24;1;10;420;Saint-Géry;236;2;238
75;Nouvelle-Aquitaine;24;3;07;421;Saint-Geyrac;198;6;204
75;Nouvelle-Aquitaine;24;3;12;422;Saint-Hilaire-d'Estissac;112;2;114
75;Nouvelle-Aquitaine;24;3;24;424;Saint-Jean-d'Ataux;128;3;131
75;Nouvelle-Aquitaine;24;3;12;426;Saint-Jean-d'Estissac;177;0;177
75;Nouvelle-Aquitaine;24;2;21;425;Saint-Jean-de-Côle;365;6;371
75;Nouvelle-Aquitaine;24;2;21;428;Saint-Jory-de-Chalais;584;38;622
75;Nouvelle-Aquitaine;24;2;06;429;Saint-Jory-las-Bloux;236;8;244
75;Nouvelle-Aquitaine;24;4;20;432;Saint-Julien-de-Lampon;626;18;644
75;Nouvelle-Aquitaine;24;1;19;423;Saint-Julien-Innocence-Eulalie;301;3;304
75;Nouvelle-Aquitaine;24;3;03;434;Saint-Just;136;2;138
75;Nouvelle-Aquitaine;24;3;24;436;Saint-Laurent-des-Hommes;1018;18;1036
75;Nouvelle-Aquitaine;24;1;10;437;Saint-Laurent-des-Vignes;886;13;899
75;Nouvelle-Aquitaine;24;4;23;438;Saint-Laurent-la-Vallée;247;9;256
75;Nouvelle-Aquitaine;24;1;19;441;Saint-Léon-d'Issigeac;126;4;130
75;Nouvelle-Aquitaine;24;3;17;442;Saint-Léon-sur-l'Isle;2027;23;2050
75;Nouvelle-Aquitaine;24;4;25;443;Saint-Léon-sur-Vézère;425;12;437
75;Nouvelle-Aquitaine;24;3;24;444;Saint-Louis-en-l'Isle;303;5;308
75;Nouvelle-Aquitaine;24;3;12;459;Saint-Maime-de-Péreyrol;283;8;291
75;Nouvelle-Aquitaine;24;1;08;445;Saint-Marcel-du-Périgord;147;2;149
75;Nouvelle-Aquitaine;24;1;08;446;Saint-Marcory;50;3;53
75;Nouvelle-Aquitaine;24;2;06;448;Saint-Martial-d'Albarède;464;7;471
75;Nouvelle-Aquitaine;24;3;09;449;Saint-Martial-d'Artenset;955;7;962
75;Nouvelle-Aquitaine;24;4;23;450;Saint-Martial-de-Nabirat;584;4;588
75;Nouvelle-Aquitaine;24;2;13;451;Saint-Martial-de-Valette;789;14;803
75;Nouvelle-Aquitaine;24;3;16;452;Saint-Martial-Viveyrol;195;2;197
75;Nouvelle-Aquitaine;24;2;21;453;Saint-Martin-de-Fressengeas;359;6;365
75;Nouvelle-Aquitaine;24;1;11;454;Saint-Martin-de-Gurson;666;8;674
75;Nouvelle-Aquitaine;24;3;16;455;Saint-Martin-de-Ribérac;716;10;726
75;Nouvelle-Aquitaine;24;3;12;456;Saint-Martin-des-Combes;186;8;194
75;Nouvelle-Aquitaine;24;3;24;457;Saint-Martin-l'Astier;138;1;139
75;Nouvelle-Aquitaine;24;2;13;458;Saint-Martin-le-Pin;271;7;278
75;Nouvelle-Aquitaine;24;3;16;460;Saint-Méard-de-Drône;497;6;503
75;Nouvelle-Aquitaine;24;1;11;461;Saint-Méard-de-Gurçon;813;18;831
75;Nouvelle-Aquitaine;24;2;06;463;Saint-Médard-d'Excideuil;546;16;562
75;Nouvelle-Aquitaine;24;3;24;462;Saint-Médard-de-Mussidan;1713;24;1737
75;Nouvelle-Aquitaine;24;2;06;464;Saint-Mesmin;318;5;323
75;Nouvelle-Aquitaine;24;3;24;465;Saint-Michel-de-Double;240;6;246
75;Nouvelle-Aquitaine;24;1;11;466;Saint-Michel-de-Montaigne;337;5;342
75;Nouvelle-Aquitaine;24;3;12;468;Saint-Michel-de-Villadeix;309;6;315
75;Nouvelle-Aquitaine;24;1;02;472;Saint-Nexans;967;18;985
75;Nouvelle-Aquitaine;24;2;03;474;Saint-Pancrace;187;0;187
75;Nouvelle-Aquitaine;24;2;06;476;Saint-Pantaly-d'Excideuil;150;3;153
75;Nouvelle-Aquitaine;24;3;16;477;Saint-Pardoux-de-Drône;198;5;203
75;Nouvelle-Aquitaine;24;4;23;478;Saint-Pardoux-et-Vielvic;211;0;211
75;Nouvelle-Aquitaine;24;2;13;479;Saint-Pardoux-la-Rivière;1179;13;1192
75;Nouvelle-Aquitaine;24;3;12;480;Saint-Paul-de-Serre;280;8;288
75;Nouvelle-Aquitaine;24;2;21;481;Saint-Paul-la-Roche;525;0;525
75;Nouvelle-Aquitaine;24;3;16;482;Saint-Paul-Lizonne;273;3;276
75;Nouvelle-Aquitaine;24;1;19;483;Saint-Perdoux;137;0;137
75;Nouvelle-Aquitaine;24;1;10;487;Saint-Pierre-d'Eyraud;1795;16;1811
75;Nouvelle-Aquitaine;24;3;07;484;Saint-Pierre-de-Chignac;871;17;888
75;Nouvelle-Aquitaine;24;2;21;485;Saint-Pierre-de-Côle;430;2;432
75;Nouvelle-Aquitaine;24;2;21;486;Saint-Pierre-de-Frugie;398;3;401
75;Nouvelle-Aquitaine;24;4;23;488;Saint-Pompont;372;6;378
75;Nouvelle-Aquitaine;24;2;21;489;Saint-Priest-les-Fougères;381;5;386
75;Nouvelle-Aquitaine;24;3;09;490;Saint Privat en Périgord;1121;30;1151
75;Nouvelle-Aquitaine;24;4;05;491;Saint-Rabier;585;9;594
75;Nouvelle-Aquitaine;24;2;06;493;Saint-Raphaël;94;3;97
75;Nouvelle-Aquitaine;24;1;11;494;Saint-Rémy;516;1;517
75;Nouvelle-Aquitaine;24;1;08;495;Saint-Romain-de-Monpazier;110;4;114
75;Nouvelle-Aquitaine;24;2;21;496;Saint-Romain-et-Saint-Clément;328;4;332
75;Nouvelle-Aquitaine;24;2;13;498;Saint-Saud-Lacoussière;832;14;846
75;Nouvelle-Aquitaine;24;1;02;499;Saint-Sauveur;847;21;868
75;Nouvelle-Aquitaine;24;3;09;500;Saint-Sauveur-Lalande;156;1;157
75;Nouvelle-Aquitaine;24;1;11;501;Saint-Seurin-de-Prats;494;8;502
75;Nouvelle-Aquitaine;24;3;24;502;Saint-Séverin-d'Estissac;100;0;100
75;Nouvelle-Aquitaine;24;2;06;505;Saint-Sulpice-d'Excideuil;344;3;347
75;Nouvelle-Aquitaine;24;3;16;504;Saint-Sulpice-de-Roumagnac;279;1;280
75;Nouvelle-Aquitaine;24;3;03;508;Saint-Victor;203;0;203
75;Nouvelle-Aquitaine;24;3;16;509;Saint-Vincent-de-Connezac;662;12;674
75;Nouvelle-Aquitaine;24;4;18;510;Saint-Vincent-de-Cosse;364;12;376
75;Nouvelle-Aquitaine;24;3;09;511;Saint-Vincent-Jalmoutiers;250;3;253
75;Nouvelle-Aquitaine;24;4;18;512;Saint-Vincent-le-Paluel;276;10;286
75;Nouvelle-Aquitaine;24;2;06;513;Saint-Vincent-sur-l'Isle;306;3;309
75;Nouvelle-Aquitaine;24;1;11;514;Saint-Vivien;250;7;257
75;Nouvelle-Aquitaine;24;1;08;393;Sainte-Croix;87;0;87
75;Nouvelle-Aquitaine;24;2;03;394;Sainte-Croix-de-Mareuil;150;6;156
75;Nouvelle-Aquitaine;24;4;05;401;Sainte-Eulalie-d'Ans;288;3;291
75;Nouvelle-Aquitaine;24;4;23;406;Sainte-Foy-de-Belvès;139;2;141
75;Nouvelle-Aquitaine;24;1;08;407;Sainte-Foy-de-Longas;237;7;244
75;Nouvelle-Aquitaine;24;4;20;470;Sainte-Mondane;260;5;265
75;Nouvelle-Aquitaine;24;4;18;471;Sainte-Nathalène;595;12;607
75;Nouvelle-Aquitaine;24;4;05;473;Sainte-Orse;358;6;364
75;Nouvelle-Aquitaine;24;1;19;492;Sainte-Radegonde;62;1;63
75;Nouvelle-Aquitaine;24;4;05;507;Sainte-Trie;110;2;112
75;Nouvelle-Aquitaine;24;2;06;515;Salagnac;769;4;773
75;Nouvelle-Aquitaine;24;4;20;516;Salignac-Eyvigues;1159;54;1213
75;Nouvelle-Aquitaine;24;4;23;517;Salles-de-Belvès;71;2;73
75;Nouvelle-Aquitaine;24;3;12;518;Salon;277;4;281
75;Nouvelle-Aquitaine;24;3;88;312;Sanilhac;4548;103;4651
75;Nouvelle-Aquitaine;24;2;06;519;Sarlande;432;0;432
75;Nouvelle-Aquitaine;24;4;18;520;Sarlat-la-Canéda;8869;434;9303
75;Nouvelle-Aquitaine;24;3;22;521;Sarliac-sur-l'Isle;1020;20;1040
75;Nouvelle-Aquitaine;24;2;06;522;Sarrazac;381;5;386
75;Nouvelle-Aquitaine;24;1;19;523;Saussignac;428;13;441
75;Nouvelle-Aquitaine;24;4;25;524;Savignac-de-Miremont;177;5;182
75;Nouvelle-Aquitaine;24;2;13;525;Savignac-de-Nontron;191;2;193
75;Nouvelle-Aquitaine;24;2;06;526;Savignac-Lédrier;717;9;726
75;Nouvelle-Aquitaine;24;3;06;527;Savignac-les-Églises;972;17;989
75;Nouvelle-Aquitaine;24;2;13;528;Sceau-Saint-Angel;124;2;126
75;Nouvelle-Aquitaine;24;3;03;529;Segonzac;205;3;208
75;Nouvelle-Aquitaine;24;4;25;531;Sergeac;216;3;219
75;Nouvelle-Aquitaine;24;1;19;532;Serres-et-Montguyard;237;3;240
75;Nouvelle-Aquitaine;24;3;09;533;Servanches;86;4;90
75;Nouvelle-Aquitaine;24;1;19;534;Sigoulès-et-Flaugeac;1225;236;1461
75;Nouvelle-Aquitaine;24;4;20;535;Simeyrols;258;3;261
75;Nouvelle-Aquitaine;24;1;19;536;Singleyrac;269;1;270
75;Nouvelle-Aquitaine;24;3;16;537;Siorac-de-Ribérac;251;4;255
75;Nouvelle-Aquitaine;24;4;23;538;Siorac-en-Périgord;1053;11;1064
75;Nouvelle-Aquitaine;24;3;21;540;Sorges et Ligueux en Périgord;1565;27;1592
75;Nouvelle-Aquitaine;24;2;13;541;Soudat;92;0;92
75;Nouvelle-Aquitaine;24;1;08;542;Soulaures;92;1;93
75;Nouvelle-Aquitaine;24;3;24;543;Sourzac;1107;14;1121
75;Nouvelle-Aquitaine;24;4;18;544;Tamniès;384;10;394
75;Nouvelle-Aquitaine;24;4;05;545;Teillots;102;1;103
75;Nouvelle-Aquitaine;24;4;05;546;Temple-Laguyon;41;1;42
75;Nouvelle-Aquitaine;24;4;20;547;Terrasson-Lavilledieu;6202;106;6308
75;Nouvelle-Aquitaine;24;2;13;548;Teyjat;275;5;280
75;Nouvelle-Aquitaine;24;1;19;549;Thénac;488;10;498
75;Nouvelle-Aquitaine;24;4;05;550;Thenon;1263;16;1279
75;Nouvelle-Aquitaine;24;2;21;551;Thiviers;2877;156;3033
75;Nouvelle-Aquitaine;24;4;25;552;Thonac;252;4;256
75;Nouvelle-Aquitaine;24;3;03;553;Tocane-Saint-Apre;1691;36;1727
75;Nouvelle-Aquitaine;24;3;16;554;La Tour-Blanche-Cercles;595;13;608
75;Nouvelle-Aquitaine;24;4;05;555;Tourtoirac;644;5;649
75;Nouvelle-Aquitaine;24;3;22;557;Trélissac;6658;223;6881
75;Nouvelle-Aquitaine;24;1;12;558;Trémolat;652;3;655
75;Nouvelle-Aquitaine;24;4;25;559;Tursac;339;10;349
75;Nouvelle-Aquitaine;24;1;08;560;Urval;114;7;121
75;Nouvelle-Aquitaine;24;3;12;362;Val de Louyre et Caudeau;1588;26;1614
75;Nouvelle-Aquitaine;24;3;24;562;Vallereuil;288;12;300
75;Nouvelle-Aquitaine;24;4;25;563;Valojoulx;271;8;279
75;Nouvelle-Aquitaine;24;3;16;564;Vanxains;700;88;788
75;Nouvelle-Aquitaine;24;2;13;565;Varaignes;403;9;412
75;Nouvelle-Aquitaine;24;1;08;566;Varennes;467;4;471
75;Nouvelle-Aquitaine;24;2;21;567;Vaunac;273;3;276
75;Nouvelle-Aquitaine;24;1;11;568;Vélines;1102;10;1112
75;Nouvelle-Aquitaine;24;3;16;569;Vendoire;134;2;136
75;Nouvelle-Aquitaine;24;1;08;570;Verdon;47;2;49
75;Nouvelle-Aquitaine;24;3;12;571;Vergt;1672;15;1687
75;Nouvelle-Aquitaine;24;1;08;572;Vergt-de-Biron;194;7;201
75;Nouvelle-Aquitaine;24;3;16;573;Verteillac;672;17;689
75;Nouvelle-Aquitaine;24;4;20;574;Veyrignac;335;8;343
75;Nouvelle-Aquitaine;24;4;23;575;Veyrines-de-Domme;230;22;252
75;Nouvelle-Aquitaine;24;3;12;576;Veyrines-de-Vergt;256;11;267
75;Nouvelle-Aquitaine;24;4;18;577;Vézac;587;11;598
75;Nouvelle-Aquitaine;24;4;05;580;Villac;266;2;268
75;Nouvelle-Aquitaine;24;3;12;581;Villamblard;886;19;905
75;Nouvelle-Aquitaine;24;2;03;582;Villars;463;9;472
75;Nouvelle-Aquitaine;24;1;11;584;Villefranche-de-Lonchat;973;18;991
75;Nouvelle-Aquitaine;24;4;23;585;Villefranche-du-Périgord;693;12;705
75;Nouvelle-Aquitaine;24;3;16;586;Villetoureix;906;21;927
75;Nouvelle-Aquitaine;24;4;18;587;Vitrac;800;30;830
27;Bourgogne-Franche-Comté;25;1;17;001;Abbans-Dessous;263;6;269
27;Bourgogne-Franche-Comté;25;1;17;002;Abbans-Dessus;304;5;309
27;Bourgogne-Franche-Comté;25;1;02;003;Abbenans;342;6;348
27;Bourgogne-Franche-Comté;25;2;12;004;Abbévillers;1040;20;1060
27;Bourgogne-Franche-Comté;25;2;03;005;Accolans;96;1;97
27;Bourgogne-Franche-Comté;25;1;02;006;Adam-lès-Passavant;89;2;91
27;Bourgogne-Franche-Comté;25;3;18;007;Adam-lès-Vercel;103;3;106
27;Bourgogne-Franche-Comté;25;2;03;008;Aibre;473;4;477
27;Bourgogne-Franche-Comté;25;1;02;009;Aïssey;169;3;172
27;Bourgogne-Franche-Comté;25;2;10;011;Allenjoie;735;16;751
27;Bourgogne-Franche-Comté;25;3;15;012;Les Alliés;158;5;163
27;Bourgogne-Franche-Comté;25;2;03;013;Allondans;253;3;256
27;Bourgogne-Franche-Comté;25;1;08;014;Amagney;856;11;867
27;Bourgogne-Franche-Comté;25;1;15;015;Amancey;687;20;707
27;Bourgogne-Franche-Comté;25;1;15;016;Amathay-Vésigneux;163;4;167
27;Bourgogne-Franche-Comté;25;1;15;017;Amondans;87;3;90
27;Bourgogne-Franche-Comté;25;2;03;018;Anteuil;652;24;676
27;Bourgogne-Franche-Comté;25;2;03;019;Appenans;376;10;386
27;Bourgogne-Franche-Comté;25;2;01;020;Arbouans;945;9;954
27;Bourgogne-Franche-Comté;25;1;17;021;Arc-et-Senans;1624;30;1654
27;Bourgogne-Franche-Comté;25;3;15;025;Arc-sous-Cicon;665;13;678
27;Bourgogne-Franche-Comté;25;3;11;026;Arc-sous-Montenot;195;9;204
27;Bourgogne-Franche-Comté;25;2;03;022;Arcey;1441;48;1489
27;Bourgogne-Franche-Comté;25;3;15;024;Arçon;841;15;856
27;Bourgogne-Franche-Comté;25;3;15;029;Aubonne;240;3;243
27;Bourgogne-Franche-Comté;25;1;05;030;Audeux;433;11;444
27;Bourgogne-Franche-Comté;25;2;01;031;Audincourt;13387;182;13569
27;Bourgogne-Franche-Comté;25;1;02;032;Autechaux;420;10;430
27;Bourgogne-Franche-Comté;25;2;12;033;Autechaux-Roide;523;10;533
27;Bourgogne-Franche-Comté;25;1;06;035;Les Auxons;2544;45;2589
27;Bourgogne-Franche-Comté;25;1;04;036;Avanne-Aveney;2255;31;2286
27;Bourgogne-Franche-Comté;25;1;02;038;Avilley;163;3;166
27;Bourgogne-Franche-Comté;25;3;18;039;Avoudrey;909;15;924
27;Bourgogne-Franche-Comté;25;2;01;040;Badevel;817;12;829
27;Bourgogne-Franche-Comté;25;3;11;041;Bannans;369;10;379
27;Bourgogne-Franche-Comté;25;3;14;042;Le Barboux;238;8;246
27;Bourgogne-Franche-Comté;25;2;13;043;Bart;1980;53;2033
27;Bourgogne-Franche-Comté;25;1;17;044;Bartherans;55;0;55
27;Bourgogne-Franche-Comté;25;1;02;045;Battenans-les-Mines;54;1;55
27;Bourgogne-Franche-Comté;25;2;18;046;Battenans-Varin;76;2;78
27;Bourgogne-Franche-Comté;25;1;02;047;Baume-les-Dames;5063;163;5226
27;Bourgogne-Franche-Comté;25;2;03;048;Bavans;3640;60;3700
27;Bourgogne-Franche-Comté;25;2;12;049;Belfays;138;5;143
27;Bourgogne-Franche-Comté;25;3;14;050;Le Bélieu;450;5;455
27;Bourgogne-Franche-Comté;25;2;18;051;Belleherbe;625;11;636
27;Bourgogne-Franche-Comté;25;3;18;052;Belmont;67;0;67
27;Bourgogne-Franche-Comté;25;2;03;053;Belvoir;104;7;111
27;Bourgogne-Franche-Comté;25;2;03;054;Berche;495;12;507
27;Bourgogne-Franche-Comté;25;1;17;055;Berthelange;330;8;338
27;Bourgogne-Franche-Comté;25;1;99;056;Besançon;115934;3315;119249
27;Bourgogne-Franche-Comté;25;2;10;057;Bethoncourt;5647;78;5725
27;Bourgogne-Franche-Comté;25;1;09;058;Beure;1349;11;1360
27;Bourgogne-Franche-Comté;25;2;03;059;Beutal;277;5;282
27;Bourgogne-Franche-Comté;25;3;15;060;Bians-les-Usiers;679;22;701
27;Bourgogne-Franche-Comté;25;2;12;061;Bief;114;1;115
27;Bourgogne-Franche-Comté;25;3;14;062;Le Bizot;309;8;317
27;Bourgogne-Franche-Comté;25;2;12;063;Blamont;1221;26;1247
27;Bourgogne-Franche-Comté;25;1;02;065;Blarians;57;4;61
27;Bourgogne-Franche-Comté;25;2;03;066;Blussangeaux;84;1;85
27;Bourgogne-Franche-Comté;25;2;03;067;Blussans;194;4;198
27;Bourgogne-Franche-Comté;25;1;15;070;Bolandoz;372;15;387
27;Bourgogne-Franche-Comté;25;2;12;071;Bondeval;472;11;483
27;Bourgogne-Franche-Comté;25;1;02;072;Bonnal;29;2;31
27;Bourgogne-Franche-Comté;25;1;02;073;Bonnay;837;6;843
27;Bourgogne-Franche-Comté;25;3;14;074;Bonnétage;917;20;937
27;Bourgogne-Franche-Comté;25;3;11;075;Bonnevaux;385;12;397
27;Bourgogne-Franche-Comté;25;3;14;077;La Bosse;74;0;74
27;Bourgogne-Franche-Comté;25;1;02;078;Bouclans;1073;23;1096
27;Bourgogne-Franche-Comté;25;3;11;079;Boujailles;428;9;437
27;Bourgogne-Franche-Comté;25;2;19;082;Bourguignon;914;23;937
27;Bourgogne-Franche-Comté;25;2;03;083;Bournois;192;1;193
27;Bourgogne-Franche-Comté;25;1;09;084;Boussières;1123;17;1140
27;Bourgogne-Franche-Comté;25;3;11;085;Bouverans;364;7;371
27;Bourgogne-Franche-Comté;25;1;07;086;Braillans;205;2;207
27;Bourgogne-Franche-Comté;25;2;03;087;Branne;175;3;178
27;Bourgogne-Franche-Comté;25;1;02;088;Breconchaux;93;5;98
27;Bourgogne-Franche-Comté;25;3;18;089;Bremondans;86;2;88
27;Bourgogne-Franche-Comté;25;1;17;090;Brères;62;0;62
27;Bourgogne-Franche-Comté;25;2;12;091;Les Bréseux;477;8;485
27;Bourgogne-Franche-Comté;25;1;02;092;La Bretenière;71;1;72
27;Bourgogne-Franche-Comté;25;2;03;093;Bretigney;73;0;73
27;Bourgogne-Franche-Comté;25;1;02;094;Bretigney-Notre-Dame;110;2;112
27;Bourgogne-Franche-Comté;25;3;18;095;Bretonvillers;276;3;279
27;Bourgogne-Franche-Comté;25;3;11;096;Brey-et-Maison-du-Bois;102;3;105
27;Bourgogne-Franche-Comté;25;2;10;097;Brognard;481;12;493
27;Bourgogne-Franche-Comté;25;1;17;098;Buffard;169;4;173
27;Bourgogne-Franche-Comté;25;3;15;099;Bugny;217;6;223
27;Bourgogne-Franche-Comté;25;3;11;100;Bulle;433;8;441
27;Bourgogne-Franche-Comté;25;1;17;101;Burgille;565;5;570
27;Bourgogne-Franche-Comté;25;2;12;102;Burnevillers;45;2;47
27;Bourgogne-Franche-Comté;25;1;09;103;Busy;630;13;643
27;Bourgogne-Franche-Comté;25;1;17;104;By;78;1;79
27;Bourgogne-Franche-Comté;25;1;17;105;Byans-sur-Doubs;560;6;566
27;Bourgogne-Franche-Comté;25;1;15;106;Cademène;71;0;71
27;Bourgogne-Franche-Comté;25;1;02;107;Cendrey;191;0;191
27;Bourgogne-Franche-Comté;25;2;12;108;Cernay-l'Église;302;9;311
27;Bourgogne-Franche-Comté;25;1;17;109;Cessey;333;10;343
27;Bourgogne-Franche-Comté;25;3;16;110;Chaffois;985;18;1003
27;Bourgogne-Franche-Comté;25;1;07;111;Chalèze;370;12;382
27;Bourgogne-Franche-Comté;25;1;07;112;Chalezeule;1292;18;1310
27;Bourgogne-Franche-Comté;25;3;18;113;Chamesey;136;3;139
27;Bourgogne-Franche-Comté;25;2;12;114;Chamesol;378;5;383
27;Bourgogne-Franche-Comté;25;1;05;115;Champagney;286;3;289
27;Bourgogne-Franche-Comté;25;1;02;116;Champlive;248;5;253
27;Bourgogne-Franche-Comté;25;1;07;117;Champoux;91;0;91
27;Bourgogne-Franche-Comté;25;1;05;119;Champvans-les-Moulins;340;10;350
27;Bourgogne-Franche-Comté;25;1;15;120;Chantrans;405;14;419
27;Bourgogne-Franche-Comté;25;3;11;122;Chapelle-d'Huin;514;7;521
27;Bourgogne-Franche-Comté;25;3;11;121;Chapelle-des-Bois;253;16;269
27;Bourgogne-Franche-Comté;25;2;12;124;Charmauvillers;250;6;256
27;Bourgogne-Franche-Comté;25;2;18;125;Charmoille;330;5;335
27;Bourgogne-Franche-Comté;25;1;17;126;Charnay;474;8;482
27;Bourgogne-Franche-Comté;25;2;12;127;Charquemont;2668;50;2718
27;Bourgogne-Franche-Comté;25;1;15;129;Chassagne-Saint-Denis;114;3;117
27;Bourgogne-Franche-Comté;25;1;15;130;Châteauvieux-les-Fossés;13;0;13
27;Bourgogne-Franche-Comté;25;3;11;131;Châtelblanc;120;5;125
27;Bourgogne-Franche-Comté;25;1;02;132;Châtillon-Guyotte;129;3;132
27;Bourgogne-Franche-Comté;25;1;06;133;Châtillon-le-Duc;2054;41;2095
27;Bourgogne-Franche-Comté;25;1;17;134;Châtillon-sur-Lison;9;0;9
27;Bourgogne-Franche-Comté;25;1;05;136;Chaucenne;511;13;524
27;Bourgogne-Franche-Comté;25;3;15;139;La Chaux;558;9;567
27;Bourgogne-Franche-Comté;25;3;18;141;Chaux-lès-Passavant;133;7;140
27;Bourgogne-Franche-Comté;25;3;11;142;Chaux-Neuve;318;3;321
27;Bourgogne-Franche-Comté;25;1;17;143;Chay;213;16;229
27;Bourgogne-Franche-Comté;25;2;03;145;Chazot;120;1;121
27;Bourgogne-Franche-Comté;25;1;04;147;Chemaudin et Vaux;1937;42;1979
27;Bourgogne-Franche-Comté;25;3;14;148;La Chenalotte;499;5;504
27;Bourgogne-Franche-Comté;25;1;17;149;Chenecey-Buillon;515;11;526
27;Bourgogne-Franche-Comté;25;3;18;151;Chevigney-lès-Vercel;128;5;133
27;Bourgogne-Franche-Comté;25;1;17;150;Chevigney-sur-l'Ognon;292;3;295
27;Bourgogne-Franche-Comté;25;1;08;152;La Chevillotte;147;0;147
27;Bourgogne-Franche-Comté;25;1;02;153;Chevroz;131;0;131
27;Bourgogne-Franche-Comté;25;1;17;154;Chouzelot;269;9;278
27;Bourgogne-Franche-Comté;25;1;15;155;Cléron;309;13;322
27;Bourgogne-Franche-Comté;25;3;16;157;La Cluse-et-Mijoux;1307;28;1335
27;Bourgogne-Franche-Comté;25;2;03;159;Colombier-Fontaine;1267;26;1293
27;Bourgogne-Franche-Comté;25;3;14;160;Les Combes;737;26;763
27;Bourgogne-Franche-Comté;25;3;18;161;Consolation-Maisonnettes;33;5;38
27;Bourgogne-Franche-Comté;25;1;02;163;Corcelle-Mieslot;109;1;110
27;Bourgogne-Franche-Comté;25;1;17;162;Corcelles-Ferrières;200;4;204
27;Bourgogne-Franche-Comté;25;1;17;164;Corcondray;144;2;146
27;Bourgogne-Franche-Comté;25;1;02;166;Côtebrune;80;6;86
27;Bourgogne-Franche-Comté;25;2;18;173;Cour-Saint-Maurice;156;1;157
27;Bourgogne-Franche-Comté;25;1;17;171;Courcelles;106;2;108
27;Bourgogne-Franche-Comté;25;2;13;170;Courcelles-lès-Montbéliard;1277;40;1317
27;Bourgogne-Franche-Comté;25;1;17;172;Courchapon;218;3;221
27;Bourgogne-Franche-Comté;25;2;12;174;Courtefontaine;246;3;249
27;Bourgogne-Franche-Comté;25;3;18;175;Courtetain-et-Salans;84;1;85
27;Bourgogne-Franche-Comté;25;3;11;176;Courvières;315;4;319
27;Bourgogne-Franche-Comté;25;2;03;177;Crosey-le-Grand;152;5;157
27;Bourgogne-Franche-Comté;25;2;03;178;Crosey-le-Petit;135;3;138
27;Bourgogne-Franche-Comté;25;3;11;179;Le Crouzet;59;1;60
27;Bourgogne-Franche-Comté;25;1;15;180;Crouzet-Migette;116;6;122
27;Bourgogne-Franche-Comté;25;1;02;181;Cubrial;136;4;140
27;Bourgogne-Franche-Comté;25;1;02;182;Cubry;88;0;88
27;Bourgogne-Franche-Comté;25;1;02;183;Cusance;69;1;70
27;Bourgogne-Franche-Comté;25;1;02;184;Cuse-et-Adrisans;284;12;296
27;Bourgogne-Franche-Comté;25;1;02;186;Cussey-sur-l'Ognon;1045;11;1056
27;Bourgogne-Franche-Comté;25;1;17;185;Cussey-sur-Lison;65;5;70
27;Bourgogne-Franche-Comté;25;2;19;187;Dambelin;495;6;501
27;Bourgogne-Franche-Comté;25;2;10;188;Dambenois;754;22;776
27;Bourgogne-Franche-Comté;25;1;02;189;Dammartin-les-Templiers;197;6;203
27;Bourgogne-Franche-Comté;25;2;01;190;Dampierre-les-Bois;1635;27;1662
27;Bourgogne-Franche-Comté;25;2;03;191;Dampierre-sur-le-Doubs;457;10;467
27;Bourgogne-Franche-Comté;25;2;12;192;Dampjoux;172;4;176
27;Bourgogne-Franche-Comté;25;2;12;193;Damprichard;1903;39;1942
27;Bourgogne-Franche-Comté;25;2;12;194;Dannemarie;113;0;113
27;Bourgogne-Franche-Comté;25;1;04;195;Dannemarie-sur-Crète;1473;292;1765
27;Bourgogne-Franche-Comté;25;2;01;196;Dasle;1417;35;1452
27;Bourgogne-Franche-Comté;25;1;08;197;Deluz;615;5;620
27;Bourgogne-Franche-Comté;25;2;03;198;Désandans;734;15;749
27;Bourgogne-Franche-Comté;25;1;15;199;Déservillers;339;10;349
27;Bourgogne-Franche-Comté;25;1;02;200;Devecey;1451;28;1479
27;Bourgogne-Franche-Comté;25;3;16;201;Dommartin;710;14;724
27;Bourgogne-Franche-Comté;25;3;11;202;Dompierre-les-Tilleuls;267;4;271
27;Bourgogne-Franche-Comté;25;3;18;203;Domprel;180;4;184
27;Bourgogne-Franche-Comté;25;3;16;204;Doubs;3021;89;3110
27;Bourgogne-Franche-Comté;25;2;03;207;Dung;637;17;654
27;Bourgogne-Franche-Comté;25;1;15;208;Durnes;177;4;181
27;Bourgogne-Franche-Comté;25;1;17;209;Échay;129;4;133
27;Bourgogne-Franche-Comté;25;2;03;210;Échenans;155;6;161
27;Bourgogne-Franche-Comté;25;1;15;211;Échevannes;89;0;89
27;Bourgogne-Franche-Comté;25;1;05;212;École-Valentin;2609;48;2657
27;Bourgogne-Franche-Comté;25;2;12;213;Les Écorces;718;22;740
27;Bourgogne-Franche-Comté;25;2;19;214;Écot;503;10;513
27;Bourgogne-Franche-Comté;25;1;02;215;L' Écouvotte;92;0;92
27;Bourgogne-Franche-Comté;25;2;12;216;Écurcey;268;10;278
27;Bourgogne-Franche-Comté;25;1;17;217;Émagny;594;10;604
27;Bourgogne-Franche-Comté;25;3;18;218;Épenouse;151;3;154
27;Bourgogne-Franche-Comté;25;3;18;219;Épenoy;630;16;646
27;Bourgogne-Franche-Comté;25;1;17;220;Épeugney;586;15;601
27;Bourgogne-Franche-Comté;25;1;02;221;Esnans;68;0;68
27;Bourgogne-Franche-Comté;25;3;89;222;Étalans;1550;36;1586
27;Bourgogne-Franche-Comté;25;1;15;223;Éternoz;338;7;345
27;Bourgogne-Franche-Comté;25;2;03;224;Étouvans;825;13;838
27;Bourgogne-Franche-Comté;25;1;17;225;Étrabonne;191;1;192
27;Bourgogne-Franche-Comté;25;2;03;226;Étrappe;213;4;217
27;Bourgogne-Franche-Comté;25;3;18;227;Étray;261;0;261
27;Bourgogne-Franche-Comté;25;2;10;228;Étupes;3727;64;3791
27;Bourgogne-Franche-Comté;25;3;15;229;Évillers;366;4;370
27;Bourgogne-Franche-Comté;25;2;10;230;Exincourt;3222;50;3272
27;Bourgogne-Franche-Comté;25;3;18;231;Eysson;116;2;118
27;Bourgogne-Franche-Comté;25;2;03;232;Faimbe;107;2;109
27;Bourgogne-Franche-Comté;25;3;18;233;Fallerans;284;8;292
27;Bourgogne-Franche-Comté;25;2;12;234;Ferrières-le-Lac;172;7;179
27;Bourgogne-Franche-Comté;25;1;17;235;Ferrières-les-Bois;320;3;323
27;Bourgogne-Franche-Comté;25;1;15;236;Fertans;256;10;266
27;Bourgogne-Franche-Comté;25;2;10;237;Fesches-le-Châtel;2189;33;2222
27;Bourgogne-Franche-Comté;25;2;12;238;Fessevillers;158;2;160
27;Bourgogne-Franche-Comté;25;2;19;239;Feule;180;1;181
27;Bourgogne-Franche-Comté;25;3;14;240;Les Fins;3100;147;3247
27;Bourgogne-Franche-Comté;25;1;15;241;Flagey;161;1;162
27;Bourgogne-Franche-Comté;25;1;02;242;Flagey-Rigney;112;1;113
27;Bourgogne-Franche-Comté;25;3;18;243;Flangebouche;779;18;797
27;Bourgogne-Franche-Comté;25;2;12;244;Fleurey;85;3;88
27;Bourgogne-Franche-Comté;25;1;87;245;Fontain;1301;27;1328
27;Bourgogne-Franche-Comté;25;2;03;246;Fontaine-lès-Clerval;299;5;304
27;Bourgogne-Franche-Comté;25;1;02;247;Fontenelle-Montby;92;3;95
27;Bourgogne-Franche-Comté;25;3;14;248;Les Fontenelles;568;133;701
27;Bourgogne-Franche-Comté;25;1;02;249;Fontenotte;62;2;64
27;Bourgogne-Franche-Comté;25;1;02;251;Fourbanne;173;8;181
27;Bourgogne-Franche-Comté;25;3;11;252;Fourcatier-et-Maison-Neuve;112;0;112
27;Bourgogne-Franche-Comté;25;1;17;253;Fourg;380;4;384
27;Bourgogne-Franche-Comté;25;3;11;254;Les Fourgs;1381;32;1413
27;Bourgogne-Franche-Comté;25;2;12;255;Fournet-Blancheroche;357;13;370
27;Bourgogne-Franche-Comté;25;3;18;288;Fournets-Luisans;699;18;717
27;Bourgogne-Franche-Comté;25;2;12;256;Frambouhans;904;14;918
27;Bourgogne-Franche-Comté;25;1;17;257;Franey;272;5;277
27;Bourgogne-Franche-Comté;25;1;04;258;Franois;2340;40;2380
27;Bourgogne-Franche-Comté;25;3;11;259;Frasne;1936;37;1973
27;Bourgogne-Franche-Comté;25;2;12;261;Froidevaux;75;1;76
27;Bourgogne-Franche-Comté;25;3;18;262;Fuans;483;24;507
27;Bourgogne-Franche-Comté;25;3;11;263;Gellin;242;6;248
27;Bourgogne-Franche-Comté;25;2;03;264;Gémonval;85;0;85
27;Bourgogne-Franche-Comté;25;1;02;265;Geneuille;1331;20;1351
27;Bourgogne-Franche-Comté;25;2;03;266;Geney;119;2;121
27;Bourgogne-Franche-Comté;25;1;08;267;Gennes;681;20;701
27;Bourgogne-Franche-Comté;25;3;18;268;Germéfontaine;122;2;124
27;Bourgogne-Franche-Comté;25;1;02;269;Germondans;60;1;61
27;Bourgogne-Franche-Comté;25;1;15;270;Gevresin;118;6;124
27;Bourgogne-Franche-Comté;25;3;15;271;Gilley;1656;37;1693
27;Bourgogne-Franche-Comté;25;1;02;273;Glamondans;217;4;221
27;Bourgogne-Franche-Comté;25;2;12;274;Glay;340;2;342
27;Bourgogne-Franche-Comté;25;2;12;275;Glère;225;1;226
27;Bourgogne-Franche-Comté;25;1;02;277;Gondenans-les-Moulins;72;0;72
27;Bourgogne-Franche-Comté;25;1;02;276;Gondenans-Montby;175;2;177
27;Bourgogne-Franche-Comté;25;1;02;278;Gonsans;567;13;580
27;Bourgogne-Franche-Comté;25;1;02;279;Gouhelans;118;1;119
27;Bourgogne-Franche-Comté;25;2;12;280;Goumois;162;5;167
27;Bourgogne-Franche-Comté;25;2;19;281;Goux-lès-Dambelin;285;0;285
27;Bourgogne-Franche-Comté;25;3;15;282;Goux-les-Usiers;727;9;736
27;Bourgogne-Franche-Comté;25;1;17;283;Goux-sous-Landet;71;1;72
27;Bourgogne-Franche-Comté;25;2;10;284;Grand-Charmont;5699;73;5772
27;Bourgogne-Franche-Comté;25;3;14;285;Grand'Combe-Châteleu;1489;26;1515
27;Bourgogne-Franche-Comté;25;3;14;286;Grand'Combe-des-Bois;133;5;138
27;Bourgogne-Franche-Comté;25;1;04;287;Grandfontaine;1647;39;1686
27;Bourgogne-Franche-Comté;25;3;18;289;Grandfontaine-sur-Creuse;72;3;75
27;Bourgogne-Franche-Comté;25;2;18;290;La Grange;94;3;97
27;Bourgogne-Franche-Comté;25;3;16;293;Granges-Narboz;1226;42;1268
27;Bourgogne-Franche-Comté;25;3;11;295;Les Grangettes;278;14;292
27;Bourgogne-Franche-Comté;25;3;14;296;Les Gras;797;28;825
27;Bourgogne-Franche-Comté;25;1;08;297;Le Gratteris;186;0;186
27;Bourgogne-Franche-Comté;25;1;02;298;Grosbois;238;9;247
27;Bourgogne-Franche-Comté;25;1;02;299;Guillon-les-Bains;109;1;110
27;Bourgogne-Franche-Comté;25;1;18;300;Guyans-Durnes;280;5;285
27;Bourgogne-Franche-Comté;25;3;18;301;Guyans-Vennes;829;25;854
27;Bourgogne-Franche-Comté;25;3;15;303;Hauterive-la-Fresse;225;6;231
27;Bourgogne-Franche-Comté;25;2;01;304;Hérimoncourt;3632;61;3693
27;Bourgogne-Franche-Comté;25;1;15;305;L' Hôpital-du-Grosbois;598;11;609
27;Bourgogne-Franche-Comté;25;2;03;306;L' Hôpital-Saint-Lieffroy;114;5;119
27;Bourgogne-Franche-Comté;25;3;11;307;Les Hôpitaux-Neufs;921;11;932
27;Bourgogne-Franche-Comté;25;3;11;308;Les Hôpitaux-Vieux;450;6;456
27;Bourgogne-Franche-Comté;25;3;16;309;Houtaud;1094;36;1130
27;Bourgogne-Franche-Comté;25;1;02;310;Huanne-Montmartin;87;1;88
27;Bourgogne-Franche-Comté;25;2;03;311;Hyémondans;201;4;205
27;Bourgogne-Franche-Comté;25;1;02;312;Hyèvre-Magny;71;1;72
27;Bourgogne-Franche-Comté;25;1;02;313;Hyèvre-Paroisse;191;3;194
27;Bourgogne-Franche-Comté;25;2;12;314;Indevillers;262;2;264
27;Bourgogne-Franche-Comté;25;2;03;315;L' Isle-sur-le-Doubs;2997;73;3070
27;Bourgogne-Franche-Comté;25;2;03;316;Issans;238;12;250
27;Bourgogne-Franche-Comté;25;1;17;317;Jallerange;260;6;266
27;Bourgogne-Franche-Comté;25;3;11;318;Jougne;1858;35;1893
27;Bourgogne-Franche-Comté;25;3;11;320;Labergement-Sainte-Marie;1198;33;1231
27;Bourgogne-Franche-Comté;25;2;03;322;Laire;400;12;412
27;Bourgogne-Franche-Comté;25;1;02;323;Laissey;439;9;448
27;Bourgogne-Franche-Comté;25;1;03;324;Lanans;167;6;173
27;Bourgogne-Franche-Comté;25;3;18;325;Landresse;233;6;239
27;Bourgogne-Franche-Comté;25;1;17;326;Lantenne-Vertière;534;13;547
27;Bourgogne-Franche-Comté;25;2;03;327;Lanthenans;68;0;68
27;Bourgogne-Franche-Comté;25;1;09;328;Larnod;773;11;784
27;Bourgogne-Franche-Comté;25;3;14;329;Laval-le-Prieuré;35;1;36
27;Bourgogne-Franche-Comté;25;1;17;330;Lavans-Quingey;191;3;194
27;Bourgogne-Franche-Comté;25;1;15;331;Lavans-Vuillafans;238;5;243
27;Bourgogne-Franche-Comté;25;1;17;332;Lavernay;576;9;585
27;Bourgogne-Franche-Comté;25;3;18;333;Laviron;334;8;342
27;Bourgogne-Franche-Comté;25;3;88;334;Levier;2183;226;2409
27;Bourgogne-Franche-Comté;25;2;12;335;Liebvillers;164;5;169
27;Bourgogne-Franche-Comté;25;1;17;336;Liesle;533;14;547
27;Bourgogne-Franche-Comté;25;1;15;338;Lizine;92;1;93
27;Bourgogne-Franche-Comté;25;1;15;339;Lods;219;2;221
27;Bourgogne-Franche-Comté;25;1;17;340;Lombard;190;4;194
27;Bourgogne-Franche-Comté;25;1;02;341;Lomont-sur-Crête;171;6;177
27;Bourgogne-Franche-Comté;25;3;18;342;Longechaux;78;3;81
27;Bourgogne-Franche-Comté;25;3;18;343;Longemaison;154;3;157
27;Bourgogne-Franche-Comté;25;3;18;344;Longevelle-lès-Russey;46;0;46
27;Bourgogne-Franche-Comté;25;2;03;345;Longevelle-sur-Doubs;682;14;696
27;Bourgogne-Franche-Comté;25;1;15;346;Longeville;173;3;176
27;Bourgogne-Franche-Comté;25;3;15;347;La Longeville;806;20;826
27;Bourgogne-Franche-Comté;25;3;11;348;Longevilles-Mont-d'Or;581;15;596
27;Bourgogne-Franche-Comté;25;3;18;349;Loray;521;14;535
27;Bourgogne-Franche-Comté;25;2;03;350;Lougres;765;23;788
27;Bourgogne-Franche-Comté;25;3;14;351;Le Luhier;222;1;223
27;Bourgogne-Franche-Comté;25;1;02;354;Luxiol;161;0;161
27;Bourgogne-Franche-Comté;25;3;18;355;Magny-Châtelard;61;0;61
27;Bourgogne-Franche-Comté;25;2;12;356;Maîche;4286;110;4396
27;Bourgogne-Franche-Comté;25;3;15;357;Maisons-du-Bois-Lièvremont;807;8;815
27;Bourgogne-Franche-Comté;25;1;15;359;Malans;173;5;178
27;Bourgogne-Franche-Comté;25;1;15;360;Malbrans;160;4;164
27;Bourgogne-Franche-Comté;25;3;11;361;Malbuisson;855;25;880
27;Bourgogne-Franche-Comté;25;3;11;362;Malpas;281;9;290
27;Bourgogne-Franche-Comté;25;1;08;364;Mamirolle;1775;18;1793
27;Bourgogne-Franche-Comté;25;2;03;365;Mancenans;308;5;313
27;Bourgogne-Franche-Comté;25;2;12;366;Mancenans-Lizerne;192;6;198
27;Bourgogne-Franche-Comté;25;2;19;367;Mandeure;4819;150;4969
27;Bourgogne-Franche-Comté;25;1;07;368;Marchaux-Chaudefontaine;1464;21;1485
27;Bourgogne-Franche-Comté;25;2;03;369;Marvelise;165;2;167
27;Bourgogne-Franche-Comté;25;2;19;370;Mathay;2158;37;2195
27;Bourgogne-Franche-Comté;25;1;05;371;Mazerolles-le-Salin;200;4;204
27;Bourgogne-Franche-Comté;25;2;03;372;Médière;284;12;296
27;Bourgogne-Franche-Comté;25;3;14;373;Le Mémont;44;2;46
27;Bourgogne-Franche-Comté;25;1;17;374;Mercey-le-Grand;542;16;558
27;Bourgogne-Franche-Comté;25;1;15;375;Mérey-sous-Montrond;430;10;440
27;Bourgogne-Franche-Comté;25;1;02;376;Mérey-Vieilley;147;5;152
27;Bourgogne-Franche-Comté;25;1;02;377;Mésandans;222;6;228
27;Bourgogne-Franche-Comté;25;2;12;378;Meslières;361;8;369
27;Bourgogne-Franche-Comté;25;1;17;379;Mesmay;71;3;74
27;Bourgogne-Franche-Comté;25;3;11;380;Métabief;1196;23;1219
27;Bourgogne-Franche-Comté;25;1;06;381;Miserey-Salines;2502;36;2538
27;Bourgogne-Franche-Comté;25;1;02;382;Moncey;579;6;585
27;Bourgogne-Franche-Comté;25;1;17;383;Moncley;280;6;286
27;Bourgogne-Franche-Comté;25;1;02;384;Mondon;96;1;97
27;Bourgogne-Franche-Comté;25;3;14;391;Mont-de-Laval;177;6;183
27;Bourgogne-Franche-Comté;25;2;12;392;Mont-de-Vougney;186;5;191
27;Bourgogne-Franche-Comté;25;1;02;385;Montagney-Servigney;132;3;135
27;Bourgogne-Franche-Comté;25;2;12;386;Montancy;141;3;144
27;Bourgogne-Franche-Comté;25;2;12;387;Montandon;405;4;409
27;Bourgogne-Franche-Comté;25;2;13;388;Montbéliard;25395;585;25980
27;Bourgogne-Franche-Comté;25;3;14;389;Montbéliardot;114;4;118
27;Bourgogne-Franche-Comté;25;3;15;390;Montbenoît;396;12;408
27;Bourgogne-Franche-Comté;25;2;12;393;Montécheroux;557;7;564
27;Bourgogne-Franche-Comté;25;2;03;394;Montenois;1501;43;1544
27;Bourgogne-Franche-Comté;25;1;08;395;Montfaucon;1550;49;1599
27;Bourgogne-Franche-Comté;25;1;09;397;Montferrand-le-Château;2161;45;2206
27;Bourgogne-Franche-Comté;25;3;15;398;Montflovin;107;4;111
27;Bourgogne-Franche-Comté;25;1;15;400;Montgesoye;465;9;474
27;Bourgogne-Franche-Comté;25;1;02;401;Montivernage;28;0;28
27;Bourgogne-Franche-Comté;25;2;12;402;Montjoie-le-Château;27;1;28
27;Bourgogne-Franche-Comté;25;3;14;403;Montlebon;2081;68;2149
27;Bourgogne-Franche-Comté;25;1;15;404;Montmahoux;93;2;95
27;Bourgogne-Franche-Comté;25;3;11;405;Montperreux;840;32;872
27;Bourgogne-Franche-Comté;25;1;17;406;Montrond-le-Château;561;14;575
27;Bourgogne-Franche-Comté;25;1;02;408;Montussaint;58;1;59
27;Bourgogne-Franche-Comté;25;1;08;410;Morre;1361;79;1440
27;Bourgogne-Franche-Comté;25;3;14;411;Morteau;6935;309;7244
27;Bourgogne-Franche-Comté;25;3;11;413;Mouthe;1098;35;1133
27;Bourgogne-Franche-Comté;25;1;17;414;Le Moutherot;127;2;129
27;Bourgogne-Franche-Comté;25;1;15;415;Mouthier-Haute-Pierre;335;5;340
27;Bourgogne-Franche-Comté;25;1;17;416;Myon;183;4;187
27;Bourgogne-Franche-Comté;25;1;02;417;Naisey-les-Granges;796;20;816
27;Bourgogne-Franche-Comté;25;1;08;418;Nancray;1260;29;1289
27;Bourgogne-Franche-Comté;25;1;02;419;Nans;100;4;104
27;Bourgogne-Franche-Comté;25;1;15;420;Nans-sous-Sainte-Anne;156;4;160
27;Bourgogne-Franche-Comté;25;3;14;421;Narbief;69;4;73
27;Bourgogne-Franche-Comté;25;2;19;422;Neuchâtel-Urtière;195;0;195
27;Bourgogne-Franche-Comté;25;3;14;425;Noël-Cerneux;433;15;448
27;Bourgogne-Franche-Comté;25;2;19;426;Noirefontaine;359;6;365
27;Bourgogne-Franche-Comté;25;1;05;427;Noironte;386;4;390
27;Bourgogne-Franche-Comté;25;2;10;428;Nommay;1638;37;1675
27;Bourgogne-Franche-Comté;25;1;08;429;Novillars;1501;41;1542
27;Bourgogne-Franche-Comté;25;1;02;430;Ollans;39;0;39
27;Bourgogne-Franche-Comté;25;2;03;431;Onans;349;13;362
27;Bourgogne-Franche-Comté;25;3;18;432;Orchamps-Vennes;2129;61;2190
27;Bourgogne-Franche-Comté;25;2;12;433;Orgeans-Blanchefontaine;44;1;45
27;Bourgogne-Franche-Comté;25;1;15;434;Ornans;4413;104;4517
27;Bourgogne-Franche-Comté;25;3;18;435;Orsans;163;4;167
27;Bourgogne-Franche-Comté;25;2;03;436;Orve;61;2;63
27;Bourgogne-Franche-Comté;25;1;02;437;Osse;323;3;326
27;Bourgogne-Franche-Comté;25;1;09;438;Osselle-Routelle;949;11;960
27;Bourgogne-Franche-Comté;25;1;02;439;Ougney-Douvot;253;5;258
27;Bourgogne-Franche-Comté;25;3;15;440;Ouhans;376;7;383
27;Bourgogne-Franche-Comté;25;3;18;441;Ouvans;60;2;62
27;Bourgogne-Franche-Comté;25;3;11;442;Oye-et-Pallet;726;12;738
27;Bourgogne-Franche-Comté;25;1;17;443;Palantine;72;1;73
27;Bourgogne-Franche-Comté;25;1;02;444;Palise;141;4;145
27;Bourgogne-Franche-Comté;25;1;17;445;Paroy;126;2;128
27;Bourgogne-Franche-Comté;25;1;02;446;Passavant;217;12;229
27;Bourgogne-Franche-Comté;25;3;18;447;Passonfontaine;325;5;330
27;Bourgogne-Franche-Comté;25;2;03;156;Pays-de-Clerval;1229;29;1258
27;Bourgogne-Franche-Comté;25;1;05;448;Pelousey;1527;28;1555
27;Bourgogne-Franche-Comté;25;2;18;449;Péseux;127;1;128
27;Bourgogne-Franche-Comté;25;1;17;450;Pessans;87;3;90
27;Bourgogne-Franche-Comté;25;3;11;451;Petite-Chaux;143;3;146
27;Bourgogne-Franche-Comté;25;2;12;452;Pierrefontaine-lès-Blamont;468;12;480
27;Bourgogne-Franche-Comté;25;3;18;453;Pierrefontaine-les-Varans;1421;25;1446
27;Bourgogne-Franche-Comté;25;1;05;454;Pirey;2066;40;2106
27;Bourgogne-Franche-Comté;25;1;17;455;Placey;198;4;202
27;Bourgogne-Franche-Comté;25;3;14;456;Plaimbois-du-Miroir;246;8;254
27;Bourgogne-Franche-Comté;25;3;18;457;Plaimbois-Vennes;102;0;102
27;Bourgogne-Franche-Comté;25;2;12;458;Les Plains-et-Grands-Essarts;219;5;224
27;Bourgogne-Franche-Comté;25;3;11;459;La Planée;296;8;304
27;Bourgogne-Franche-Comté;25;2;03;461;Pompierre-sur-Doubs;307;2;309
27;Bourgogne-Franche-Comté;25;2;19;463;Pont-de-Roide-Vermondans;4185;75;4260
27;Bourgogne-Franche-Comté;25;1;02;465;Pont-les-Moulins;195;2;197
27;Bourgogne-Franche-Comté;25;3;16;462;Pontarlier;17197;836;18033
27;Bourgogne-Franche-Comté;25;3;11;464;Les Pontets;135;4;139
27;Bourgogne-Franche-Comté;25;1;17;466;Pouilley-Français;833;19;852
27;Bourgogne-Franche-Comté;25;1;05;467;Pouilley-les-Vignes;1965;39;2004
27;Bourgogne-Franche-Comté;25;1;02;468;Pouligney-Lusans;850;11;861
27;Bourgogne-Franche-Comté;25;3;18;424;Les Premiers Sapins;1555;31;1586
27;Bourgogne-Franche-Comté;25;2;03;469;Présentevillers;455;12;467
27;Bourgogne-Franche-Comté;25;2;03;470;La Prétière;156;5;161
27;Bourgogne-Franche-Comté;25;2;18;471;Provenchère;135;3;138
27;Bourgogne-Franche-Comté;25;1;02;472;Puessans;31;3;34
27;Bourgogne-Franche-Comté;25;1;09;473;Pugey;742;20;762
27;Bourgogne-Franche-Comté;25;1;02;474;Le Puy;112;3;115
27;Bourgogne-Franche-Comté;25;1;17;475;Quingey;1430;14;1444
27;Bourgogne-Franche-Comté;25;2;03;476;Rahon;126;0;126
27;Bourgogne-Franche-Comté;25;1;04;477;Rancenay;352;6;358
27;Bourgogne-Franche-Comté;25;2;03;478;Randevillers;122;2;124
27;Bourgogne-Franche-Comté;25;2;03;479;Rang;418;5;423
27;Bourgogne-Franche-Comté;25;2;03;481;Raynans;337;5;342
27;Bourgogne-Franche-Comté;25;1;17;482;Recologne;653;3;656
27;Bourgogne-Franche-Comté;25;3;11;483;Reculfoz;41;3;44
27;Bourgogne-Franche-Comté;25;2;19;485;Rémondans-Vaivre;234;4;238
27;Bourgogne-Franche-Comté;25;3;11;486;Remoray-Boujeons;428;11;439
27;Bourgogne-Franche-Comté;25;3;15;487;Renédale;40;3;43
27;Bourgogne-Franche-Comté;25;1;17;488;Rennes-sur-Loue;104;5;109
27;Bourgogne-Franche-Comté;25;1;15;489;Reugney;305;29;334
27;Bourgogne-Franche-Comté;25;1;02;490;Rigney;390;19;409
27;Bourgogne-Franche-Comté;25;1;02;491;Rignosot;116;3;119
27;Bourgogne-Franche-Comté;25;1;02;492;Rillans;93;3;96
27;Bourgogne-Franche-Comté;25;3;11;493;La Rivière-Drugeon;902;26;928
27;Bourgogne-Franche-Comté;25;2;03;496;Roche-lès-Clerval;110;0;110
27;Bourgogne-Franche-Comté;25;1;08;495;Roche-lez-Beaupré;2111;26;2137
27;Bourgogne-Franche-Comté;25;3;11;494;Rochejean;672;6;678
27;Bourgogne-Franche-Comté;25;2;12;497;Roches-lès-Blamont;632;14;646
27;Bourgogne-Franche-Comté;25;1;02;498;Rognon;48;0;48
27;Bourgogne-Franche-Comté;25;1;02;499;Romain;128;2;130
27;Bourgogne-Franche-Comté;25;1;17;500;Ronchaux;87;1;88
27;Bourgogne-Franche-Comté;25;3;11;501;Rondefontaine;34;1;35
27;Bourgogne-Franche-Comté;25;1;17;502;Roset-Fluans;520;3;523
27;Bourgogne-Franche-Comté;25;2;18;503;Rosières-sur-Barbèche;122;4;126
27;Bourgogne-Franche-Comté;25;3;18;504;Rosureux;78;1;79
27;Bourgogne-Franche-Comté;25;1;02;505;Rougemont;1124;32;1156
27;Bourgogne-Franche-Comté;25;1;02;506;Rougemontot;95;1;96
27;Bourgogne-Franche-Comté;25;1;17;507;Rouhe;79;2;81
27;Bourgogne-Franche-Comté;25;1;02;508;Roulans;1127;24;1151
27;Bourgogne-Franche-Comté;25;1;17;510;Ruffey-le-Château;364;8;372
27;Bourgogne-Franche-Comté;25;1;17;511;Rurey;340;6;346
27;Bourgogne-Franche-Comté;25;3;14;512;Le Russey;2342;81;2423
27;Bourgogne-Franche-Comté;25;3;11;514;Saint-Antoine;339;17;356
27;Bourgogne-Franche-Comté;25;2;03;516;Saint-Georges-Armont;120;6;126
27;Bourgogne-Franche-Comté;25;3;15;517;Saint-Gorgon-Main;283;3;286
27;Bourgogne-Franche-Comté;25;1;02;518;Saint-Hilaire;160;9;169
27;Bourgogne-Franche-Comté;25;2;12;519;Saint-Hippolyte;898;13;911
27;Bourgogne-Franche-Comté;25;1;02;520;Saint-Juan;172;3;175
27;Bourgogne-Franche-Comté;25;2;03;521;Saint-Julien-lès-Montbéliard;165;5;170
27;Bourgogne-Franche-Comté;25;3;14;522;Saint-Julien-lès-Russey;180;3;183
27;Bourgogne-Franche-Comté;25;2;03;524;Saint-Maurice-Colombier;907;26;933
27;Bourgogne-Franche-Comté;25;3;11;525;Saint-Point-Lac;281;8;289
27;Bourgogne-Franche-Comté;25;1;17;527;Saint-Vit;4874;71;4945
27;Bourgogne-Franche-Comté;25;1;15;513;Sainte-Anne;42;0;42
27;Bourgogne-Franche-Comté;25;3;16;515;Sainte-Colombe;409;7;416
27;Bourgogne-Franche-Comté;25;2;03;523;Sainte-Marie;685;15;700
27;Bourgogne-Franche-Comté;25;2;13;526;Sainte-Suzanne;1510;41;1551
27;Bourgogne-Franche-Comté;25;1;17;528;Samson;86;0;86
27;Bourgogne-Franche-Comté;25;2;03;529;Sancey;1332;27;1359
27;Bourgogne-Franche-Comté;25;1;08;532;Saône;3375;58;3433
27;Bourgogne-Franche-Comté;25;1;15;533;Saraz;11;2;13
27;Bourgogne-Franche-Comté;25;3;11;534;Sarrageois;194;4;198
27;Bourgogne-Franche-Comté;25;1;15;535;Saules;226;6;232
27;Bourgogne-Franche-Comté;25;1;17;536;Sauvagney;185;4;189
27;Bourgogne-Franche-Comté;25;1;15;537;Scey-Maisières;291;9;300
27;Bourgogne-Franche-Comté;25;1;02;538;Séchin;113;1;114
27;Bourgogne-Franche-Comté;25;2;01;539;Seloncourt;5775;144;5919
27;Bourgogne-Franche-Comté;25;2;03;540;Semondans;302;6;308
27;Bourgogne-Franche-Comté;25;3;15;541;Septfontaines;368;7;375
27;Bourgogne-Franche-Comté;25;1;05;542;Serre-les-Sapins;1639;28;1667
27;Bourgogne-Franche-Comté;25;1;03;544;Servin;202;9;211
27;Bourgogne-Franche-Comté;25;1;15;545;Silley-Amancey;140;2;142
27;Bourgogne-Franche-Comté;25;1;02;546;Silley-Bléfond;56;1;57
27;Bourgogne-Franche-Comté;25;2;10;547;Sochaux;3949;40;3989
27;Bourgogne-Franche-Comté;25;2;19;548;Solemont;150;7;157
27;Bourgogne-Franche-Comté;25;3;15;549;Sombacour;641;6;647
27;Bourgogne-Franche-Comté;25;3;18;550;La Sommette;236;3;239
27;Bourgogne-Franche-Comté;25;2;12;551;Soulce-Cernay;127;1;128
27;Bourgogne-Franche-Comté;25;2;03;552;Sourans;118;2;120
27;Bourgogne-Franche-Comté;25;2;03;553;Soye;390;9;399
27;Bourgogne-Franche-Comté;25;2;03;554;Surmont;121;3;124
27;Bourgogne-Franche-Comté;25;2;01;555;Taillecourt;1104;24;1128
27;Bourgogne-Franche-Comté;25;1;02;556;Tallans;47;3;50
27;Bourgogne-Franche-Comté;25;1;06;557;Tallenay;414;8;422
27;Bourgogne-Franche-Comté;25;1;15;558;Tarcenay-Foucherans;1495;23;1518
27;Bourgogne-Franche-Comté;25;2;12;138;Les Terres-de-Chaux;135;5;140
27;Bourgogne-Franche-Comté;25;2;12;559;Thiébouhans;256;6;262
27;Bourgogne-Franche-Comté;25;1;07;560;Thise;3044;45;3089
27;Bourgogne-Franche-Comté;25;1;09;561;Thoraise;362;4;366
27;Bourgogne-Franche-Comté;25;2;12;562;Thulay;218;5;223
27;Bourgogne-Franche-Comté;25;1;02;563;Thurey-le-Mont;129;3;132
27;Bourgogne-Franche-Comté;25;1;09;564;Torpes;1021;15;1036
27;Bourgogne-Franche-Comté;25;3;11;565;Touillon-et-Loutelet;269;13;282
27;Bourgogne-Franche-Comté;25;1;02;566;La Tour-de-Sçay;297;4;301
27;Bourgogne-Franche-Comté;25;1;02;567;Tournans;127;3;130
27;Bourgogne-Franche-Comté;25;1;15;569;Trépot;532;11;543
27;Bourgogne-Franche-Comté;25;1;02;570;Tressandans;23;2;25
27;Bourgogne-Franche-Comté;25;2;12;571;Trévillers;484;11;495
27;Bourgogne-Franche-Comté;25;1;02;572;Trouvans;104;5;109
27;Bourgogne-Franche-Comté;25;2;12;573;Urtière;11;0;11
27;Bourgogne-Franche-Comté;25;1;02;574;Uzelle;172;1;173
27;Bourgogne-Franche-Comté;25;1;08;575;Vaire;810;17;827
27;Bourgogne-Franche-Comté;25;1;17;460;Le Val;245;29;274
27;Bourgogne-Franche-Comté;25;1;02;579;Val-de-Roulans;195;3;198
27;Bourgogne-Franche-Comté;25;3;18;578;Valdahon;5595;97;5692
27;Bourgogne-Franche-Comté;25;2;19;580;Valentigney;10714;175;10889
27;Bourgogne-Franche-Comté;25;1;02;582;Valleroy;156;2;158
27;Bourgogne-Franche-Comté;25;2;03;583;Valonne;244;3;247
27;Bourgogne-Franche-Comté;25;2;12;584;Valoreille;127;4;131
27;Bourgogne-Franche-Comté;25;2;01;586;Vandoncourt;830;32;862
27;Bourgogne-Franche-Comté;25;2;18;588;Vaucluse;120;30;150
27;Bourgogne-Franche-Comté;25;2;18;589;Vauclusotte;87;1;88
27;Bourgogne-Franche-Comté;25;1;03;590;Vaudrivillers;91;0;91
27;Bourgogne-Franche-Comté;25;2;12;591;Vaufrey;158;0;158
27;Bourgogne-Franche-Comté;25;3;11;592;Vaux-et-Chantegrue;585;13;598
27;Bourgogne-Franche-Comté;25;1;17;594;Velesmes-Essarts;348;4;352
27;Bourgogne-Franche-Comté;25;2;03;595;Vellerot-lès-Belvoir;96;0;96
27;Bourgogne-Franche-Comté;25;3;18;596;Vellerot-lès-Vercel;67;1;68
27;Bourgogne-Franche-Comté;25;2;03;597;Vellevans;234;6;240
27;Bourgogne-Franche-Comté;25;1;02;598;Venise;513;7;520
27;Bourgogne-Franche-Comté;25;1;02;599;Vennans;259;8;267
27;Bourgogne-Franche-Comté;25;3;18;600;Vennes;182;4;186
27;Bourgogne-Franche-Comté;25;3;18;601;Vercel-Villedieu-le-Camp;1591;83;1674
27;Bourgogne-Franche-Comté;25;1;02;602;Vergranne;108;4;112
27;Bourgogne-Franche-Comté;25;1;02;604;Verne;127;4;131
27;Bourgogne-Franche-Comté;25;3;18;605;Vernierfontaine;462;11;473
27;Bourgogne-Franche-Comté;25;2;03;607;Vernois-lès-Belvoir;60;1;61
27;Bourgogne-Franche-Comté;25;2;03;608;Le Vernoy;168;3;171
27;Bourgogne-Franche-Comté;25;3;16;609;Verrières-de-Joux;450;11;461
27;Bourgogne-Franche-Comté;25;1;08;611;La Vèze;455;7;462
27;Bourgogne-Franche-Comté;25;1;02;612;Vieilley;699;19;718
27;Bourgogne-Franche-Comté;25;1;02;613;Viéthorey;94;2;96
27;Bourgogne-Franche-Comté;25;2;10;614;Vieux-Charmont;2744;54;2798
27;Bourgogne-Franche-Comté;25;2;12;615;Villars-lès-Blamont;441;6;447
27;Bourgogne-Franche-Comté;25;1;17;616;Villars-Saint-Georges;273;2;275
27;Bourgogne-Franche-Comté;25;2;19;617;Villars-sous-Dampjoux;356;9;365
27;Bourgogne-Franche-Comté;25;2;03;618;Villars-sous-Écot;352;8;360
27;Bourgogne-Franche-Comté;25;3;15;620;Ville-du-Pont;315;7;322
27;Bourgogne-Franche-Comté;25;3;11;619;Les Villedieu;207;3;210
27;Bourgogne-Franche-Comté;25;3;11;621;Villeneuve-d'Amont;235;37;272
27;Bourgogne-Franche-Comté;25;1;17;622;Villers-Buzon;259;1;260
27;Bourgogne-Franche-Comté;25;3;18;623;Villers-Chief;123;1;124
27;Bourgogne-Franche-Comté;25;1;02;624;Villers-Grélot;152;3;155
27;Bourgogne-Franche-Comté;25;3;18;625;Villers-la-Combe;51;1;52
27;Bourgogne-Franche-Comté;25;3;14;321;Villers-le-Lac;4985;111;5096
27;Bourgogne-Franche-Comté;25;1;02;626;Villers-Saint-Martin;212;5;217
27;Bourgogne-Franche-Comté;25;3;11;627;Villers-sous-Chalamont;296;3;299
27;Bourgogne-Franche-Comté;25;1;15;628;Villers-sous-Montrond;210;3;213
27;Bourgogne-Franche-Comté;25;1;02;629;Voillans;208;6;214
27;Bourgogne-Franche-Comté;25;1;18;630;Voires;92;0;92
27;Bourgogne-Franche-Comté;25;1;09;631;Vorges-les-Pins;602;11;613
27;Bourgogne-Franche-Comté;25;2;19;632;Voujeaucourt;3175;84;3259
27;Bourgogne-Franche-Comté;25;1;15;633;Vuillafans;757;13;770
27;Bourgogne-Franche-Comté;25;3;16;634;Vuillecin;641;23;664
27;Bourgogne-Franche-Comté;25;2;03;635;Vyt-lès-Belvoir;188;3;191
84;Auvergne-Rhône-Alpes;26;3;12;002;Albon;1937;36;1973
84;Auvergne-Rhône-Alpes;26;2;03;003;Aleyrac;47;0;47
84;Auvergne-Rhône-Alpes;26;3;01;004;Alixan;2509;75;2584
84;Auvergne-Rhône-Alpes;26;2;09;005;Allan;1727;49;1776
84;Auvergne-Rhône-Alpes;26;1;07;006;Allex;2515;78;2593
84;Auvergne-Rhône-Alpes;26;1;07;007;Ambonil;113;7;120
84;Auvergne-Rhône-Alpes;26;2;08;008;Ancône;1341;29;1370
84;Auvergne-Rhône-Alpes;26;3;12;009;Andancette;1339;36;1375
84;Auvergne-Rhône-Alpes;26;3;12;010;Anneyron;3999;92;4091
84;Auvergne-Rhône-Alpes;26;1;02;011;Aouste-sur-Sye;2524;41;2565
84;Auvergne-Rhône-Alpes;26;1;04;012;Arnayon;24;3;27
84;Auvergne-Rhône-Alpes;26;2;10;013;Arpavon;77;3;80
84;Auvergne-Rhône-Alpes;26;3;05;014;Arthémonay;588;8;596
84;Auvergne-Rhône-Alpes;26;1;04;015;Aubenasson;72;5;77
84;Auvergne-Rhône-Alpes;26;2;10;016;Aubres;421;16;437
84;Auvergne-Rhône-Alpes;26;1;04;017;Aucelon;16;0;16
84;Auvergne-Rhône-Alpes;26;2;10;018;Aulan;11;1;12
84;Auvergne-Rhône-Alpes;26;1;04;019;Aurel;245;3;248
84;Auvergne-Rhône-Alpes;26;1;02;021;Autichamp;121;4;125
84;Auvergne-Rhône-Alpes;26;2;10;022;Ballons;83;3;86
84;Auvergne-Rhône-Alpes;26;3;19;023;Barbières;1059;18;1077
84;Auvergne-Rhône-Alpes;26;3;02;024;Barcelonne;349;10;359
84;Auvergne-Rhône-Alpes;26;1;04;025;Barnave;198;11;209
84;Auvergne-Rhône-Alpes;26;2;10;026;Barret-de-Lioure;74;0;74
84;Auvergne-Rhône-Alpes;26;1;04;027;Barsac;138;3;141
84;Auvergne-Rhône-Alpes;26;3;05;028;Bathernay;254;8;262
84;Auvergne-Rhône-Alpes;26;1;04;030;La Bâtie-des-Fonds;4;0;4
84;Auvergne-Rhône-Alpes;26;2;03;031;La Bâtie-Rolland;1029;27;1056
84;Auvergne-Rhône-Alpes;26;3;02;032;La Baume-Cornillane;443;9;452
84;Auvergne-Rhône-Alpes;26;3;19;034;La Baume-d'Hostun;571;9;580
84;Auvergne-Rhône-Alpes;26;2;06;033;La Baume-de-Transit;881;16;897
84;Auvergne-Rhône-Alpes;26;1;02;035;Beaufort-sur-Gervanne;471;8;479
84;Auvergne-Rhône-Alpes;26;1;04;036;Beaumont-en-Diois;104;4;108
84;Auvergne-Rhône-Alpes;26;3;17;037;Beaumont-lès-Valence;3649;85;3734
84;Auvergne-Rhône-Alpes;26;3;13;038;Beaumont-Monteux;1317;17;1334
84;Auvergne-Rhône-Alpes;26;3;19;039;Beauregard-Baret;854;13;867
84;Auvergne-Rhône-Alpes;26;1;04;040;Beaurières;67;2;69
84;Auvergne-Rhône-Alpes;26;3;12;041;Beausemblant;1432;26;1458
84;Auvergne-Rhône-Alpes;26;3;17;042;Beauvallon;1591;27;1618
84;Auvergne-Rhône-Alpes;26;2;10;043;Beauvoisin;145;4;149
84;Auvergne-Rhône-Alpes;26;2;03;045;La Bégude-de-Mazenc;1656;47;1703
84;Auvergne-Rhône-Alpes;26;2;10;046;Bellecombe-Tarendol;75;3;78
84;Auvergne-Rhône-Alpes;26;1;04;047;Bellegarde-en-Diois;85;0;85
84;Auvergne-Rhône-Alpes;26;2;10;048;Bénivay-Ollon;66;1;67
84;Auvergne-Rhône-Alpes;26;3;19;049;Bésayes;1221;35;1256
84;Auvergne-Rhône-Alpes;26;2;10;050;Bésignan;82;2;84
84;Auvergne-Rhône-Alpes;26;2;03;051;Bézaudun-sur-Bîne;68;2;70
84;Auvergne-Rhône-Alpes;26;2;03;052;Bonlieu-sur-Roubion;469;12;481
84;Auvergne-Rhône-Alpes;26;2;06;054;Bouchet;1512;23;1535
84;Auvergne-Rhône-Alpes;26;1;04;055;Boulc;134;2;136
84;Auvergne-Rhône-Alpes;26;2;03;056;Bourdeaux;653;17;670
84;Auvergne-Rhône-Alpes;26;3;01;057;Bourg-de-Péage;10205;179;10384
84;Auvergne-Rhône-Alpes;26;3;15;058;Bourg-lès-Valence;19975;579;20554
84;Auvergne-Rhône-Alpes;26;1;19;059;Bouvante;226;3;229
84;Auvergne-Rhône-Alpes;26;2;03;060;Bouvières;146;6;152
84;Auvergne-Rhône-Alpes;26;3;05;061;Bren;563;9;572
84;Auvergne-Rhône-Alpes;26;1;04;062;Brette;40;0;40
84;Auvergne-Rhône-Alpes;26;2;10;063;Buis-les-Baronnies;2302;96;2398
84;Auvergne-Rhône-Alpes;26;3;16;064;Chabeuil;6875;178;7053
84;Auvergne-Rhône-Alpes;26;1;02;065;Chabrillan;721;8;729
84;Auvergne-Rhône-Alpes;26;1;19;066;Le Chaffal;39;0;39
84;Auvergne-Rhône-Alpes;26;1;04;067;Chalancon;53;1;54
84;Auvergne-Rhône-Alpes;26;3;05;068;Le Chalon;211;6;217
84;Auvergne-Rhône-Alpes;26;1;04;069;Chamaloc;131;3;134
84;Auvergne-Rhône-Alpes;26;2;06;070;Chamaret;546;11;557
84;Auvergne-Rhône-Alpes;26;3;13;071;Chanos-Curson;1078;33;1111
84;Auvergne-Rhône-Alpes;26;3;13;072;Chantemerle-les-Blés;1282;22;1304
84;Auvergne-Rhône-Alpes;26;2;06;073;Chantemerle-lès-Grignan;251;3;254
84;Auvergne-Rhône-Alpes;26;1;19;074;La Chapelle-en-Vercors;713;132;845
84;Auvergne-Rhône-Alpes;26;2;10;075;La Charce;34;0;34
84;Auvergne-Rhône-Alpes;26;1;04;076;Charens;28;0;28
84;Auvergne-Rhône-Alpes;26;3;05;077;Charmes-sur-l'Herbasse;927;23;950
84;Auvergne-Rhône-Alpes;26;2;03;078;Charols;918;14;932
84;Auvergne-Rhône-Alpes;26;3;19;079;Charpey;1417;36;1453
84;Auvergne-Rhône-Alpes;26;1;04;080;Chastel-Arnaud;40;0;40
84;Auvergne-Rhône-Alpes;26;3;02;081;Châteaudouble;578;24;602
84;Auvergne-Rhône-Alpes;26;2;10;082;Châteauneuf-de-Bordette;96;5;101
84;Auvergne-Rhône-Alpes;26;3;05;083;Châteauneuf-de-Galaure;1808;578;2386
84;Auvergne-Rhône-Alpes;26;2;09;085;Châteauneuf-du-Rhône;2725;55;2780
84;Auvergne-Rhône-Alpes;26;3;13;084;Châteauneuf-sur-Isère;3875;139;4014
84;Auvergne-Rhône-Alpes;26;1;04;086;Châtillon-en-Diois;666;13;679
84;Auvergne-Rhône-Alpes;26;3;11;087;Châtillon-Saint-Jean;1359;35;1394
84;Auvergne-Rhône-Alpes;26;3;19;088;Chatuzange-le-Goubet;5516;125;5641
84;Auvergne-Rhône-Alpes;26;2;10;089;Chaudebonne;56;1;57
84;Auvergne-Rhône-Alpes;26;1;04;090;La Chaudière;28;0;28
84;Auvergne-Rhône-Alpes;26;2;10;091;Chauvac-Laux-Montaux;42;0;42
84;Auvergne-Rhône-Alpes;26;3;05;092;Chavannes;710;11;721
84;Auvergne-Rhône-Alpes;26;2;14;093;Clansayes;529;13;542
84;Auvergne-Rhône-Alpes;26;3;12;094;Claveyson;865;23;888
84;Auvergne-Rhône-Alpes;26;2;03;095;Cléon-d'Andran;836;35;871
84;Auvergne-Rhône-Alpes;26;3;11;096;Clérieux;2017;36;2053
84;Auvergne-Rhône-Alpes;26;1;07;097;Cliousclat;638;16;654
84;Auvergne-Rhône-Alpes;26;1;02;098;Cobonne;161;4;165
84;Auvergne-Rhône-Alpes;26;2;06;099;Colonzelle;549;12;561
84;Auvergne-Rhône-Alpes;26;3;02;100;Combovin;422;14;436
84;Auvergne-Rhône-Alpes;26;2;03;101;Comps;156;10;166
84;Auvergne-Rhône-Alpes;26;2;03;102;Condillac;139;6;145
84;Auvergne-Rhône-Alpes;26;2;10;103;Condorcet;486;4;490
84;Auvergne-Rhône-Alpes;26;2;10;104;Cornillac;83;2;85
84;Auvergne-Rhône-Alpes;26;2;10;105;Cornillon-sur-l'Oule;69;6;75
84;Auvergne-Rhône-Alpes;26;2;08;106;La Coucourde;1071;19;1090
84;Auvergne-Rhône-Alpes;26;3;05;107;Crépol;563;1;564
84;Auvergne-Rhône-Alpes;26;1;02;108;Crest;8505;268;8773
84;Auvergne-Rhône-Alpes;26;3;13;110;Crozes-Hermitage;670;10;680
84;Auvergne-Rhône-Alpes;26;2;03;111;Crupies;100;1;101
84;Auvergne-Rhône-Alpes;26;2;10;112;Curnier;181;8;189
84;Auvergne-Rhône-Alpes;26;1;04;113;Die;4621;242;4863
84;Auvergne-Rhône-Alpes;26;2;03;114;Dieulefit;3159;138;3297
84;Auvergne-Rhône-Alpes;26;1;02;115;Divajeu;640;69;709
84;Auvergne-Rhône-Alpes;26;2;06;116;Donzère;5833;94;5927
84;Auvergne-Rhône-Alpes;26;1;19;117;Échevis;51;4;55
84;Auvergne-Rhône-Alpes;26;3;05;118;Épinouze;1521;20;1541
84;Auvergne-Rhône-Alpes;26;3;13;119;Érôme;811;9;820
84;Auvergne-Rhône-Alpes;26;2;09;121;Espeluche;1064;39;1103
84;Auvergne-Rhône-Alpes;26;1;04;122;Espenel;172;2;174
84;Auvergne-Rhône-Alpes;26;1;04;123;Establet;27;0;27
84;Auvergne-Rhône-Alpes;26;3;07;124;Étoile-sur-Rhône;5478;125;5603
84;Auvergne-Rhône-Alpes;26;1;02;125;Eurre;1334;32;1366
84;Auvergne-Rhône-Alpes;26;2;10;126;Eygalayes;86;0;86
84;Auvergne-Rhône-Alpes;26;2;10;127;Eygaliers;104;3;107
84;Auvergne-Rhône-Alpes;26;1;04;128;Eygluy-Escoulin;67;0;67
84;Auvergne-Rhône-Alpes;26;3;19;129;Eymeux;1024;22;1046
84;Auvergne-Rhône-Alpes;26;2;10;130;Eyroles;28;0;28
84;Auvergne-Rhône-Alpes;26;2;03;131;Eyzahut;147;1;148
84;Auvergne-Rhône-Alpes;26;3;12;133;Fay-le-Clos;163;4;167
84;Auvergne-Rhône-Alpes;26;1;03;134;Félines-sur-Rimandoule;79;1;80
84;Auvergne-Rhône-Alpes;26;2;10;135;Ferrassières;127;2;129
84;Auvergne-Rhône-Alpes;26;1;03;137;Francillon-sur-Roubion;190;5;195
84;Auvergne-Rhône-Alpes;26;2;14;138;La Garde-Adhémar;1107;34;1141
84;Auvergne-Rhône-Alpes;26;3;11;139;Génissieux;2282;55;2337
84;Auvergne-Rhône-Alpes;26;3;13;380;Gervans;554;10;564
84;Auvergne-Rhône-Alpes;26;3;05;140;Geyssans;717;28;745
84;Auvergne-Rhône-Alpes;26;1;02;141;Gigors-et-Lozeron;193;5;198
84;Auvergne-Rhône-Alpes;26;1;04;142;Glandage;113;1;114
84;Auvergne-Rhône-Alpes;26;3;05;143;Le Grand-Serre;912;51;963
84;Auvergne-Rhône-Alpes;26;1;02;144;Grane;1913;52;1965
84;Auvergne-Rhône-Alpes;26;2;06;145;Les Granges-Gontardes;643;19;662
84;Auvergne-Rhône-Alpes;26;3;13;379;Granges-les-Beaumont;927;10;937
84;Auvergne-Rhône-Alpes;26;2;06;146;Grignan;1551;41;1592
84;Auvergne-Rhône-Alpes;26;1;04;147;Gumiane;20;1;21
84;Auvergne-Rhône-Alpes;26;3;05;148;Hauterives;1895;56;1951
84;Auvergne-Rhône-Alpes;26;3;19;149;Hostun;983;8;991
84;Auvergne-Rhône-Alpes;26;2;10;150;Izon-la-Bruisse;10;0;10
84;Auvergne-Rhône-Alpes;26;3;19;381;Jaillans;892;12;904
84;Auvergne-Rhône-Alpes;26;1;04;152;Jonchères;28;0;28
84;Auvergne-Rhône-Alpes;26;2;10;153;Laborel;102;1;103
84;Auvergne-Rhône-Alpes;26;2;10;154;Lachau;232;5;237
84;Auvergne-Rhône-Alpes;26;3;05;155;Lapeyrouse-Mornay;1219;18;1237
84;Auvergne-Rhône-Alpes;26;3;13;156;Larnage;1078;30;1108
84;Auvergne-Rhône-Alpes;26;2;03;157;La Laupie;756;18;774
84;Auvergne-Rhône-Alpes;26;1;04;159;Laval-d'Aix;118;2;120
84;Auvergne-Rhône-Alpes;26;3;12;160;Laveyron;1187;17;1204
84;Auvergne-Rhône-Alpes;26;2;10;161;Lemps;50;0;50
84;Auvergne-Rhône-Alpes;26;3;05;162;Lens-Lestang;882;29;911
84;Auvergne-Rhône-Alpes;26;1;19;163;Léoncel;51;0;51
84;Auvergne-Rhône-Alpes;26;1;04;164;Lesches-en-Diois;53;1;54
84;Auvergne-Rhône-Alpes;26;1;07;165;Livron-sur-Drôme;9104;136;9240
84;Auvergne-Rhône-Alpes;26;1;07;166;Loriol-sur-Drôme;6593;87;6680
84;Auvergne-Rhône-Alpes;26;1;04;167;Luc-en-Diois;527;2;529
84;Auvergne-Rhône-Alpes;26;1;04;168;Lus-la-Croix-Haute;549;6;555
84;Auvergne-Rhône-Alpes;26;2;06;169;Malataverne;2012;38;2050
84;Auvergne-Rhône-Alpes;26;3;16;170;Malissard;3201;96;3297
84;Auvergne-Rhône-Alpes;26;2;03;171;Manas;194;10;204
84;Auvergne-Rhône-Alpes;26;3;05;172;Manthes;670;10;680
84;Auvergne-Rhône-Alpes;26;3;19;173;Marches;836;20;856
84;Auvergne-Rhône-Alpes;26;3;05;174;Margès;1159;21;1180
84;Auvergne-Rhône-Alpes;26;1;04;175;Marignac-en-Diois;214;9;223
84;Auvergne-Rhône-Alpes;26;2;03;176;Marsanne;1343;38;1381
84;Auvergne-Rhône-Alpes;26;3;05;177;Marsaz;761;25;786
84;Auvergne-Rhône-Alpes;26;1;04;178;Menglon;517;8;525
84;Auvergne-Rhône-Alpes;26;3;13;179;Mercurol-Veaunes;2664;55;2719
84;Auvergne-Rhône-Alpes;26;2;10;180;Mérindol-les-Oliviers;236;5;241
84;Auvergne-Rhône-Alpes;26;2;10;181;Mévouillon;238;7;245
84;Auvergne-Rhône-Alpes;26;2;10;182;Mirabel-aux-Baronnies;1620;28;1648
84;Auvergne-Rhône-Alpes;26;1;02;183;Mirabel-et-Blacons;1095;28;1123
84;Auvergne-Rhône-Alpes;26;1;07;185;Mirmande;585;13;598
84;Auvergne-Rhône-Alpes;26;1;04;186;Miscon;55;1;56
84;Auvergne-Rhône-Alpes;26;2;10;188;Mollans-sur-Ouvèze;1061;24;1085
84;Auvergne-Rhône-Alpes;26;2;10;189;Montauban-sur-l'Ouvèze;110;0;110
84;Auvergne-Rhône-Alpes;26;2;10;190;Montaulieu;83;4;87
84;Auvergne-Rhône-Alpes;26;2;09;191;Montboucher-sur-Jabron;2285;57;2342
84;Auvergne-Rhône-Alpes;26;2;06;192;Montbrison-sur-Lez;281;11;292
84;Auvergne-Rhône-Alpes;26;2;10;193;Montbrun-les-Bains;441;9;450
84;Auvergne-Rhône-Alpes;26;3;05;194;Montchenu;579;16;595
84;Auvergne-Rhône-Alpes;26;1;02;195;Montclar-sur-Gervanne;186;3;189
84;Auvergne-Rhône-Alpes;26;3;17;196;Montéléger;1806;140;1946
84;Auvergne-Rhône-Alpes;26;3;16;197;Montélier;4140;114;4254
84;Auvergne-Rhône-Alpes;26;2;97;198;Montélimar;39097;1130;40227
84;Auvergne-Rhône-Alpes;26;2;10;199;Montferrand-la-Fare;29;0;29
84;Auvergne-Rhône-Alpes;26;2;10;200;Montfroc;75;1;76
84;Auvergne-Rhône-Alpes;26;2;10;201;Montguers;45;6;51
84;Auvergne-Rhône-Alpes;26;2;03;202;Montjoux;332;11;343
84;Auvergne-Rhône-Alpes;26;2;06;203;Montjoyer;286;8;294
84;Auvergne-Rhône-Alpes;26;1;04;204;Montlaur-en-Diois;146;5;151
84;Auvergne-Rhône-Alpes;26;1;04;205;Montmaur-en-Diois;83;0;83
84;Auvergne-Rhône-Alpes;26;3;02;206;Montmeyran;2916;95;3011
84;Auvergne-Rhône-Alpes;26;3;05;207;Montmiral;671;17;688
84;Auvergne-Rhône-Alpes;26;1;07;208;Montoison;1925;52;1977
84;Auvergne-Rhône-Alpes;26;2;10;209;Montréal-les-Sources;23;0;23
84;Auvergne-Rhône-Alpes;26;2;06;211;Montségur-sur-Lauzon;1312;27;1339
84;Auvergne-Rhône-Alpes;26;3;02;212;Montvendre;1185;29;1214
84;Auvergne-Rhône-Alpes;26;3;05;213;Moras-en-Valloire;667;15;682
84;Auvergne-Rhône-Alpes;26;1;03;214;Mornans;72;0;72
84;Auvergne-Rhône-Alpes;26;1;04;215;La Motte-Chalancon;426;19;445
84;Auvergne-Rhône-Alpes;26;3;12;216;La Motte-de-Galaure;795;15;810
84;Auvergne-Rhône-Alpes;26;1;19;217;La Motte-Fanjas;193;0;193
84;Auvergne-Rhône-Alpes;26;3;11;218;Mours-Saint-Eusèbe;3153;54;3207
84;Auvergne-Rhône-Alpes;26;3;12;219;Mureils;465;8;473
84;Auvergne-Rhône-Alpes;26;2;10;220;Nyons;6793;187;6980
84;Auvergne-Rhône-Alpes;26;1;02;221;Omblèze;72;1;73
84;Auvergne-Rhône-Alpes;26;2;03;222;Orcinas;38;0;38
84;Auvergne-Rhône-Alpes;26;1;19;223;Oriol-en-Royans;532;6;538
84;Auvergne-Rhône-Alpes;26;3;02;224;Ourches;251;6;257
84;Auvergne-Rhône-Alpes;26;3;05;225;Parnans;697;21;718
84;Auvergne-Rhône-Alpes;26;2;06;226;Le Pègue;364;6;370
84;Auvergne-Rhône-Alpes;26;2;10;227;Pelonne;24;0;24
84;Auvergne-Rhône-Alpes;26;2;10;229;La Penne-sur-l'Ouvèze;96;1;97
84;Auvergne-Rhône-Alpes;26;1;04;228;Pennes-le-Sec;36;0;36
84;Auvergne-Rhône-Alpes;26;3;11;231;Peyrins;2751;71;2822
84;Auvergne-Rhône-Alpes;26;3;02;232;Peyrus;606;8;614
84;Auvergne-Rhône-Alpes;26;2;10;233;Piégon;260;10;270
84;Auvergne-Rhône-Alpes;26;1;02;234;Piégros-la-Clastre;843;35;878
84;Auvergne-Rhône-Alpes;26;2;14;235;Pierrelatte;13496;256;13752
84;Auvergne-Rhône-Alpes;26;2;10;236;Pierrelongue;217;4;221
84;Auvergne-Rhône-Alpes;26;2;10;238;Les Pilles;246;2;248
84;Auvergne-Rhône-Alpes;26;2;10;239;Plaisians;199;4;203
84;Auvergne-Rhône-Alpes;26;1;02;240;Plan-de-Baix;147;3;150
84;Auvergne-Rhône-Alpes;26;1;03;241;Le Poët-Célard;127;2;129
84;Auvergne-Rhône-Alpes;26;2;10;242;Le Poët-en-Percip;17;0;17
84;Auvergne-Rhône-Alpes;26;2;03;243;Le Poët-Laval;933;41;974
84;Auvergne-Rhône-Alpes;26;2;10;244;Le Poët-Sigillat;121;1;122
84;Auvergne-Rhône-Alpes;26;2;10;245;Pommerol;11;0;11
84;Auvergne-Rhône-Alpes;26;1;04;246;Ponet-et-Saint-Auban;125;4;129
84;Auvergne-Rhône-Alpes;26;3;12;247;Ponsas;527;8;535
84;Auvergne-Rhône-Alpes;26;2;03;249;Pont-de-Barret;670;17;687
84;Auvergne-Rhône-Alpes;26;3;13;250;Pont-de-l'Isère;3503;53;3556
84;Auvergne-Rhône-Alpes;26;1;04;248;Pontaix;168;1;169
84;Auvergne-Rhône-Alpes;26;2;03;251;Portes-en-Valdaine;399;12;411
84;Auvergne-Rhône-Alpes;26;3;17;252;Portes-lès-Valence;10610;148;10758
84;Auvergne-Rhône-Alpes;26;1;04;253;Poyols;70;1;71
84;Auvergne-Rhône-Alpes;26;1;04;254;Pradelle;18;0;18
84;Auvergne-Rhône-Alpes;26;1;04;255;Les Prés;24;0;24
84;Auvergne-Rhône-Alpes;26;2;10;256;Propiac;131;2;133
84;Auvergne-Rhône-Alpes;26;1;03;258;Puy-Saint-Martin;886;29;915
84;Auvergne-Rhône-Alpes;26;2;03;257;Puygiron;433;21;454
84;Auvergne-Rhône-Alpes;26;3;05;259;Ratières;270;12;282
84;Auvergne-Rhône-Alpes;26;2;06;261;Réauville;387;11;398
84;Auvergne-Rhône-Alpes;26;1;04;262;Recoubeau-Jansac;269;7;276
84;Auvergne-Rhône-Alpes;26;2;10;263;Reilhanette;144;2;146
84;Auvergne-Rhône-Alpes;26;2;10;264;Rémuzat;343;7;350
84;Auvergne-Rhône-Alpes;26;1;02;020;La Répara-Auriples;235;6;241
84;Auvergne-Rhône-Alpes;26;1;04;266;Rimon-et-Savel;27;2;29
84;Auvergne-Rhône-Alpes;26;2;10;267;Rioms;26;1;27
84;Auvergne-Rhône-Alpes;26;3;13;271;La Roche-de-Glun;3272;75;3347
84;Auvergne-Rhône-Alpes;26;2;03;276;Roche-Saint-Secret-Béconne;452;14;466
84;Auvergne-Rhône-Alpes;26;1;02;277;La Roche-sur-Grane;170;4;174
84;Auvergne-Rhône-Alpes;26;2;10;278;La Roche-sur-le-Buis;288;10;298
84;Auvergne-Rhône-Alpes;26;2;03;268;Rochebaudin;121;0;121
84;Auvergne-Rhône-Alpes;26;2;10;269;Rochebrune;61;0;61
84;Auvergne-Rhône-Alpes;26;1;19;270;Rochechinard;120;2;122
84;Auvergne-Rhône-Alpes;26;2;03;272;Rochefort-en-Valdaine;355;9;364
84;Auvergne-Rhône-Alpes;26;3;19;273;Rochefort-Samson;1007;20;1027
84;Auvergne-Rhône-Alpes;26;1;04;274;Rochefourchat;1;0;1
84;Auvergne-Rhône-Alpes;26;2;14;275;Rochegude;1579;45;1624
84;Auvergne-Rhône-Alpes;26;2;10;279;La Rochette-du-Buis;72;2;74
84;Auvergne-Rhône-Alpes;26;3;98;281;Romans-sur-Isère;33160;672;33832
84;Auvergne-Rhône-Alpes;26;1;04;282;Romeyer;197;8;205
84;Auvergne-Rhône-Alpes;26;1;04;283;Rottier;21;2;23
84;Auvergne-Rhône-Alpes;26;2;06;284;Roussas;365;9;374
84;Auvergne-Rhône-Alpes;26;2;06;285;Rousset-les-Vignes;289;9;298
84;Auvergne-Rhône-Alpes;26;2;10;286;Roussieux;23;1;24
84;Auvergne-Rhône-Alpes;26;2;03;287;Roynac;486;18;504
84;Auvergne-Rhône-Alpes;26;2;10;288;Sahune;313;6;319
84;Auvergne-Rhône-Alpes;26;1;04;289;Saillans;1278;19;1297
84;Auvergne-Rhône-Alpes;26;1;19;290;Saint-Agnan-en-Vercors;376;10;386
84;Auvergne-Rhône-Alpes;26;1;04;291;Saint-Andéol;83;1;84
84;Auvergne-Rhône-Alpes;26;2;10;292;Saint-Auban-sur-l'Ouvèze;213;4;217
84;Auvergne-Rhône-Alpes;26;3;05;293;Saint-Avit;306;8;314
84;Auvergne-Rhône-Alpes;26;3;11;294;Saint-Bardoux;622;19;641
84;Auvergne-Rhône-Alpes;26;3;12;295;Saint-Barthélemy-de-Vals;1869;31;1900
84;Auvergne-Rhône-Alpes;26;1;04;296;Saint-Benoit-en-Diois;27;1;28
84;Auvergne-Rhône-Alpes;26;3;05;298;Saint-Christophe-et-le-Laris;416;5;421
84;Auvergne-Rhône-Alpes;26;1;04;300;Saint-Dizier-en-Diois;48;0;48
84;Auvergne-Rhône-Alpes;26;3;05;301;Saint-Donat-sur-l'Herbasse;4195;91;4286
84;Auvergne-Rhône-Alpes;26;2;10;304;Saint-Ferréol-Trente-Pas;258;5;263
84;Auvergne-Rhône-Alpes;26;2;03;305;Saint-Gervais-sur-Roubion;1035;21;1056
84;Auvergne-Rhône-Alpes;26;1;19;307;Saint-Jean-en-Royans;2868;67;2935
84;Auvergne-Rhône-Alpes;26;1;04;308;Saint-Julien-en-Quint;153;1;154
84;Auvergne-Rhône-Alpes;26;1;19;309;Saint-Julien-en-Vercors;238;5;243
84;Auvergne-Rhône-Alpes;26;3;05;310;Saint-Laurent-d'Onay;154;4;158
84;Auvergne-Rhône-Alpes;26;1;19;311;Saint-Laurent-en-Royans;1419;49;1468
84;Auvergne-Rhône-Alpes;26;2;03;312;Saint-Marcel-lès-Sauzet;1244;44;1288
84;Auvergne-Rhône-Alpes;26;3;15;313;Saint-Marcel-lès-Valence;6236;127;6363
84;Auvergne-Rhône-Alpes;26;3;05;314;Saint-Martin-d'Août;383;16;399
84;Auvergne-Rhône-Alpes;26;1;19;315;Saint-Martin-en-Vercors;361;14;375
84;Auvergne-Rhône-Alpes;26;1;19;316;Saint-Martin-le-Colonel;192;6;198
84;Auvergne-Rhône-Alpes;26;2;10;317;Saint-Maurice-sur-Eygues;781;14;795
84;Auvergne-Rhône-Alpes;26;2;10;318;Saint-May;39;1;40
84;Auvergne-Rhône-Alpes;26;3;05;319;Saint-Michel-sur-Savasse;583;10;593
84;Auvergne-Rhône-Alpes;26;1;19;320;Saint-Nazaire-en-Royans;804;10;814
84;Auvergne-Rhône-Alpes;26;1;04;321;Saint-Nazaire-le-Désert;193;8;201
84;Auvergne-Rhône-Alpes;26;2;06;322;Saint-Pantaléon-les-Vignes;441;16;457
84;Auvergne-Rhône-Alpes;26;3;11;323;Saint-Paul-lès-Romans;1822;47;1869
84;Auvergne-Rhône-Alpes;26;2;14;324;Saint-Paul-Trois-Châteaux;8937;457;9394
84;Auvergne-Rhône-Alpes;26;3;12;325;Saint-Rambert-d'Albon;6530;65;6595
84;Auvergne-Rhône-Alpes;26;2;14;326;Saint-Restitut;1387;45;1432
84;Auvergne-Rhône-Alpes;26;1;04;327;Saint-Roman;201;3;204
84;Auvergne-Rhône-Alpes;26;1;04;328;Saint-Sauveur-en-Diois;55;1;56
84;Auvergne-Rhône-Alpes;26;2;10;329;Saint-Sauveur-Gouvernet;182;6;188
84;Auvergne-Rhône-Alpes;26;3;05;330;Saint-Sorlin-en-Valloire;2268;31;2299
84;Auvergne-Rhône-Alpes;26;1;19;331;Saint-Thomas-en-Royans;596;14;610
84;Auvergne-Rhône-Alpes;26;3;12;332;Saint-Uze;2046;22;2068
84;Auvergne-Rhône-Alpes;26;3;12;333;Saint-Vallier;3915;152;4067
84;Auvergne-Rhône-Alpes;26;3;19;382;Saint-Vincent-la-Commanderie;541;7;548
84;Auvergne-Rhône-Alpes;26;1;04;299;Sainte-Croix;106;3;109
84;Auvergne-Rhône-Alpes;26;1;19;302;Sainte-Eulalie-en-Royans;544;13;557
84;Auvergne-Rhône-Alpes;26;2;10;303;Sainte-Euphémie-sur-Ouvèze;70;3;73
84;Auvergne-Rhône-Alpes;26;2;10;306;Sainte-Jalle;308;6;314
84;Auvergne-Rhône-Alpes;26;2;03;334;Salettes;145;2;147
84;Auvergne-Rhône-Alpes;26;2;06;335;Salles-sous-Bois;191;3;194
84;Auvergne-Rhône-Alpes;26;1;03;336;Saou;571;23;594
84;Auvergne-Rhône-Alpes;26;2;08;337;Saulce-sur-Rhône;1855;32;1887
84;Auvergne-Rhône-Alpes;26;2;03;338;Sauzet;1840;57;1897
84;Auvergne-Rhône-Alpes;26;2;08;339;Savasse;1444;41;1485
84;Auvergne-Rhône-Alpes;26;2;10;340;Séderon;264;4;268
84;Auvergne-Rhône-Alpes;26;3;13;341;Serves-sur-Rhône;729;13;742
84;Auvergne-Rhône-Alpes;26;1;04;001;Solaure en Diois;444;8;452
84;Auvergne-Rhône-Alpes;26;2;14;342;Solérieux;335;7;342
84;Auvergne-Rhône-Alpes;26;2;03;343;Souspierre;97;2;99
84;Auvergne-Rhône-Alpes;26;1;03;344;Soyans;388;6;394
84;Auvergne-Rhône-Alpes;26;1;02;346;Suze;234;5;239
84;Auvergne-Rhône-Alpes;26;2;14;345;Suze-la-Rousse;2104;53;2157
84;Auvergne-Rhône-Alpes;26;3;13;347;Tain-l'Hermitage;6162;204;6366
84;Auvergne-Rhône-Alpes;26;2;06;348;Taulignan;1677;29;1706
84;Auvergne-Rhône-Alpes;26;3;05;349;Tersanne;357;5;362
84;Auvergne-Rhône-Alpes;26;2;03;350;Teyssières;88;0;88
84;Auvergne-Rhône-Alpes;26;2;03;351;Les Tonils;25;0;25
84;Auvergne-Rhône-Alpes;26;2;03;352;La Touche;253;7;260
84;Auvergne-Rhône-Alpes;26;2;08;353;Les Tourrettes;1030;13;1043
84;Auvergne-Rhône-Alpes;26;3;11;355;Triors;567;8;575
84;Auvergne-Rhône-Alpes;26;2;03;356;Truinas;119;4;123
84;Auvergne-Rhône-Alpes;26;2;06;357;Tulette;1989;39;2028
84;Auvergne-Rhône-Alpes;26;3;02;358;Upie;1520;45;1565
84;Auvergne-Rhône-Alpes;26;1;04;359;Vachères-en-Quint;32;0;32
84;Auvergne-Rhône-Alpes;26;1;04;136;Val-Maravel;55;0;55
84;Auvergne-Rhône-Alpes;26;2;06;360;Valaurie;593;16;609
84;Auvergne-Rhône-Alpes;26;1;04;361;Valdrôme;146;1;147
84;Auvergne-Rhône-Alpes;26;3;99;362;Valence;63714;1314;65028
84;Auvergne-Rhône-Alpes;26;3;05;210;Valherbasse;1010;23;1033
84;Auvergne-Rhône-Alpes;26;2;10;363;Valouse;36;0;36
84;Auvergne-Rhône-Alpes;26;1;19;364;Vassieux-en-Vercors;313;4;317
84;Auvergne-Rhône-Alpes;26;1;02;365;Vaunaveys-la-Rochette;584;11;595
84;Auvergne-Rhône-Alpes;26;2;10;367;Venterol;699;20;719
84;Auvergne-Rhône-Alpes;26;1;04;368;Vercheny;461;6;467
84;Auvergne-Rhône-Alpes;26;2;10;369;Verclause;59;1;60
84;Auvergne-Rhône-Alpes;26;2;10;370;Vercoiran;141;6;147
84;Auvergne-Rhône-Alpes;26;1;04;371;Véronne;46;2;48
84;Auvergne-Rhône-Alpes;26;2;10;372;Vers-sur-Méouge;42;1;43
84;Auvergne-Rhône-Alpes;26;2;03;373;Vesc;260;8;268
84;Auvergne-Rhône-Alpes;26;2;10;374;Villebois-les-Pins;16;0;16
84;Auvergne-Rhône-Alpes;26;2;10;375;Villefranche-le-Château;20;1;21
84;Auvergne-Rhône-Alpes;26;2;10;376;Villeperdrix;118;0;118
84;Auvergne-Rhône-Alpes;26;2;10;377;Vinsobres;1115;25;1140
84;Auvergne-Rhône-Alpes;26;1;04;378;Volvent;33;0;33
28;Normandie;27;2;07;001;Aclou;324;9;333
28;Normandie;27;3;22;002;Acon;468;8;476
28;Normandie;27;1;18;003;Acquigny;1586;34;1620
28;Normandie;27;1;16;004;Aigleville;409;8;417
28;Normandie;27;1;12;005;Ailly;1159;17;1176
28;Normandie;27;2;04;006;Aizier;137;2;139
28;Normandie;27;1;18;008;Alizay;1544;17;1561
28;Normandie;27;2;06;009;Ambenay;566;8;574
28;Normandie;27;1;13;010;Amécourt;162;1;163
28;Normandie;27;1;19;012;Amfreville-les-Champs;453;16;469
28;Normandie;27;2;05;011;Amfreville-Saint-Amand;1204;14;1218
28;Normandie;27;1;21;013;Amfreville-sous-les-Monts;494;11;505
28;Normandie;27;1;18;014;Amfreville-sur-Iton;830;22;852
28;Normandie;27;1;14;015;Andé;1288;31;1319
28;Normandie;27;1;01;016;Les Andelys;8056;143;8199
28;Normandie;27;3;11;017;Angerville-la-Campagne;1391;36;1427
28;Normandie;27;2;17;018;Appeville-Annebault;1013;11;1024
28;Normandie;27;2;22;019;Armentières-sur-Avre;170;7;177
28;Normandie;27;3;09;020;Arnières-sur-Iton;1682;43;1725
28;Normandie;27;2;03;021;Asnières;320;9;329
28;Normandie;27;3;08;023;Aulnay-sur-Iton;709;21;730
28;Normandie;27;1;12;025;Autheuil-Authouillet;958;19;977
28;Normandie;27;1;13;026;Authevernes;400;8;408
28;Normandie;27;3;20;027;Les Authieux;294;7;301
28;Normandie;27;2;17;028;Authou;338;4;342
28;Normandie;27;3;10;031;Aviron;1100;59;1159
28;Normandie;27;2;15;033;Bacquepuis;313;7;320
28;Normandie;27;1;19;034;Bacqueville;628;9;637
28;Normandie;27;2;03;035;Bailleul-la-Vallée;114;1;115
28;Normandie;27;2;22;036;Bâlines;567;8;575
28;Normandie;27;2;07;037;Barc;1225;17;1242
28;Normandie;27;2;22;038;Les Barils;269;6;275
28;Normandie;27;2;04;039;Barneville-sur-Seine;511;38;549
28;Normandie;27;3;20;277;La Baronnie;718;15;733
28;Normandie;27;2;07;040;Barquet;449;6;455
28;Normandie;27;2;03;042;Barville;71;0;71
28;Normandie;27;2;06;043;Les Baux-de-Breteuil;664;20;684
28;Normandie;27;3;11;044;Les Baux-Sainte-Croix;840;38;878
28;Normandie;27;1;13;045;Bazincourt-sur-Epte;757;12;769
28;Normandie;27;2;03;046;Bazoques;161;1;162
28;Normandie;27;3;08;047;Beaubray;318;6;324
28;Normandie;27;1;19;048;Beauficel-en-Lyons;188;3;191
28;Normandie;27;2;07;051;Beaumont-le-Roger;2879;37;2916
28;Normandie;27;2;07;050;Beaumontel;657;15;672
28;Normandie;27;2;07;052;Le Bec-Hellouin;396;3;399
28;Normandie;27;2;05;053;Le Bec-Thomas;219;5;224
28;Normandie;27;2;06;054;Bémécourt;576;7;583
28;Normandie;27;2;15;055;Bérengeville-la-Campagne;324;6;330
28;Normandie;27;2;02;056;Bernay;10085;358;10443
28;Normandie;27;2;15;057;Bernienville;288;6;294
28;Normandie;27;1;13;059;Bernouville;303;3;306
28;Normandie;27;2;07;061;Berthouville;312;5;317
28;Normandie;27;2;07;063;Berville-la-Campagne;245;1;246
28;Normandie;27;2;03;064;Berville-sur-Mer;709;9;718
28;Normandie;27;2;03;065;Beuzeville;4608;59;4667
28;Normandie;27;1;19;066;Bézu-la-Forêt;320;6;326
28;Normandie;27;1;13;067;Bézu-Saint-Éloi;1505;28;1533
28;Normandie;27;2;06;068;Bois-Anzeray;176;2;178
28;Normandie;27;2;06;069;Bois-Arnault;700;16;716
28;Normandie;27;2;03;071;Le Bois-Hellain;226;2;228
28;Normandie;27;1;01;072;Bois-Jérôme-Saint-Ouen;749;23;772
28;Normandie;27;3;20;073;Bois-le-Roi;1185;18;1203
28;Normandie;27;2;06;075;Bois-Normand-près-Lyre;340;4;344
28;Normandie;27;2;07;074;Boisney;283;8;291
28;Normandie;27;1;16;076;Boisset-les-Prévanches;468;9;477
28;Normandie;27;2;05;077;Boissey-le-Châtel;880;10;890
28;Normandie;27;1;16;078;La Boissière;273;4;277
28;Normandie;27;2;03;079;Boissy-Lamberville;350;5;355
28;Normandie;27;3;11;081;Boncourt;186;6;192
28;Normandie;27;2;17;083;Bonneville-Aptot;257;4;261
28;Normandie;27;3;08;082;La Bonneville-sur-Iton;2131;50;2181
28;Normandie;27;2;15;302;Le Bosc du Theil;1344;13;1357
28;Normandie;27;2;04;091;Bosgouet;707;5;712
28;Normandie;27;1;19;094;Bosquentin;123;1;124
28;Normandie;27;2;07;095;Bosrobert;664;5;669
28;Normandie;27;2;05;090;Bosroumois;3588;67;3655
28;Normandie;27;2;06;096;Les Bottereaux;349;12;361
28;Normandie;27;1;01;097;Bouafles;653;12;665
28;Normandie;27;1;19;098;Bouchevilliers;81;3;84
28;Normandie;27;3;10;099;Le Boulay-Morin;777;10;787
28;Normandie;27;2;03;100;Boulleville;1148;21;1169
28;Normandie;27;2;04;101;Bouquelon;512;9;521
28;Normandie;27;2;04;102;Bouquetot;1060;22;1082
28;Normandie;27;2;04;103;Bourg-Achard;3947;49;3996
28;Normandie;27;1;19;104;Bourg-Beaudouin;708;10;718
28;Normandie;27;2;03;106;Bournainville-Faverolles;483;5;488
28;Normandie;27;2;04;107;Bourneville-Sainte-Croix;1291;24;1315
28;Normandie;27;2;22;108;Bourth;1255;34;1289
28;Normandie;27;2;07;109;Bray;398;4;402
28;Normandie;27;2;17;110;Brestot;596;6;602
28;Normandie;27;3;20;111;Bretagnolles;201;5;206
28;Normandie;27;2;06;112;Breteuil;4424;120;4544
28;Normandie;27;2;07;113;Brétigny;134;6;140
28;Normandie;27;1;16;114;Breuilpont;1222;21;1243
28;Normandie;27;2;22;115;Breux-sur-Avre;346;7;353
28;Normandie;27;2;07;116;Brionne;4278;152;4430
28;Normandie;27;2;06;117;Broglie;1057;21;1078
28;Normandie;27;2;15;118;Brosville;633;10;643
28;Normandie;27;1;16;119;Bueil;1621;29;1650
28;Normandie;27;3;08;120;Burey;400;5;405
28;Normandie;27;1;16;123;Caillouet-Orgeville;477;12;489
28;Normandie;27;1;12;124;Cailly-sur-Eure;219;1;220
28;Normandie;27;2;07;125;Calleville;669;11;680
28;Normandie;27;2;17;126;Campigny;1201;10;1211
28;Normandie;27;2;15;127;Canappeville;678;20;698
28;Normandie;27;2;02;129;Caorches-Saint-Nicolas;592;15;607
28;Normandie;27;2;06;130;Capelle-les-Grands;428;11;439
28;Normandie;27;3;08;132;Caugé;866;24;890
28;Normandie;27;2;04;133;Caumont;1058;10;1068
28;Normandie;27;2;04;134;Cauverville-en-Roumois;226;0;226
28;Normandie;27;2;15;135;Cesseville;489;5;494
28;Normandie;27;1;16;136;Chaignes;277;12;289
28;Normandie;27;2;06;137;Chaise-Dieu-du-Theil;216;5;221
28;Normandie;27;2;06;138;Chamblac;391;13;404
28;Normandie;27;2;22;032;Chambois;1376;31;1407
28;Normandie;27;2;06;139;Chambord;163;6;169
28;Normandie;27;1;16;140;Chambray;423;11;434
28;Normandie;27;3;08;141;Champ-Dolent;66;0;66
28;Normandie;27;1;12;142;Champenard;270;7;277
28;Normandie;27;3;20;144;Champigny-la-Futelaye;289;3;292
28;Normandie;27;2;03;146;La Chapelle-Bayvel;386;5;391
28;Normandie;27;3;10;147;La Chapelle-du-Bois-des-Faulx;653;10;663
28;Normandie;27;2;06;148;La Chapelle-Gauthier;398;6;404
28;Normandie;27;2;03;149;La Chapelle-Hareng;100;3;103
28;Normandie;27;1;16;554;La Chapelle-Longueville;3371;105;3476
28;Normandie;27;1;19;151;Charleval;1789;21;1810
28;Normandie;27;1;01;152;Château-sur-Epte;569;9;578
28;Normandie;27;1;13;153;Chauvincourt-Provemont;365;6;371
28;Normandie;27;3;20;154;Chavigny-Bailleul;593;16;609
28;Normandie;27;2;22;155;Chennebrun;109;1;110
28;Normandie;27;2;06;156;Chéronvilliers;505;17;522
28;Normandie;27;3;11;158;Cierrey;743;27;770
28;Normandie;27;3;08;161;Claville;1082;21;1103
28;Normandie;27;1;12;191;Clef Vallée d'Eure;2533;47;2580
28;Normandie;27;3;08;162;Collandres-Quincarnon;233;5;238
28;Normandie;27;2;17;163;Colletot;202;1;203
28;Normandie;27;2;07;164;Combon;813;8;821
28;Normandie;27;3;08;165;Conches-en-Ouche;5030;65;5095
28;Normandie;27;2;17;167;Condé-sur-Risle;639;6;645
28;Normandie;27;1;21;168;Connelles;189;7;196
28;Normandie;27;2;03;169;Conteville;999;10;1009
28;Normandie;27;2;03;170;Cormeilles;1161;21;1182
28;Normandie;27;1;16;171;Le Cormier;408;12;420
28;Normandie;27;2;02;173;Corneville-la-Fouquetière;121;3;124
28;Normandie;27;2;17;174;Corneville-sur-Risle;1357;25;1382
28;Normandie;27;1;13;176;Coudray;218;5;223
28;Normandie;27;3;20;177;Coudres;552;12;564
28;Normandie;27;2;02;179;Courbépine;727;16;743
28;Normandie;27;1;12;180;Courcelles-sur-Seine;2040;34;2074
28;Normandie;27;3;22;181;Courdemanche;597;12;609
28;Normandie;27;2;22;182;Courteilles;148;1;149
28;Normandie;27;3;20;183;La Couture-Boussey;2314;45;2359
28;Normandie;27;1;18;184;Crasville;126;3;129
28;Normandie;27;2;15;185;Crestot;565;6;571
28;Normandie;27;2;15;187;Criquebeuf-la-Campagne;310;4;314
28;Normandie;27;1;18;188;Criquebeuf-sur-Seine;1449;15;1464
28;Normandie;27;3;08;189;La Croisille;440;7;447
28;Normandie;27;1;16;190;Croisy-sur-Eure;188;10;198
28;Normandie;27;2;15;192;Crosville-la-Vieille;603;11;614
28;Normandie;27;3;20;193;Croth;1348;16;1364
28;Normandie;27;1;01;194;Cuverville;248;2;250
28;Normandie;27;1;18;196;Les Damps;1389;8;1397
28;Normandie;27;1;13;199;Dangu;573;12;585
28;Normandie;27;3;10;200;Dardez;152;7;159
28;Normandie;27;2;15;201;Daubeuf-la-Campagne;233;6;239
28;Normandie;27;1;01;202;Daubeuf-près-Vatteville;468;8;476
28;Normandie;27;1;16;203;Douains;513;14;527
28;Normandie;27;1;13;204;Doudeauville-en-Vexin;302;9;311
28;Normandie;27;1;19;205;Douville-sur-Andelle;446;3;449
28;Normandie;27;3;22;206;Droisy;439;3;442
28;Normandie;27;2;03;207;Drucourt;606;8;614
28;Normandie;27;2;03;208;Duranville;153;3;156
28;Normandie;27;2;17;209;Écaquelon;613;11;624
28;Normandie;27;2;07;210;Écardenville-la-Campagne;473;12;485
28;Normandie;27;2;15;212;Écauville;111;2;113
28;Normandie;27;1;01;214;Écouis;816;14;830
28;Normandie;27;2;15;215;Ecquetot;374;9;383
28;Normandie;27;3;10;216;Émalleville;522;26;548
28;Normandie;27;2;15;217;Émanville;572;9;581
28;Normandie;27;2;03;218;Épaignes;1617;16;1633
28;Normandie;27;2;15;219;Épégard;574;8;582
28;Normandie;27;3;20;220;Épieds;354;3;357
28;Normandie;27;2;03;222;Épreville-en-Lieuvin;195;3;198
28;Normandie;27;2;15;224;Épreville-près-le-Neubourg;471;10;481
28;Normandie;27;1;13;226;Étrépagny;3764;80;3844
28;Normandie;27;2;04;227;Étréville;676;11;687
28;Normandie;27;2;04;228;Éturqueraye;298;3;301
28;Normandie;27;3;99;229;Évreux;47733;1299;49032
28;Normandie;27;3;20;230;Ézy-sur-Eure;3670;52;3722
28;Normandie;27;1;16;231;Fains;440;7;447
28;Normandie;27;1;13;232;Farceaux;344;6;350
28;Normandie;27;2;03;233;Fatouville-Grestain;746;11;757
28;Normandie;27;3;11;234;Fauville;353;6;359
28;Normandie;27;3;08;235;Faverolles-la-Campagne;159;3;162
28;Normandie;27;2;03;237;Le Favril;170;2;172
28;Normandie;27;3;08;240;La Ferrière-sur-Risle;221;3;224
28;Normandie;27;3;08;238;Ferrières-Haut-Clocher;1166;27;1193
28;Normandie;27;2;06;239;Ferrières-Saint-Hilaire;419;7;426
28;Normandie;27;2;15;241;Feuguerolles;177;5;182
28;Normandie;27;3;08;242;Le Fidelaire;1024;14;1038
28;Normandie;27;2;03;243;Fiquefleur-Équainville;725;10;735
28;Normandie;27;2;05;085;Flancourt-Crescy-en-Roumois;1455;20;1475
28;Normandie;27;1;19;245;Fleury-la-Forêt;265;8;273
28;Normandie;27;1;19;246;Fleury-sur-Andelle;1844;20;1864
28;Normandie;27;1;19;247;Flipou;324;3;327
28;Normandie;27;2;03;248;Folleville;199;4;203
28;Normandie;27;1;12;249;Fontaine-Bellenger;1150;20;1170
28;Normandie;27;2;02;251;Fontaine-l'Abbé;527;8;535
28;Normandie;27;2;03;252;Fontaine-la-Louvet;332;7;339
28;Normandie;27;1;16;254;Fontaine-sous-Jouy;873;24;897
28;Normandie;27;3;20;256;La Forêt-du-Parc;597;9;606
28;Normandie;27;2;03;258;Fort-Moville;500;7;507
28;Normandie;27;3;20;259;Foucrainville;78;3;81
28;Normandie;27;2;03;260;Foulbec;659;8;667
28;Normandie;27;2;05;261;Fouqueville;460;5;465
28;Normandie;27;2;07;266;Franqueville;332;6;338
28;Normandie;27;1;01;070;Frenelles-en-Vexin;1689;36;1725
28;Normandie;27;2;17;267;Freneuse-sur-Risle;360;4;364
28;Normandie;27;2;03;269;Fresne-Cauverville;196;3;199
28;Normandie;27;3;20;271;Fresney;346;6;352
28;Normandie;27;1;16;273;Gadencourt;382;6;388
28;Normandie;27;1;12;275;Gaillon;6924;98;7022
28;Normandie;27;1;13;276;Gamaches-en-Vexin;291;8;299
28;Normandie;27;3;20;278;Garennes-sur-Eure;1908;37;1945
28;Normandie;27;1;23;279;Gasny;3089;50;3139
28;Normandie;27;3;11;280;Gauciel;861;7;868
28;Normandie;27;3;08;281;Gaudreville-la-Rivière;227;8;235
28;Normandie;27;3;08;282;Gauville-la-Campagne;578;12;590
28;Normandie;27;1;13;284;Gisors;11537;167;11704
28;Normandie;27;1;23;285;Giverny;494;15;509
28;Normandie;27;2;03;286;Giverville;400;5;405
28;Normandie;27;3;08;287;Glisolles;847;17;864
28;Normandie;27;2;17;288;Glos-sur-Risle;591;13;604
28;Normandie;27;2;06;289;La Goulafrière;165;3;168
28;Normandie;27;2;07;290;Goupil-Othon;1257;17;1274
28;Normandie;27;2;22;291;Gournay-le-Guérin;132;11;143
28;Normandie;27;2;05;105;Grand Bourgtheroulde;3802;72;3874
28;Normandie;27;2;06;295;Grand-Camp;493;10;503
28;Normandie;27;2;15;298;Graveron-Sémerville;303;6;309
28;Normandie;27;3;10;299;Gravigny;3940;81;4021
28;Normandie;27;2;07;300;Grosley-sur-Risle;523;4;527
28;Normandie;27;3;20;301;Grossœuvre;1227;26;1253
28;Normandie;27;1;13;304;Guerny;172;6;178
28;Normandie;27;3;11;306;Guichainville;2757;56;2813
28;Normandie;27;1;01;307;Guiseniers;461;8;469
28;Normandie;27;3;20;309;L' Habit;506;7;513
28;Normandie;27;1;13;310;Hacqueville;438;8;446
28;Normandie;27;2;07;311;Harcourt;1068;6;1074
28;Normandie;27;1;16;312;Hardencourt-Cocherel;259;13;272
28;Normandie;27;2;05;313;La Harengère;595;5;600
28;Normandie;27;1;01;315;Harquency;264;9;273
28;Normandie;27;2;04;316;Hauville;1279;27;1306
28;Normandie;27;2;04;317;La Haye-Aubrée;462;11;473
28;Normandie;27;2;07;318;La Haye-de-Calleville;265;3;268
28;Normandie;27;2;04;319;La Haye-de-Routot;305;5;310
28;Normandie;27;2;05;320;La Haye-du-Theil;298;0;298
28;Normandie;27;1;18;321;La Haye-le-Comte;135;5;140
28;Normandie;27;1;18;322;La Haye-Malherbe;1403;19;1422
28;Normandie;27;2;06;323;La Haye-Saint-Sylvestre;279;2;281
28;Normandie;27;1;13;324;Hébécourt;586;13;599
28;Normandie;27;2;07;325;Hecmanville;173;3;176
28;Normandie;27;1;16;326;Hécourt;330;13;343
28;Normandie;27;2;15;327;Hectomare;219;8;227
28;Normandie;27;1;01;329;Hennezis;789;15;804
28;Normandie;27;1;21;330;Herqueville;134;4;138
28;Normandie;27;1;01;331;Heubécourt-Haricourt;464;10;474
28;Normandie;27;1;14;332;Heudebouville;788;12;800
28;Normandie;27;1;13;333;Heudicourt;684;7;691
28;Normandie;27;2;03;334;Heudreville-en-Lieuvin;108;0;108
28;Normandie;27;1;12;335;Heudreville-sur-Eure;1052;31;1083
28;Normandie;27;1;16;336;La Heunière;367;4;371
28;Normandie;27;1;01;337;Heuqueville;361;6;367
28;Normandie;27;1;19;338;Les Hogues;642;8;650
28;Normandie;27;2;15;339;Hondouville;798;15;813
28;Normandie;27;2;04;340;Honguemare-Guenouville;696;7;703
28;Normandie;27;2;22;341;L' Hosmes;68;3;71
28;Normandie;27;2;15;342;Houetteville;205;6;211
28;Normandie;27;1;16;343;Houlbec-Cocherel;1305;56;1361
28;Normandie;27;2;07;345;La Houssaye;210;2;212
28;Normandie;27;1;19;346;Houville-en-Vexin;233;1;234
28;Normandie;27;3;11;347;Huest;799;14;813
28;Normandie;27;1;18;348;Igoville;1746;20;1766
28;Normandie;27;2;17;349;Illeville-sur-Montfort;874;22;896
28;Normandie;27;3;22;350;Illiers-l'Évêque;999;17;1016
28;Normandie;27;1;14;351;Incarville;1416;24;1440
28;Normandie;27;3;10;353;Irreville;467;8;475
28;Normandie;27;2;15;354;Iville;464;4;468
28;Normandie;27;3;20;355;Ivry-la-Bataille;2724;29;2753
28;Normandie;27;1;16;358;Jouy-sur-Eure;583;13;596
28;Normandie;27;2;06;359;Juignettes;220;1;221
28;Normandie;27;3;20;360;Jumelles;321;7;328
28;Normandie;27;2;03;361;La Lande-Saint-Léger;368;4;372
28;Normandie;27;2;04;363;Le Landin;209;5;214
28;Normandie;27;2;07;364;Launay;200;3;203
28;Normandie;27;1;21;365;Léry;2033;38;2071
28;Normandie;27;2;06;565;Le Lesme;669;9;678
28;Normandie;27;1;19;366;Letteguives;203;3;206
28;Normandie;27;2;03;367;Lieurey;1451;16;1467
28;Normandie;27;3;20;368;Lignerolles;327;10;337
28;Normandie;27;1;19;369;Lilly;84;2;86
28;Normandie;27;1;19;370;Lisors;350;6;356
28;Normandie;27;2;07;371;Livet-sur-Authou;150;1;151
28;Normandie;27;1;13;372;Longchamps;635;5;640
28;Normandie;27;1;19;373;Lorleau;144;2;146
28;Normandie;27;3;08;374;Louversey;538;14;552
28;Normandie;27;1;14;375;Louviers;18648;421;19069
28;Normandie;27;3;20;376;Louye;220;6;226
28;Normandie;27;1;19;377;Lyons-la-Forêt;723;7;730
28;Normandie;27;3;22;378;La Madeleine-de-Nonancourt;1146;23;1169
28;Normandie;27;1;19;379;Mainneville;425;8;433
28;Normandie;27;2;07;380;Malleville-sur-le-Bec;261;4;265
28;Normandie;27;2;02;381;Malouy;160;0;160
28;Normandie;27;2;15;382;Mandeville;318;9;327
28;Normandie;27;2;22;383;Mandres;373;11;384
28;Normandie;27;2;03;384;Manneville-la-Raoult;506;11;517
28;Normandie;27;2;17;385;Manneville-sur-Risle;1531;21;1552
28;Normandie;27;1;18;386;Le Manoir;1278;6;1284
28;Normandie;27;2;04;388;Marais-Vernier;508;13;521
28;Normandie;27;2;15;389;Marbeuf;461;17;478
28;Normandie;27;2;89;157;Marbois;1387;20;1407
28;Normandie;27;3;22;390;Marcilly-la-Campagne;1161;17;1178
28;Normandie;27;3;20;391;Marcilly-sur-Eure;1580;31;1611
28;Normandie;27;1;19;392;Martagny;152;4;156
28;Normandie;27;2;03;393;Martainville;493;2;495
28;Normandie;27;1;18;394;Martot;573;11;584
28;Normandie;27;2;06;395;Mélicourt;83;1;84
28;Normandie;27;1;19;396;Ménesqueville;465;8;473
28;Normandie;27;1;16;397;Ménilles;1728;42;1770
28;Normandie;27;2;02;398;Menneval;1430;94;1524
28;Normandie;27;1;16;399;Mercey;50;1;51
28;Normandie;27;1;16;400;Merey;348;5;353
28;Normandie;27;2;02;049;Mesnil-en-Ouche;4684;128;4812
28;Normandie;27;3;15;401;Le Mesnil-Fuguet;171;7;178
28;Normandie;27;1;18;403;Le Mesnil-Jourdain;233;12;245
28;Normandie;27;2;06;404;Mesnil-Rousset;93;1;94
28;Normandie;27;2;03;541;Le Mesnil-Saint-Jean;209;6;215
28;Normandie;27;1;19;405;Mesnil-sous-Vienne;110;5;115
28;Normandie;27;3;20;406;Mesnil-sur-l'Estrée;904;22;926
28;Normandie;27;1;01;407;Mesnil-Verclives;316;9;325
28;Normandie;27;2;88;198;Mesnils-sur-Iton;6122;252;6374
28;Normandie;27;1;01;408;Mézières-en-Vexin;613;18;631
28;Normandie;27;3;11;410;Miserey;629;7;636
28;Normandie;27;3;22;411;Moisville;238;1;239
28;Normandie;27;2;17;413;Montfort-sur-Risle;761;11;772
28;Normandie;27;2;06;414;Montreuil-l'Argillé;823;11;834
28;Normandie;27;2;05;062;Les Monts du Roumois;1559;32;1591
28;Normandie;27;2;03;415;Morainville-Jouveaux;372;3;375
28;Normandie;27;1;13;417;Morgny;656;12;668
28;Normandie;27;2;07;418;Morsan;108;0;108
28;Normandie;27;3;20;419;Mouettes;786;5;791
28;Normandie;27;1;13;420;Mouflaines;167;9;176
28;Normandie;27;3;20;421;Mousseaux-Neuville;647;14;661
28;Normandie;27;1;01;422;Muids;871;25;896
28;Normandie;27;3;20;423;Muzy;805;19;824
28;Normandie;27;3;08;424;Nagel-Séez-Mesnil;327;8;335
28;Normandie;27;2;87;425;Nassandres sur Risle;2394;46;2440
28;Normandie;27;2;06;427;Neaufles-Auvergny;423;8;431
28;Normandie;27;1;13;426;Neaufles-Saint-Martin;1294;7;1301
28;Normandie;27;2;15;428;Le Neubourg;4166;209;4375
28;Normandie;27;1;16;429;Neuilly;178;0;178
28;Normandie;27;1;13;430;La Neuve-Grange;330;3;333
28;Normandie;27;2;06;431;La Neuve-Lyre;573;6;579
28;Normandie;27;2;07;432;La Neuville-du-Bosc;652;7;659
28;Normandie;27;2;07;433;Neuville-sur-Authou;194;2;196
28;Normandie;27;2;03;434;Noards;54;0;54
28;Normandie;27;2;03;435;La Noë-Poulain;272;3;275
28;Normandie;27;3;08;436;Nogent-le-Sec;427;6;433
28;Normandie;27;1;13;437;Nojeon-en-Vexin;339;6;345
28;Normandie;27;3;22;438;Nonancourt;2282;46;2328
28;Normandie;27;3;10;439;Normanville;1073;35;1108
28;Normandie;27;2;07;441;Notre-Dame-d'Épine;81;0;81
28;Normandie;27;1;01;440;Notre-Dame-de-l'Isle;671;21;692
28;Normandie;27;2;06;442;Notre-Dame-du-Hamel;210;7;217
28;Normandie;27;2;02;444;Le Noyer-en-Ouche;228;2;230
28;Normandie;27;1;13;445;Noyers;264;4;268
28;Normandie;27;3;08;446;Ormes;489;3;492
28;Normandie;27;1;16;448;Pacy-sur-Eure;5090;124;5214
28;Normandie;27;3;08;451;Parville;308;6;314
28;Normandie;27;2;84;263;Le Perrey;1233;13;1246
28;Normandie;27;1;19;453;Perriers-sur-Andelle;1809;19;1828
28;Normandie;27;1;19;454;Perruel;469;3;472
28;Normandie;27;2;03;455;Piencourt;155;3;158
28;Normandie;27;1;18;456;Pinterville;745;10;755
28;Normandie;27;2;22;457;Piseux;744;13;757
28;Normandie;27;1;18;458;Pîtres;2519;25;2544
28;Normandie;27;2;03;459;Les Places;78;1;79
28;Normandie;27;2;02;460;Plainville;195;5;200
28;Normandie;27;2;03;462;Le Planquay;157;2;159
28;Normandie;27;2;02;463;Plasnes;713;9;722
28;Normandie;27;3;11;464;Le Plessis-Grohan;870;18;888
28;Normandie;27;1;16;465;Le Plessis-Hébert;400;13;413
28;Normandie;27;2;07;466;Le Plessis-Sainte-Opportune;335;5;340
28;Normandie;27;2;17;467;Pont-Audemer;10230;245;10475
28;Normandie;27;2;17;468;Pont-Authou;632;8;640
28;Normandie;27;1;18;469;Pont-de-l'Arche;4143;57;4200
28;Normandie;27;1;19;470;Pont-Saint-Pierre;1151;22;1173
28;Normandie;27;1;01;473;Port-Mort;931;26;957
28;Normandie;27;1;21;471;Porte-de-Seine;207;7;214
28;Normandie;27;3;08;472;Portes;271;3;274
28;Normandie;27;1;21;474;Poses;1169;22;1191
28;Normandie;27;2;03;475;La Poterie-Mathieu;169;1;170
28;Normandie;27;2;17;476;Les Préaux;377;9;386
28;Normandie;27;1;01;477;Pressagny-l'Orgueilleux;706;26;732
28;Normandie;27;3;20;478;Prey;950;25;975
28;Normandie;27;1;13;480;Puchay;626;7;633
28;Normandie;27;2;22;481;Pullay;400;53;453
28;Normandie;27;2;15;482;La Pyle;156;4;160
28;Normandie;27;1;18;483;Quatremare;418;6;424
28;Normandie;27;2;04;485;Quillebeuf-sur-Seine;870;9;879
28;Normandie;27;2;15;486;Quittebeuf;663;11;674
28;Normandie;27;1;19;487;Radepont;657;5;662
28;Normandie;27;1;19;488;Renneville;197;3;200
28;Normandie;27;3;10;489;Reuilly;525;12;537
28;Normandie;27;1;13;490;Richeville;272;5;277
28;Normandie;27;2;07;492;Romilly-la-Puthenaye;318;10;328
28;Normandie;27;1;19;493;Romilly-sur-Andelle;3261;51;3312
28;Normandie;27;1;01;495;La Roquette;238;2;240
28;Normandie;27;1;19;496;Rosay-sur-Lieure;530;6;536
28;Normandie;27;2;07;498;Rouge-Perriers;367;4;371
28;Normandie;27;2;04;497;Rougemontiers;1058;9;1067
28;Normandie;27;2;04;500;Routot;1600;52;1652
28;Normandie;27;1;16;501;Rouvray;263;6;269
28;Normandie;27;2;06;502;Rugles;2246;27;2273
28;Normandie;27;3;15;504;Sacquenville;1231;36;1267
28;Normandie;27;2;06;505;Saint-Agnan-de-Cernières;161;1;162
28;Normandie;27;3;20;507;Saint-André-de-l'Eure;3988;65;4053
28;Normandie;27;2;06;508;Saint-Antonin-de-Sommaire;183;5;188
28;Normandie;27;2;15;511;Saint-Aubin-d'Écrosville;709;11;720
28;Normandie;27;2;03;512;Saint-Aubin-de-Scellon;346;7;353
28;Normandie;27;2;06;514;Saint-Aubin-du-Thenney;373;3;376
28;Normandie;27;1;12;517;Saint-Aubin-sur-Gaillon;1989;44;2033
28;Normandie;27;2;04;518;Saint-Aubin-sur-Quillebeuf;716;13;729
28;Normandie;27;2;03;520;Saint-Benoît-des-Ombres;143;2;145
28;Normandie;27;2;22;521;Saint-Christophe-sur-Avre;142;6;148
28;Normandie;27;2;03;522;Saint-Christophe-sur-Condé;481;4;485
28;Normandie;27;2;07;527;Saint-Cyr-de-Salerne;205;7;212
28;Normandie;27;2;05;529;Saint-Cyr-la-Campagne;427;9;436
28;Normandie;27;2;06;530;Saint-Denis-d'Augerons;85;4;89
28;Normandie;27;2;05;531;Saint-Denis-des-Monts;211;2;213
28;Normandie;27;1;13;533;Saint-Denis-le-Ferment;488;20;508
28;Normandie;27;2;05;534;Saint-Didier-des-Bois;887;10;897
28;Normandie;27;3;08;535;Saint-Élier;440;9;449
28;Normandie;27;2;07;536;Saint-Éloi-de-Fourques;522;15;537
28;Normandie;27;1;14;537;Saint-Étienne-du-Vauvray;882;14;896
28;Normandie;27;2;03;538;Saint-Étienne-l'Allier;547;9;556
28;Normandie;27;1;12;539;Saint-Étienne-sous-Bailleul;388;13;401
28;Normandie;27;2;03;542;Saint-Georges-du-Vièvre;884;15;899
28;Normandie;27;3;20;543;Saint-Georges-Motel;889;11;900
28;Normandie;27;3;20;544;Saint-Germain-de-Fresney;206;5;211
28;Normandie;27;2;05;545;Saint-Germain-de-Pasquier;126;5;131
28;Normandie;27;3;10;546;Saint-Germain-des-Angles;173;2;175
28;Normandie;27;2;03;547;Saint-Germain-la-Campagne;893;11;904
28;Normandie;27;3;22;548;Saint-Germain-sur-Avre;1177;25;1202
28;Normandie;27;2;03;550;Saint-Grégoire-du-Vièvre;318;7;325
28;Normandie;27;2;06;552;Saint-Jean-du-Thenney;245;7;252
28;Normandie;27;1;12;553;Saint-Julien-de-la-Liègue;413;3;416
28;Normandie;27;3;20;555;Saint-Laurent-des-Bois;248;5;253
28;Normandie;27;2;06;556;Saint-Laurent-du-Tencement;64;0;64
28;Normandie;27;2;02;557;Saint-Léger-de-Rôtes;436;6;442
28;Normandie;27;2;05;558;Saint-Léger-du-Gennetey;182;6;188
28;Normandie;27;3;11;560;Saint-Luc;253;12;265
28;Normandie;27;2;03;561;Saint-Maclou;627;12;639
28;Normandie;27;1;16;562;Saint-Marcel;4493;136;4629
28;Normandie;27;2;17;563;Saint-Mards-de-Blacarville;801;16;817
28;Normandie;27;2;03;564;Saint-Mards-de-Fresne;334;6;340
28;Normandie;27;2;02;569;Saint-Martin-du-Tilleul;240;4;244
28;Normandie;27;3;15;570;Saint-Martin-la-Campagne;99;2;101
28;Normandie;27;2;03;571;Saint-Martin-Saint-Firmin;329;10;339
28;Normandie;27;2;15;572;Saint-Meslin-du-Bosc;284;4;288
28;Normandie;27;2;05;579;Saint-Ouen-de-Pontcheuil;95;2;97
28;Normandie;27;2;04;580;Saint-Ouen-de-Thouberville;2378;29;2407
28;Normandie;27;2;05;582;Saint-Ouen-du-Tilleul;1653;18;1671
28;Normandie;27;2;07;584;Saint-Paul-de-Fourques;294;9;303
28;Normandie;27;2;05;586;Saint-Philbert-sur-Boissey;172;1;173
28;Normandie;27;2;17;587;Saint-Philbert-sur-Risle;787;7;794
28;Normandie;27;1;12;589;Saint-Pierre-de-Bailleul;955;37;992
28;Normandie;27;2;06;590;Saint-Pierre-de-Cernières;225;3;228
28;Normandie;27;2;03;591;Saint-Pierre-de-Cormeilles;609;12;621
28;Normandie;27;2;07;592;Saint-Pierre-de-Salerne;248;3;251
28;Normandie;27;2;05;593;Saint-Pierre-des-Fleurs;1562;21;1583
28;Normandie;27;2;03;594;Saint-Pierre-des-Ifs;277;1;278
28;Normandie;27;2;05;595;Saint-Pierre-du-Bosguérard;1032;13;1045
28;Normandie;27;2;03;597;Saint-Pierre-du-Val;572;1;573
28;Normandie;27;1;14;598;Saint-Pierre-du-Vauvray;1282;26;1308
28;Normandie;27;1;12;599;Saint-Pierre-la-Garenne;912;10;922
28;Normandie;27;2;04;601;Saint-Samson-de-la-Roque;436;4;440
28;Normandie;27;3;09;602;Saint-Sébastien-de-Morsent;5697;170;5867
28;Normandie;27;2;03;603;Saint-Siméon;317;6;323
28;Normandie;27;2;03;604;Saint-Sulpice-de-Grimbouville;167;2;169
28;Normandie;27;2;03;605;Saint-Sylvestre-de-Cormeilles;253;6;259
28;Normandie;27;2;17;606;Saint-Symphorien;488;1;489
28;Normandie;27;2;07;609;Saint-Victor-d'Épine;321;3;324
28;Normandie;27;2;02;608;Saint-Victor-de-Chrétienville;456;9;465
28;Normandie;27;2;22;610;Saint-Victor-sur-Avre;58;4;62
28;Normandie;27;3;10;611;Saint-Vigor;330;4;334
28;Normandie;27;1;16;612;Saint-Vincent-des-Bois;334;6;340
28;Normandie;27;2;03;613;Saint-Vincent-du-Boulay;381;5;386
28;Normandie;27;2;15;524;Sainte-Colombe-la-Commanderie;848;6;854
28;Normandie;27;1;16;525;Sainte-Colombe-près-Vernon;309;19;328
28;Normandie;27;1;23;540;Sainte-Geneviève-lès-Gasny;663;15;678
28;Normandie;27;2;06;578;Sainte-Marie-d'Attez;599;14;613
28;Normandie;27;1;13;567;Sainte-Marie-de-Vatimesnil;269;6;275
28;Normandie;27;3;08;568;Sainte-Marthe;508;8;516
28;Normandie;27;2;07;576;Sainte-Opportune-du-Bosc;648;15;663
28;Normandie;27;2;04;577;Sainte-Opportune-la-Mare;440;11;451
28;Normandie;27;1;13;614;Sancourt;155;4;159
28;Normandie;27;3;11;615;Sassey;192;3;195
28;Normandie;27;1;13;617;Saussay-la-Campagne;531;8;539
28;Normandie;27;2;05;616;La Saussaye;1872;55;1927
28;Normandie;27;3;08;618;Sébécourt;477;10;487
28;Normandie;27;2;17;620;Selles;469;2;471
28;Normandie;27;3;20;621;Serez;154;5;159
28;Normandie;27;2;02;622;Serquigny;1987;47;2034
28;Normandie;27;1;18;623;Surtauville;486;9;495
28;Normandie;27;1;18;624;Surville;904;24;928
28;Normandie;27;1;01;625;Suzay;351;2;353
28;Normandie;27;2;22;693;Sylvains-Lès-Moulins;1295;33;1328
28;Normandie;27;1;18;412;Terres de Bord;1484;35;1519
28;Normandie;27;2;03;627;Le Theil-Nolent;250;12;262
28;Normandie;27;2;85;089;Thénouville;1017;17;1034
28;Normandie;27;2;03;629;Thiberville;1800;15;1815
28;Normandie;27;2;07;630;Thibouville;312;55;367
28;Normandie;27;2;17;631;Thierville;371;4;375
28;Normandie;27;1;13;632;Le Thil;539;8;547
28;Normandie;27;1;13;633;Les Thilliers-en-Vexin;494;6;500
28;Normandie;27;1;01;635;Le Thuit;141;5;146
28;Normandie;27;2;05;638;Le Thuit de l'Oison;3619;51;3670
28;Normandie;27;3;08;640;Tilleul-Dame-Agnès;195;4;199
28;Normandie;27;2;15;641;Le Tilleul-Lambert;251;5;256
28;Normandie;27;2;22;643;Tillières-sur-Avre;1081;22;1103
28;Normandie;27;1;01;644;Tilly;547;42;589
28;Normandie;27;2;04;645;Tocqueville;155;2;157
28;Normandie;27;2;03;646;Le Torpt;443;4;447
28;Normandie;27;1;19;649;Touffreville;351;7;358
28;Normandie;27;2;15;650;Tournedos-Bois-Hubert;476;4;480
28;Normandie;27;3;15;652;Tourneville;319;8;327
28;Normandie;27;2;05;654;Tourville-la-Campagne;1081;11;1092
28;Normandie;27;2;17;655;Tourville-sur-Pont-Audemer;721;169;890
28;Normandie;27;2;17;656;Toutainville;1344;26;1370
28;Normandie;27;2;83;516;Treis-Sants-en-Ouche;1420;33;1453
28;Normandie;27;2;15;658;Le Tremblay-Omonville;342;6;348
28;Normandie;27;3;11;659;La Trinité;116;3;119
28;Normandie;27;2;06;660;La Trinité-de-Réville;239;2;241
28;Normandie;27;2;04;661;La Trinité-de-Thouberville;432;11;443
28;Normandie;27;2;17;662;Triqueville;332;10;342
28;Normandie;27;1;12;676;Les Trois Lacs;1784;34;1818
28;Normandie;27;2;15;663;Le Troncq;173;4;177
28;Normandie;27;1;19;664;Le Tronquay;511;8;519
28;Normandie;27;2;04;665;Trouville-la-Haule;767;13;780
28;Normandie;27;1;18;666;La Vacherie;568;19;587
28;Normandie;27;1;12;022;Le Val d'Hazey;5556;72;5628
28;Normandie;27;1;19;294;Val d'Orger;982;12;994
28;Normandie;27;3;11;668;Le Val-David;723;18;741
28;Normandie;27;1;21;701;Val-de-Reuil;13063;264;13327
28;Normandie;27;3;08;447;Le Val-Doré;921;50;971
28;Normandie;27;2;02;667;Valailles;384;10;394
28;Normandie;27;2;04;669;Valletot;424;5;429
28;Normandie;27;1;19;670;Vandrimare;959;18;977
28;Normandie;27;2;03;671;Vannecrocq;153;6;159
28;Normandie;27;1;19;672;Vascœuil;355;1;356
28;Normandie;27;1;01;673;Vatteville;182;2;184
28;Normandie;27;1;21;528;Le Vaudreuil;3722;84;3806
28;Normandie;27;1;16;674;Vaux-sur-Eure;270;7;277
28;Normandie;27;2;15;677;Venon;395;8;403
28;Normandie;27;3;08;678;Les Ventes;1041;24;1065
28;Normandie;27;2;86;679;Verneuil d'Avre et d'Iton;8170;403;8573
28;Normandie;27;2;06;680;Verneusses;201;4;205
28;Normandie;27;1;23;681;Vernon;23872;658;24530
28;Normandie;27;1;13;682;Vesly;694;23;717
28;Normandie;27;1;01;213;Vexin-sur-Epte;6065;137;6202
28;Normandie;27;1;01;683;Vézillon;251;3;254
28;Normandie;27;3;11;684;Le Vieil-Évreux;812;14;826
28;Normandie;27;2;06;685;La Vieille-Lyre;651;10;661
28;Normandie;27;2;04;686;Vieux-Port;46;0;46
28;Normandie;27;1;16;689;Villegats;350;16;366
28;Normandie;27;1;13;690;Villers-en-Vexin;318;1;319
28;Normandie;27;1;12;691;Villers-sur-le-Roule;853;18;871
28;Normandie;27;2;15;692;Villettes;170;6;176
28;Normandie;27;1;16;694;Villez-sous-Bailleul;312;14;326
28;Normandie;27;2;15;695;Villez-sur-le-Neubourg;284;6;290
28;Normandie;27;1;16;696;Villiers-en-Désœuvre;937;18;955
28;Normandie;27;1;14;697;Vironvay;332;5;337
28;Normandie;27;2;15;698;Vitot;559;14;573
28;Normandie;27;2;05;699;Voiscreville;124;4;128
28;Normandie;27;2;15;700;Vraiville;691;5;696
24;Centre-Val de Loire;28;3;01;001;Abondant;2372;54;2426
24;Centre-Val de Loire;28;3;08;003;Allainville;136;7;143
24;Centre-Val de Loire;28;1;15;004;Allonnes;313;3;316
24;Centre-Val de Loire;28;2;07;005;Alluyes;760;89;849
24;Centre-Val de Loire;28;1;12;006;Amilly;1842;47;1889
24;Centre-Val de Loire;28;3;01;007;Anet;2733;99;2832
24;Centre-Val de Loire;28;4;13;236;Arcisses;2204;59;2263
24;Centre-Val de Loire;28;3;14;008;Ardelles;200;3;203
24;Centre-Val de Loire;28;1;02;009;Ardelu;73;1;74
24;Centre-Val de Loire;28;4;13;010;Argenvilliers;332;10;342
24;Centre-Val de Loire;28;1;02;013;Aunay-sous-Auneau;1483;24;1507
24;Centre-Val de Loire;28;3;08;014;Aunay-sous-Crécy;637;7;644
24;Centre-Val de Loire;28;1;02;015;Auneau-Bleury-Saint-Symphorien;5916;84;6000
24;Centre-Val de Loire;28;4;03;016;Les Autels-Villevillon;156;2;158
24;Centre-Val de Loire;28;4;03;018;Authon-du-Perche;1511;17;1528
24;Centre-Val de Loire;28;2;15;019;Baigneaux;225;5;230
24;Centre-Val de Loire;28;1;02;023;Bailleau-Armenonville;1386;27;1413
24;Centre-Val de Loire;28;1;06;022;Bailleau-l'Évêque;1162;32;1194
24;Centre-Val de Loire;28;1;11;021;Bailleau-le-Pin;1563;30;1593
24;Centre-Val de Loire;28;1;12;024;Barjouville;1712;59;1771
24;Centre-Val de Loire;28;1;15;025;Barmainville;117;2;119
24;Centre-Val de Loire;28;1;15;026;Baudreville;259;0;259
24;Centre-Val de Loire;28;4;03;027;La Bazoche-Gouet;1224;20;1244
24;Centre-Val de Loire;28;2;15;028;Bazoches-en-Dunois;258;5;263
24;Centre-Val de Loire;28;2;15;029;Bazoches-les-Hautes;309;7;316
24;Centre-Val de Loire;28;3;14;030;Beauche;274;9;283
24;Centre-Val de Loire;28;4;03;031;Beaumont-les-Autels;394;111;505
24;Centre-Val de Loire;28;1;15;032;Beauvilliers;335;4;339
24;Centre-Val de Loire;28;4;13;033;Belhomert-Guéhouville;800;32;832
24;Centre-Val de Loire;28;1;05;035;Berchères-les-Pierres;1000;23;1023
24;Centre-Val de Loire;28;1;04;034;Berchères-Saint-Germain;845;11;856
24;Centre-Val de Loire;28;3;01;036;Berchères-sur-Vesgre;849;20;869
24;Centre-Val de Loire;28;3;14;037;Bérou-la-Mulotière;337;5;342
24;Centre-Val de Loire;28;4;03;038;Béthonvilliers;118;5;123
24;Centre-Val de Loire;28;1;02;039;Béville-le-Comte;1657;31;1688
24;Centre-Val de Loire;28;1;11;040;Billancelles;324;8;332
24;Centre-Val de Loire;28;1;11;041;Blandainville;273;3;276
24;Centre-Val de Loire;28;3;08;045;Boissy-en-Drouais;210;6;216
24;Centre-Val de Loire;28;3;14;046;Boissy-lès-Perche;498;12;510
24;Centre-Val de Loire;28;1;15;047;Boisville-la-Saint-Père;712;15;727
24;Centre-Val de Loire;28;1;15;049;Boncé;245;5;250
24;Centre-Val de Loire;28;3;01;050;Boncourt;266;5;271
24;Centre-Val de Loire;28;2;07;051;Bonneval;5055;103;5158
24;Centre-Val de Loire;28;1;10;052;Bouglainval;767;14;781
24;Centre-Val de Loire;28;3;14;053;Le Boullay-les-Deux-Églises;261;4;265
24;Centre-Val de Loire;28;3;09;054;Le Boullay-Mivoye;486;10;496
24;Centre-Val de Loire;28;3;09;055;Le Boullay-Thierry;553;5;558
24;Centre-Val de Loire;28;1;05;048;La Bourdinière-Saint-Loup;725;15;740
24;Centre-Val de Loire;28;3;01;056;Boutigny-Prouais;1745;39;1784
24;Centre-Val de Loire;28;2;15;057;Bouville;588;8;596
24;Centre-Val de Loire;28;3;09;058;Bréchamps;344;5;349
24;Centre-Val de Loire;28;3;14;059;Brezolles;1816;25;1841
24;Centre-Val de Loire;28;1;04;060;Briconville;249;5;254
24;Centre-Val de Loire;28;2;03;061;Brou;3403;37;3440
24;Centre-Val de Loire;28;3;01;062;Broué;888;15;903
24;Centre-Val de Loire;28;3;01;064;Bû;1963;51;2014
24;Centre-Val de Loire;28;2;15;065;Bullainville;108;5;113
24;Centre-Val de Loire;28;1;11;067;Cernay;89;2;91
24;Centre-Val de Loire;28;1;04;068;Challet;433;10;443
24;Centre-Val de Loire;28;1;04;070;Champhol;3656;106;3762
24;Centre-Val de Loire;28;4;13;071;Champrond-en-Gâtine;661;2;663
24;Centre-Val de Loire;28;4;13;072;Champrond-en-Perchet;405;0;405
24;Centre-Val de Loire;28;1;02;073;Champseru;333;1;334
24;Centre-Val de Loire;28;1;02;074;La Chapelle-d'Aunainville;274;13;287
24;Centre-Val de Loire;28;2;07;075;La Chapelle-du-Noyer;1032;181;1213
24;Centre-Val de Loire;28;3;01;076;La Chapelle-Forainvilliers;201;3;204
24;Centre-Val de Loire;28;3;14;077;La Chapelle-Fortin;189;5;194
24;Centre-Val de Loire;28;4;03;078;Chapelle-Guillaume;185;5;190
24;Centre-Val de Loire;28;4;03;079;Chapelle-Royale;307;5;312
24;Centre-Val de Loire;28;4;03;080;Charbonnières;253;3;256
24;Centre-Val de Loire;28;1;11;081;Charonville;315;5;320
24;Centre-Val de Loire;28;3;09;082;Charpont;608;13;621
24;Centre-Val de Loire;28;1;10;084;Chartainvilliers;727;9;736
24;Centre-Val de Loire;28;1;98;085;Chartres;38578;1185;39763
24;Centre-Val de Loire;28;4;13;086;Chassant;329;8;337
24;Centre-Val de Loire;28;3;14;087;Châtaincourt;239;4;243
24;Centre-Val de Loire;28;2;07;088;Châteaudun;13195;324;13519
24;Centre-Val de Loire;28;3;14;089;Châteauneuf-en-Thymerais;2619;30;2649
24;Centre-Val de Loire;28;3;14;090;Les Châtelets;99;4;103
24;Centre-Val de Loire;28;1;11;091;Les Châtelliers-Notre-Dame;137;3;140
24;Centre-Val de Loire;28;1;02;092;Châtenay;238;6;244
24;Centre-Val de Loire;28;3;09;094;Chaudon;1685;25;1710
24;Centre-Val de Loire;28;1;11;095;Chauffours;276;6;282
24;Centre-Val de Loire;28;3;01;096;La Chaussée-d'Ivry;1156;17;1173
24;Centre-Val de Loire;28;3;01;098;Cherisy;1866;27;1893
24;Centre-Val de Loire;28;1;11;099;Chuisnes;1127;19;1146
24;Centre-Val de Loire;28;1;12;100;Cintray;422;6;428
24;Centre-Val de Loire;28;1;04;102;Clévilliers;707;9;716
24;Centre-Val de Loire;28;2;03;103;Cloyes-les-Trois-Rivières;5662;126;5788
24;Centre-Val de Loire;28;1;04;104;Coltainville;884;28;912
24;Centre-Val de Loire;28;4;13;105;Combres;562;6;568
24;Centre-Val de Loire;28;2;03;012;Commune nouvelle d'Arrou;3803;66;3869
24;Centre-Val de Loire;28;2;07;106;Conie-Molitard;406;11;417
24;Centre-Val de Loire;28;1;05;107;Corancez;378;9;387
24;Centre-Val de Loire;28;2;15;108;Cormainville;237;8;245
24;Centre-Val de Loire;28;4;13;109;Les Corvées-les-Yys;316;2;318
24;Centre-Val de Loire;28;1;05;110;Le Coudray;4161;120;4281
24;Centre-Val de Loire;28;4;03;111;Coudray-au-Perche;341;9;350
24;Centre-Val de Loire;28;3;10;113;Coulombs;1353;18;1371
24;Centre-Val de Loire;28;2;15;114;Courbehaye;137;0;137
24;Centre-Val de Loire;28;1;11;116;Courville-sur-Eure;2867;44;2911
24;Centre-Val de Loire;28;3;08;117;Crécy-Couvé;264;9;273
24;Centre-Val de Loire;28;3;09;118;Croisilles;437;14;451
24;Centre-Val de Loire;28;4;13;119;La Croix-du-Perche;163;4;167
24;Centre-Val de Loire;28;3;14;120;Crucey-Villages;468;10;478
24;Centre-Val de Loire;28;2;15;121;Dambron;102;0;102
24;Centre-Val de Loire;28;1;05;122;Dammarie;1512;23;1535
24;Centre-Val de Loire;28;2;03;123;Dampierre-sous-Brou;461;8;469
24;Centre-Val de Loire;28;3;14;124;Dampierre-sur-Avre;742;18;760
24;Centre-Val de Loire;28;2;07;126;Dancy;203;0;203
24;Centre-Val de Loire;28;2;88;127;Dangeau;1274;20;1294
24;Centre-Val de Loire;28;1;11;128;Dangers;432;7;439
24;Centre-Val de Loire;28;1;02;129;Denonville;759;19;778
24;Centre-Val de Loire;28;3;14;130;Digny;979;11;990
24;Centre-Val de Loire;28;2;07;132;Donnemain-Saint-Mamès;684;17;701
24;Centre-Val de Loire;28;3;99;134;Dreux;31044;561;31605
24;Centre-Val de Loire;28;1;10;135;Droue-sur-Drouette;1241;58;1299
24;Centre-Val de Loire;28;3;09;136;Écluzelles;166;5;171
24;Centre-Val de Loire;28;1;02;137;Écrosnes;855;18;873
24;Centre-Val de Loire;28;1;15;406;Éole-en-Beauce;1242;19;1261
24;Centre-Val de Loire;28;1;11;139;Épeautrolles;186;2;188
24;Centre-Val de Loire;28;1;10;140;Épernon;5551;66;5617
24;Centre-Val de Loire;28;1;11;141;Ermenonville-la-Grande;319;11;330
24;Centre-Val de Loire;28;1;11;142;Ermenonville-la-Petite;191;4;195
24;Centre-Val de Loire;28;3;14;143;Escorpain;248;3;251
24;Centre-Val de Loire;28;4;03;144;Les Étilleux;221;7;228
24;Centre-Val de Loire;28;3;10;146;Faverolles;865;11;876
24;Centre-Val de Loire;28;3;14;147;Favières;595;10;605
24;Centre-Val de Loire;28;1;11;148;Le Favril;363;11;374
24;Centre-Val de Loire;28;3;14;149;La Ferté-Vidame;700;19;719
24;Centre-Val de Loire;28;3;14;151;Fessanvilliers-Mattanvilliers;176;5;181
24;Centre-Val de Loire;28;2;07;153;Flacey;209;7;216
24;Centre-Val de Loire;28;1;11;154;Fontaine-la-Guyon;1664;32;1696
24;Centre-Val de Loire;28;3;14;155;Fontaine-les-Ribouts;208;3;211
24;Centre-Val de Loire;28;4;13;156;Fontaine-Simon;924;16;940
24;Centre-Val de Loire;28;2;15;157;Fontenay-sur-Conie;128;3;131
24;Centre-Val de Loire;28;1;12;158;Fontenay-sur-Eure;1016;26;1042
24;Centre-Val de Loire;28;3;14;159;La Framboisière;340;4;344
24;Centre-Val de Loire;28;1;02;160;Francourville;833;8;841
24;Centre-Val de Loire;28;4;03;161;Frazé;505;7;512
24;Centre-Val de Loire;28;1;15;164;Fresnay-l'Évêque;741;10;751
24;Centre-Val de Loire;28;1;05;162;Fresnay-le-Comte;326;9;335
24;Centre-Val de Loire;28;1;04;163;Fresnay-le-Gilmert;202;3;205
24;Centre-Val de Loire;28;4;11;166;Friaize;244;2;246
24;Centre-Val de Loire;28;1;11;167;Fruncé;405;6;411
24;Centre-Val de Loire;28;1;02;168;Gallardon;3669;58;3727
24;Centre-Val de Loire;28;1;02;169;Garancières-en-Beauce;219;7;226
24;Centre-Val de Loire;28;3;08;170;Garancières-en-Drouais;274;6;280
24;Centre-Val de Loire;28;3;08;171;Garnay;876;13;889
24;Centre-Val de Loire;28;1;10;172;Gas;792;16;808
24;Centre-Val de Loire;28;1;04;173;Gasville-Oisème;1448;34;1482
24;Centre-Val de Loire;28;4;13;175;La Gaudaine;175;4;179
24;Centre-Val de Loire;28;2;15;176;Le Gault-Saint-Denis;674;12;686
24;Centre-Val de Loire;28;1;05;177;Gellainville;670;12;682
24;Centre-Val de Loire;28;3;01;178;Germainville;290;6;296
24;Centre-Val de Loire;28;3;01;180;Gilles;522;20;542
24;Centre-Val de Loire;28;2;03;182;Gohory;323;2;325
24;Centre-Val de Loire;28;1;89;183;Gommerville;685;3;688
24;Centre-Val de Loire;28;1;15;184;Gouillons;338;4;342
24;Centre-Val de Loire;28;3;01;185;Goussainville;1292;18;1310
24;Centre-Val de Loire;28;3;01;187;Guainville;655;12;667
24;Centre-Val de Loire;28;1;02;188;Le Gué-de-Longroi;945;16;961
24;Centre-Val de Loire;28;1;15;189;Guilleville;178;4;182
24;Centre-Val de Loire;28;2;15;190;Guillonville;446;12;458
24;Centre-Val de Loire;28;1;10;191;Hanches;2701;57;2758
24;Centre-Val de Loire;28;4;13;192;Happonvilliers;307;4;311
24;Centre-Val de Loire;28;3;01;193;Havelu;142;3;145
24;Centre-Val de Loire;28;1;02;194;Houville-la-Branche;424;16;440
24;Centre-Val de Loire;28;1;10;195;Houx;758;22;780
24;Centre-Val de Loire;28;1;11;196;Illiers-Combray;3324;61;3385
24;Centre-Val de Loire;28;1;15;197;Intréville;145;3;148
24;Centre-Val de Loire;28;2;07;198;Jallans;809;31;840
24;Centre-Val de Loire;28;1;15;199;Janville-en-Beauce;2567;50;2617
24;Centre-Val de Loire;28;3;14;200;Jaudrais;406;5;411
24;Centre-Val de Loire;28;1;04;201;Jouy;1939;41;1980
24;Centre-Val de Loire;28;3;14;202;Lamblore;333;5;338
24;Centre-Val de Loire;28;1;11;203;Landelles;640;6;646
24;Centre-Val de Loire;28;3;14;206;Laons;687;13;700
24;Centre-Val de Loire;28;1;02;207;Léthuin;229;4;233
24;Centre-Val de Loire;28;1;02;208;Levainville;389;14;403
24;Centre-Val de Loire;28;1;06;209;Lèves;5801;133;5934
24;Centre-Val de Loire;28;1;15;210;Levesville-la-Chenard;218;2;220
24;Centre-Val de Loire;28;2;07;211;Logron;585;8;593
24;Centre-Val de Loire;28;2;15;212;Loigny-la-Bataille;206;8;214
24;Centre-Val de Loire;28;3;10;213;Lormaye;661;9;670
24;Centre-Val de Loire;28;4;13;214;La Loupe;3342;83;3425
24;Centre-Val de Loire;28;1;15;215;Louville-la-Chenard;252;5;257
24;Centre-Val de Loire;28;3;08;216;Louvilliers-en-Drouais;201;1;202
24;Centre-Val de Loire;28;3;14;217;Louvilliers-lès-Perche;184;2;186
24;Centre-Val de Loire;28;1;12;218;Lucé;15404;265;15669
24;Centre-Val de Loire;28;4;03;219;Luigny;342;8;350
24;Centre-Val de Loire;28;1;12;220;Luisant;6665;310;6975
24;Centre-Val de Loire;28;2;15;221;Lumeau;149;8;157
24;Centre-Val de Loire;28;1;11;222;Luplanté;386;8;394
24;Centre-Val de Loire;28;3;09;223;Luray;1552;23;1575
24;Centre-Val de Loire;28;1;11;225;Magny;653;12;665
24;Centre-Val de Loire;28;3;14;226;Maillebois;922;16;938
24;Centre-Val de Loire;28;1;10;227;Maintenon;4292;79;4371
24;Centre-Val de Loire;28;1;06;229;Mainvilliers;11182;280;11462
24;Centre-Val de Loire;28;1;02;230;Maisons;374;6;380
24;Centre-Val de Loire;28;3;14;231;La Mancelière;187;3;190
24;Centre-Val de Loire;28;4;13;232;Manou;597;29;626
24;Centre-Val de Loire;28;2;07;233;Marboué;1147;28;1175
24;Centre-Val de Loire;28;1;11;234;Marchéville;479;12;491
24;Centre-Val de Loire;28;3;01;235;Marchezais;342;3;345
24;Centre-Val de Loire;28;4;13;237;Marolles-les-Buis;212;4;216
24;Centre-Val de Loire;28;3;08;239;Marville-Moutiers-Brûlé;976;20;996
24;Centre-Val de Loire;28;4;13;240;Meaucé;543;8;551
24;Centre-Val de Loire;28;1;11;242;Méréglise;100;3;103
24;Centre-Val de Loire;28;1;15;243;Mérouville;218;4;222
24;Centre-Val de Loire;28;1;11;245;Meslay-le-Grenet;345;6;351
24;Centre-Val de Loire;28;2;15;246;Meslay-le-Vidame;522;9;531
24;Centre-Val de Loire;28;3;01;247;Le Mesnil-Simon;580;15;595
24;Centre-Val de Loire;28;3;14;248;Le Mesnil-Thomas;335;9;344
24;Centre-Val de Loire;28;1;10;249;Mévoisins;624;18;642
24;Centre-Val de Loire;28;3;09;251;Mézières-en-Drouais;1073;26;1099
24;Centre-Val de Loire;28;4;03;252;Miermaigne;195;4;199
24;Centre-Val de Loire;28;1;05;253;Mignières;1057;84;1141
24;Centre-Val de Loire;28;1;11;254;Mittainvilliers-Vérigny;794;13;807
24;Centre-Val de Loire;28;1;02;255;Moinville-la-Jeulin;170;0;170
24;Centre-Val de Loire;28;2;07;256;Moléans;461;14;475
24;Centre-Val de Loire;28;1;02;257;Mondonville-Saint-Jean;87;2;89
24;Centre-Val de Loire;28;2;07;259;Montboissier;322;5;327
24;Centre-Val de Loire;28;2;07;260;Montharville;98;5;103
24;Centre-Val de Loire;28;4;03;261;Montigny-le-Chartif;615;12;627
24;Centre-Val de Loire;28;3;14;263;Montigny-sur-Avre;258;6;264
24;Centre-Val de Loire;28;4;13;264;Montireau;140;5;145
24;Centre-Val de Loire;28;4;13;265;Montlandon;241;8;249
24;Centre-Val de Loire;28;3;01;267;Montreuil;508;5;513
24;Centre-Val de Loire;28;1;02;268;Morainville;22;2;24
24;Centre-Val de Loire;28;1;05;269;Morancez;1836;37;1873
24;Centre-Val de Loire;28;2;07;270;Moriers;224;4;228
24;Centre-Val de Loire;28;3;14;271;Morvilliers;152;4;156
24;Centre-Val de Loire;28;2;03;272;Mottereau;166;3;169
24;Centre-Val de Loire;28;4;03;273;Moulhard;142;2;144
24;Centre-Val de Loire;28;1;15;274;Moutiers;249;6;255
24;Centre-Val de Loire;28;3;10;275;Néron;656;15;671
24;Centre-Val de Loire;28;1;15;276;Neuvy-en-Beauce;212;8;220
24;Centre-Val de Loire;28;2;15;277;Neuvy-en-Dunois;310;13;323
24;Centre-Val de Loire;28;1;05;278;Nogent-le-Phaye;1472;34;1506
24;Centre-Val de Loire;28;3;10;279;Nogent-le-Roi;4084;67;4151
24;Centre-Val de Loire;28;4;13;280;Nogent-le-Rotrou;9715;441;10156
24;Centre-Val de Loire;28;1;11;281;Nogent-sur-Eure;497;9;506
24;Centre-Val de Loire;28;4;13;282;Nonvilliers-Grandhoux;427;11;438
24;Centre-Val de Loire;28;2;15;283;Nottonville;304;6;310
24;Centre-Val de Loire;28;1;15;284;Oinville-Saint-Liphard;276;9;285
24;Centre-Val de Loire;28;1;02;285;Oinville-sous-Auneau;345;9;354
24;Centre-Val de Loire;28;1;11;286;Ollé;612;15;627
24;Centre-Val de Loire;28;2;15;287;Orgères-en-Beauce;1061;15;1076
24;Centre-Val de Loire;28;3;09;289;Ormoy;235;5;240
24;Centre-Val de Loire;28;1;11;290;Orrouer;301;10;311
24;Centre-Val de Loire;28;1;15;291;Ouarville;524;16;540
24;Centre-Val de Loire;28;3;09;292;Ouerre;733;15;748
24;Centre-Val de Loire;28;3;01;293;Oulins;1205;27;1232
24;Centre-Val de Loire;28;1;02;294;Oysonville;525;4;529
24;Centre-Val de Loire;28;2;15;296;Péronville;268;4;272
24;Centre-Val de Loire;28;1;10;298;Pierres;2783;56;2839
24;Centre-Val de Loire;28;3;10;299;Les Pinthières;178;6;184
24;Centre-Val de Loire;28;1;15;300;Poinville;142;3;145
24;Centre-Val de Loire;28;1;04;301;Poisvilliers;443;6;449
24;Centre-Val de Loire;28;1;11;302;Pontgouin;1096;334;1430
24;Centre-Val de Loire;28;2;15;303;Poupry;112;1;113
24;Centre-Val de Loire;28;1;15;304;Prasville;431;6;437
24;Centre-Val de Loire;28;2;15;305;Pré-Saint-Évroult;298;5;303
24;Centre-Val de Loire;28;2;15;306;Pré-Saint-Martin;199;6;205
24;Centre-Val de Loire;28;3;14;308;Prudemanche;256;7;263
24;Centre-Val de Loire;28;1;05;309;Prunay-le-Gillon;1075;17;1092
24;Centre-Val de Loire;28;3;14;310;La Puisaye;278;6;284
24;Centre-Val de Loire;28;3;14;312;Puiseux;136;2;138
24;Centre-Val de Loire;28;1;15;313;Réclainville;190;1;191
24;Centre-Val de Loire;28;3;14;314;Les Ressuintes;122;8;130
24;Centre-Val de Loire;28;3;14;315;Revercourt;23;1;24
24;Centre-Val de Loire;28;3;14;316;Rohaire;127;3;130
24;Centre-Val de Loire;28;1;02;317;Roinville;561;3;564
24;Centre-Val de Loire;28;1;15;319;Rouvray-Saint-Denis;434;6;440
24;Centre-Val de Loire;28;3;01;321;Rouvres;823;14;837
24;Centre-Val de Loire;28;3;14;322;Rueil-la-Gadelière;507;10;517
24;Centre-Val de Loire;28;3;14;323;Saint-Ange-et-Torçay;287;1;288
24;Centre-Val de Loire;28;1;11;324;Saint-Arnoult-des-Bois;888;23;911
24;Centre-Val de Loire;28;1;06;325;Saint-Aubin-des-Bois;1016;25;1041
24;Centre-Val de Loire;28;2;11;326;Saint-Avit-les-Guespières;362;4;366
24;Centre-Val de Loire;28;4;03;327;Saint-Bomer;196;2;198
24;Centre-Val de Loire;28;2;07;329;Saint-Christophe;159;2;161
24;Centre-Val de Loire;28;1;11;333;Saint-Denis-des-Puits;139;2;141
24;Centre-Val de Loire;28;2;07;334;Saint-Denis-Lanneray;2243;55;2298
24;Centre-Val de Loire;28;4;13;335;Saint-Éliph;875;24;899
24;Centre-Val de Loire;28;1;11;336;Saint-Éman;108;1;109
24;Centre-Val de Loire;28;1;11;337;Saint-Georges-sur-Eure;2803;67;2870
24;Centre-Val de Loire;28;1;11;339;Saint-Germain-le-Gaillard;345;11;356
24;Centre-Val de Loire;28;3;14;341;Saint-Jean-de-Rebervilliers;241;5;246
24;Centre-Val de Loire;28;4;13;342;Saint-Jean-Pierre-Fixte;259;9;268
24;Centre-Val de Loire;28;3;10;343;Saint-Laurent-la-Gâtine;441;12;453
24;Centre-Val de Loire;28;1;02;344;Saint-Léger-des-Aubées;266;10;276
24;Centre-Val de Loire;28;3;14;346;Saint-Lubin-de-Cravant;58;3;61
24;Centre-Val de Loire;28;3;01;347;Saint-Lubin-de-la-Haye;956;30;986
24;Centre-Val de Loire;28;3;14;348;Saint-Lubin-des-Joncherets;3995;55;4050
24;Centre-Val de Loire;28;3;10;349;Saint-Lucien;254;2;256
24;Centre-Val de Loire;28;1;11;350;Saint-Luperce;896;20;916
24;Centre-Val de Loire;28;3;14;351;Saint-Maixme-Hauterive;418;8;426
24;Centre-Val de Loire;28;1;10;352;Saint-Martin-de-Nigelles;1560;42;1602
24;Centre-Val de Loire;28;2;07;353;Saint-Maur-sur-le-Loir;413;5;418
24;Centre-Val de Loire;28;4;13;354;Saint-Maurice-Saint-Germain;415;73;488
24;Centre-Val de Loire;28;3;01;355;Saint-Ouen-Marchefroy;295;8;303
24;Centre-Val de Loire;28;1;10;357;Saint-Piat;1050;30;1080
24;Centre-Val de Loire;28;1;04;358;Saint-Prest;2031;73;2104
24;Centre-Val de Loire;28;3;14;359;Saint-Rémy-sur-Avre;4010;42;4052
24;Centre-Val de Loire;28;3;14;360;Saint-Sauveur-Marville;925;17;942
24;Centre-Val de Loire;28;4;13;362;Saint-Victor-de-Buthon;511;13;524
24;Centre-Val de Loire;28;3;09;332;Sainte-Gemme-Moronval;1093;22;1115
24;Centre-Val de Loire;28;4;13;331;Saintigny;1020;20;1040
24;Centre-Val de Loire;28;1;02;363;Sainville;1012;13;1025
24;Centre-Val de Loire;28;2;15;364;Sancheville;806;13;819
24;Centre-Val de Loire;28;1;11;365;Sandarville;408;9;417
24;Centre-Val de Loire;28;1;02;366;Santeuil;320;1;321
24;Centre-Val de Loire;28;1;15;367;Santilly;339;6;345
24;Centre-Val de Loire;28;3;14;368;La Saucelle;194;3;197
24;Centre-Val de Loire;28;3;08;369;Saulnières;709;9;718
24;Centre-Val de Loire;28;2;07;370;Saumeray;491;11;502
24;Centre-Val de Loire;28;3;01;371;Saussay;1092;19;1111
24;Centre-Val de Loire;28;3;10;372;Senantes;582;12;594
24;Centre-Val de Loire;28;3;14;373;Senonches;3087;45;3132
24;Centre-Val de Loire;28;3;14;374;Serazereux;546;2;548
24;Centre-Val de Loire;28;3;01;375;Serville;366;5;371
24;Centre-Val de Loire;28;3;01;377;Sorel-Moussel;1804;35;1839
24;Centre-Val de Loire;28;4;13;378;Souancé-au-Perche;532;11;543
24;Centre-Val de Loire;28;1;10;379;Soulaires;454;10;464
24;Centre-Val de Loire;28;1;05;380;Sours;1951;170;2121
24;Centre-Val de Loire;28;2;15;382;Terminiers;903;15;918
24;Centre-Val de Loire;28;1;15;383;Theuville;708;6;714
24;Centre-Val de Loire;28;4;11;385;Le Thieulin;452;34;486
24;Centre-Val de Loire;28;3;14;386;Thimert-Gâtelles;1256;22;1278
24;Centre-Val de Loire;28;4;13;387;Thiron-Gardais;995;11;1006
24;Centre-Val de Loire;28;1;05;388;Thivars;1059;33;1092
24;Centre-Val de Loire;28;2;07;389;Thiville;342;4;346
24;Centre-Val de Loire;28;2;15;390;Tillay-le-Péneux;324;6;330
24;Centre-Val de Loire;28;1;15;391;Toury;2573;33;2606
24;Centre-Val de Loire;28;1;15;392;Trancrainville;161;3;164
24;Centre-Val de Loire;28;3;14;393;Tremblay-les-Villages;2271;65;2336
24;Centre-Val de Loire;28;3;08;394;Tréon;1403;27;1430
24;Centre-Val de Loire;28;4;13;395;Trizay-Coutretot-Saint-Serge;444;14;458
24;Centre-Val de Loire;28;2;07;396;Trizay-lès-Bonneval;316;4;320
24;Centre-Val de Loire;28;1;02;397;Umpeau;396;12;408
24;Centre-Val de Loire;28;2;03;398;Unverre;1193;24;1217
24;Centre-Val de Loire;28;2;15;400;Varize;196;8;204
24;Centre-Val de Loire;28;4;13;401;Vaupillon;456;7;463
24;Centre-Val de Loire;28;1;05;403;Ver-lès-Chartres;783;27;810
24;Centre-Val de Loire;28;3;08;404;Vernouillet;12506;148;12654
24;Centre-Val de Loire;28;3;08;405;Vert-en-Drouais;1091;21;1112
24;Centre-Val de Loire;28;4;13;407;Vichères;304;8;312
24;Centre-Val de Loire;28;1;02;408;Vierville;132;1;133
24;Centre-Val de Loire;28;2;11;409;Vieuvicq;476;9;485
24;Centre-Val de Loire;28;1;15;422;Les Villages Vovéens;3945;61;4006
24;Centre-Val de Loire;28;2;07;410;Villampuy;306;4;310
24;Centre-Val de Loire;28;1;15;411;Villars;175;1;176
24;Centre-Val de Loire;28;1;11;414;Villebon;76;0;76
24;Centre-Val de Loire;28;2;07;330;Villemaury;1392;34;1426
24;Centre-Val de Loire;28;3;09;415;Villemeux-sur-Eure;1641;27;1668
24;Centre-Val de Loire;28;3;10;417;Villiers-le-Morhier;1339;28;1367
24;Centre-Val de Loire;28;2;07;418;Villiers-Saint-Orien;163;5;168
24;Centre-Val de Loire;28;2;15;419;Vitray-en-Beauce;357;6;363
24;Centre-Val de Loire;28;1;02;421;Voise;282;5;287
24;Centre-Val de Loire;28;1;02;423;Yermenonville;597;7;604
24;Centre-Val de Loire;28;2;03;424;Yèvres;1647;34;1681
24;Centre-Val de Loire;28;1;02;425;Ymeray;612;12;624
24;Centre-Val de Loire;28;1;15;426;Ymonville;498;9;507
53;Bretagne;29;2;09;001;Argol;991;17;1008
53;Bretagne;29;4;25;002;Arzano;1387;33;1420
53;Bretagne;29;4;10;003;Audierne;3692;65;3757
53;Bretagne;29;4;16;004;Bannalec;5659;158;5817
53;Bretagne;29;4;25;005;Baye;1149;34;1183
53;Bretagne;29;4;11;006;Bénodet;3568;65;3633
53;Bretagne;29;2;07;007;Berrien;919;31;950
53;Bretagne;29;4;10;008;Beuzec-Cap-Sizun;1001;20;1021
53;Bretagne;29;3;14;010;Bodilis;1609;35;1644
53;Bretagne;29;1;04;011;Bohars;3458;83;3541
53;Bretagne;29;2;07;012;Bolazec;205;1;206
53;Bretagne;29;2;07;013;Botmeur;215;6;221
53;Bretagne;29;3;20;014;Botsorhel;428;6;434
53;Bretagne;29;1;18;015;Bourg-Blanc;3568;53;3621
53;Bretagne;29;2;07;016;Brasparts;1024;11;1035
53;Bretagne;29;1;27;017;Brélès;875;27;902
53;Bretagne;29;2;07;018;Brennilis;444;5;449
53;Bretagne;29;1;98;019;Brest;140064;2684;142748
53;Bretagne;29;4;06;020;Briec;5630;112;5742
53;Bretagne;29;2;09;022;Camaret-sur-Mer;2543;57;2600
53;Bretagne;29;3;17;023;Carantec;3161;100;3261
53;Bretagne;29;2;07;024;Carhaix-Plouguer;7174;615;7789
53;Bretagne;29;2;09;025;Cast;1556;45;1601
53;Bretagne;29;2;09;026;Châteaulin;5214;456;5670
53;Bretagne;29;2;06;027;Châteauneuf-du-Faou;3673;102;3775
53;Bretagne;29;4;10;028;Cléden-Cap-Sizun;944;20;964
53;Bretagne;29;2;07;029;Cléden-Poher;1158;21;1179
53;Bretagne;29;3;26;030;Cléder;3779;105;3884
53;Bretagne;29;4;25;031;Clohars-Carnoët;4333;111;4444
53;Bretagne;29;4;11;032;Clohars-Fouesnant;2055;51;2106
53;Bretagne;29;2;06;033;Le Cloître-Pleyben;531;11;542
53;Bretagne;29;3;20;034;Le Cloître-Saint-Thégonnec;660;6;666
53;Bretagne;29;1;18;035;Coat-Méal;1100;19;1119
53;Bretagne;29;2;07;036;Collorec;611;7;618
53;Bretagne;29;4;19;037;Combrit;4092;133;4225
53;Bretagne;29;3;14;038;Commana;1036;27;1063
53;Bretagne;29;4;08;039;Concarneau;19050;825;19875
53;Bretagne;29;4;10;145;Confort-Meilars;879;28;907
53;Bretagne;29;1;27;040;Le Conquet;2713;59;2772
53;Bretagne;29;2;06;041;Coray;1896;30;1926
53;Bretagne;29;2;09;042;Crozon;7477;220;7697
53;Bretagne;29;1;21;043;Daoulas;1786;52;1838
53;Bretagne;29;2;09;044;Dinéault;2168;38;2206
53;Bretagne;29;1;21;045;Dirinon;2261;73;2334
53;Bretagne;29;4;10;046;Douarnenez;13902;363;14265
53;Bretagne;29;1;15;047;Le Drennec;1837;34;1871
53;Bretagne;29;4;06;048;Edern;2224;42;2266
53;Bretagne;29;4;08;049;Elliant;3271;141;3412
53;Bretagne;29;4;11;051;Ergué-Gabéric;8208;211;8419
53;Bretagne;29;2;21;053;Le Faou;1727;41;1768
53;Bretagne;29;2;07;054;La Feuillée;641;14;655
53;Bretagne;29;1;15;055;Le Folgoët;3187;77;3264
53;Bretagne;29;1;13;056;La Forest-Landerneau;1881;29;1910
53;Bretagne;29;4;11;057;La Forêt-Fouesnant;3366;119;3485
53;Bretagne;29;4;11;058;Fouesnant;9458;429;9887
53;Bretagne;29;3;20;059;Garlan;1052;33;1085
53;Bretagne;29;4;11;060;Gouesnach;2769;80;2849
53;Bretagne;29;1;04;061;Gouesnou;6116;130;6246
53;Bretagne;29;2;06;062;Gouézec;1100;34;1134
53;Bretagne;29;4;10;063;Goulien;433;7;440
53;Bretagne;29;1;15;064;Goulven;446;4;450
53;Bretagne;29;4;19;065;Gourlizon;896;16;912
53;Bretagne;29;4;23;066;Guengat;1782;29;1811
53;Bretagne;29;3;20;067;Guerlesquin;1329;41;1370
53;Bretagne;29;3;14;068;Guiclan;2490;52;2542
53;Bretagne;29;4;19;070;Guiler-sur-Goyen;529;10;539
53;Bretagne;29;1;04;069;Guilers;7981;155;8136
53;Bretagne;29;4;25;071;Guilligomarc'h;778;3;781
53;Bretagne;29;4;22;072;Guilvinec;2658;68;2726
53;Bretagne;29;3;20;073;Guimaëc;947;34;981
53;Bretagne;29;3;14;074;Guimiliau;1009;17;1026
53;Bretagne;29;1;12;075;Guipavas;14482;375;14857
53;Bretagne;29;1;15;077;Guissény;2009;42;2051
53;Bretagne;29;1;21;078;Hanvec;2025;46;2071
53;Bretagne;29;3;17;079;Henvic;1351;30;1381
53;Bretagne;29;1;21;080;Hôpital-Camfrout;2247;38;2285
53;Bretagne;29;2;07;081;Huelgoat;1449;28;1477
53;Bretagne;29;3;26;082;Île-de-Batz;457;18;475
53;Bretagne;29;4;10;083;Île-de-Sein;249;2;251
53;Bretagne;29;1;27;084;Île-Molène;141;5;146
53;Bretagne;29;4;19;085;Île-Tudy;741;17;758
53;Bretagne;29;1;21;086;Irvillac;1429;22;1451
53;Bretagne;29;4;10;087;Le Juch;713;17;730
53;Bretagne;29;2;07;089;Kergloff;880;23;903
53;Bretagne;29;4;10;090;Kerlaz;799;27;826
53;Bretagne;29;1;15;091;Kerlouan;2119;39;2158
53;Bretagne;29;1;15;093;Kernilis;1453;31;1484
53;Bretagne;29;1;15;094;Kernouës;685;14;699
53;Bretagne;29;1;18;095;Kersaint-Plabennec;1447;26;1473
53;Bretagne;29;3;14;097;Lampaul-Guimiliau;2058;51;2109
53;Bretagne;29;1;27;098;Lampaul-Plouarzel;2111;50;2161
53;Bretagne;29;1;18;099;Lampaul-Ploudalmézeau;838;22;860
53;Bretagne;29;1;15;100;Lanarvily;421;12;433
53;Bretagne;29;1;18;101;Landéda;3578;109;3687
53;Bretagne;29;2;07;102;Landeleau;937;12;949
53;Bretagne;29;1;13;103;Landerneau;15781;617;16398
53;Bretagne;29;2;09;104;Landévennec;337;6;343
53;Bretagne;29;3;14;105;Landivisiau;9132;322;9454
53;Bretagne;29;4;06;106;Landrévarzec;1841;39;1880
53;Bretagne;29;4;06;107;Landudal;877;13;890
53;Bretagne;29;4;19;108;Landudec;1436;39;1475
53;Bretagne;29;1;18;109;Landunvez;1475;36;1511
53;Bretagne;29;4;06;110;Langolen;876;18;894
53;Bretagne;29;3;26;111;Lanhouarneau;1308;24;1332
53;Bretagne;29;1;27;112;Lanildut;956;17;973
53;Bretagne;29;3;20;113;Lanmeur;2251;39;2290
53;Bretagne;29;3;20;114;Lannéanou;378;8;386
53;Bretagne;29;2;06;115;Lannédern;293;5;298
53;Bretagne;29;1;13;116;Lanneuffret;151;2;153
53;Bretagne;29;1;18;117;Lannilis;5592;114;5706
53;Bretagne;29;1;27;119;Lanrivoaré;1464;35;1499
53;Bretagne;29;2;09;120;Lanvéoc;2095;66;2161
53;Bretagne;29;2;06;122;Laz;661;15;676
53;Bretagne;29;2;06;123;Lennon;788;20;808
53;Bretagne;29;1;15;124;Lesneven;7311;228;7539
53;Bretagne;29;2;06;125;Leuhan;819;14;833
53;Bretagne;29;1;15;126;Loc-Brévalaire;202;6;208
53;Bretagne;29;3;14;128;Loc-Eguiner;402;7;409
53;Bretagne;29;1;27;130;Locmaria-Plouzané;5076;129;5205
53;Bretagne;29;3;14;131;Locmélar;471;14;485
53;Bretagne;29;3;17;132;Locquénolé;787;26;813
53;Bretagne;29;3;20;133;Locquirec;1456;42;1498
53;Bretagne;29;4;23;134;Locronan;795;27;822
53;Bretagne;29;4;22;135;Loctudy;4073;110;4183
53;Bretagne;29;4;25;136;Locunolé;1154;23;1177
53;Bretagne;29;1;21;137;Logonna-Daoulas;2124;52;2176
53;Bretagne;29;2;07;139;Lopérec;859;154;1013
53;Bretagne;29;1;21;140;Loperhet;3760;82;3842
53;Bretagne;29;2;07;141;Loqueffret;359;10;369
53;Bretagne;29;2;06;142;Lothey;459;4;463
53;Bretagne;29;4;10;143;Mahalon;957;20;977
53;Bretagne;29;1;21;144;La Martyre;751;9;760
53;Bretagne;29;4;08;146;Melgven;3356;51;3407
53;Bretagne;29;4;25;147;Mellac;3112;76;3188
53;Bretagne;29;3;26;148;Mespaul;966;17;983
53;Bretagne;29;1;27;076;Milizac-Guipronvel;4478;64;4542
53;Bretagne;29;4;16;150;Moëlan-sur-Mer;6781;140;6921
53;Bretagne;29;3;17;151;Morlaix;14559;469;15028
53;Bretagne;29;2;07;152;Motreff;703;14;717
53;Bretagne;29;4;16;153;Névez;2661;59;2720
53;Bretagne;29;1;27;155;Ouessant;835;19;854
53;Bretagne;29;1;13;156;Pencran;1970;31;2001
53;Bretagne;29;4;22;158;Penmarch;5247;114;5361
53;Bretagne;29;4;19;159;Peumerit;803;12;815
53;Bretagne;29;1;18;160;Plabennec;8436;160;8596
53;Bretagne;29;4;11;161;Pleuven;2987;79;3066
53;Bretagne;29;2;06;162;Pleyben;3627;263;3890
53;Bretagne;29;3;17;163;Pleyber-Christ;3139;77;3216
53;Bretagne;29;4;22;165;Plobannalec-Lesconil;3474;87;3561
53;Bretagne;29;2;09;166;Ploéven;518;17;535
53;Bretagne;29;4;19;167;Plogastel-Saint-Germain;1953;43;1996
53;Bretagne;29;4;10;168;Plogoff;1229;20;1249
53;Bretagne;29;4;23;169;Plogonnec;3156;74;3230
53;Bretagne;29;4;23;170;Plomelin;4171;167;4338
53;Bretagne;29;4;19;171;Plomeur;3774;81;3855
53;Bretagne;29;2;09;172;Plomodiern;2136;63;2199
53;Bretagne;29;4;23;173;Plonéis;2425;49;2474
53;Bretagne;29;4;19;174;Plonéour-Lanvern;6064;156;6220
53;Bretagne;29;2;07;175;Plonévez-du-Faou;2105;50;2155
53;Bretagne;29;2;09;176;Plonévez-Porzay;1758;44;1802
53;Bretagne;29;1;27;177;Plouarzel;3715;70;3785
53;Bretagne;29;1;18;178;Ploudalmézeau;6297;129;6426
53;Bretagne;29;1;15;179;Ploudaniel;3709;112;3821
53;Bretagne;29;1;21;180;Ploudiry;952;22;974
53;Bretagne;29;1;13;181;Plouédern;2813;67;2880
53;Bretagne;29;3;20;182;Plouégat-Guérand;1067;23;1090
53;Bretagne;29;3;20;183;Plouégat-Moysan;716;9;725
53;Bretagne;29;3;26;184;Plouénan;2510;59;2569
53;Bretagne;29;3;26;185;Plouescat;3446;82;3528
53;Bretagne;29;3;20;186;Plouezoc'h;1596;62;1658
53;Bretagne;29;3;14;187;Plougar;785;31;816
53;Bretagne;29;3;20;188;Plougasnou;2776;122;2898
53;Bretagne;29;1;12;189;Plougastel-Daoulas;13337;361;13698
53;Bretagne;29;1;27;190;Plougonvelin;4174;99;4273
53;Bretagne;29;3;20;191;Plougonven;3496;61;3557
53;Bretagne;29;3;26;192;Plougoulm;1759;45;1804
53;Bretagne;29;3;14;193;Plougourvest;1404;28;1432
53;Bretagne;29;1;15;195;Plouguerneau;6607;128;6735
53;Bretagne;29;1;18;196;Plouguin;2151;41;2192
53;Bretagne;29;4;10;197;Plouhinec;3975;118;4093
53;Bretagne;29;1;15;198;Plouider;1866;34;1900
53;Bretagne;29;3;20;199;Plouigneau;5083;182;5265
53;Bretagne;29;1;27;201;Ploumoguer;2063;37;2100
53;Bretagne;29;1;15;021;Plounéour-Brignogan-plages;1922;49;1971
53;Bretagne;29;3;17;202;Plounéour-Ménez;1246;39;1285
53;Bretagne;29;3;14;204;Plounéventer;2088;33;2121
53;Bretagne;29;3;26;206;Plounévez-Lochrist;2291;93;2384
53;Bretagne;29;2;07;205;Plounévézel;1227;26;1253
53;Bretagne;29;1;27;208;Plourin;1241;28;1269
53;Bretagne;29;3;20;207;Plourin-lès-Morlaix;4457;287;4744
53;Bretagne;29;1;18;209;Plouvien;3766;99;3865
53;Bretagne;29;3;14;210;Plouvorn;2870;73;2943
53;Bretagne;29;2;07;211;Plouyé;674;18;692
53;Bretagne;29;1;03;212;Plouzané;12822;269;13091
53;Bretagne;29;3;14;213;Plouzévédé;1766;40;1806
53;Bretagne;29;4;19;214;Plovan;682;27;709
53;Bretagne;29;4;19;215;Plozévet;2967;77;3044
53;Bretagne;29;4;23;216;Pluguffan;4109;99;4208
53;Bretagne;29;4;16;217;Pont-Aven;2801;58;2859
53;Bretagne;29;4;10;218;Pont-Croix;1580;30;1610
53;Bretagne;29;2;21;302;Pont-de-Buis-lès-Quimerch;3792;150;3942
53;Bretagne;29;4;22;220;Pont-l'Abbé;8250;399;8649
53;Bretagne;29;1;27;221;Porspoder;1810;38;1848
53;Bretagne;29;2;09;222;Port-Launay;391;7;398
53;Bretagne;29;4;10;224;Pouldergat;1211;25;1236
53;Bretagne;29;4;19;225;Pouldreuzic;2156;46;2202
53;Bretagne;29;4;10;226;Poullan-sur-Mer;1516;94;1610
53;Bretagne;29;2;07;227;Poullaouen;1500;32;1532
53;Bretagne;29;4;10;228;Primelin;702;17;719
53;Bretagne;29;4;09;229;Quéménéven;1117;34;1151
53;Bretagne;29;4;25;230;Querrien;1739;33;1772
53;Bretagne;29;4;99;232;Quimper;62985;2495;65480
53;Bretagne;29;4;25;233;Quimperlé;12057;453;12510
53;Bretagne;29;4;25;234;Rédené;2908;64;2972
53;Bretagne;29;1;12;235;Le Relecq-Kerhuon;11462;243;11705
53;Bretagne;29;4;16;236;Riec-sur-Bélon;4185;122;4307
53;Bretagne;29;1;13;237;La Roche-Maurice;1807;43;1850
53;Bretagne;29;2;09;238;Roscanvel;839;29;868
53;Bretagne;29;3;26;239;Roscoff;3404;84;3488
53;Bretagne;29;2;21;240;Rosnoën;955;26;981
53;Bretagne;29;4;08;241;Rosporden;7671;120;7791
53;Bretagne;29;2;09;243;Saint-Coulitz;437;10;447
53;Bretagne;29;3;14;244;Saint-Derrien;811;13;824
53;Bretagne;29;1;13;245;Saint-Divy;1537;21;1558
53;Bretagne;29;1;21;246;Saint-Eloy;214;5;219
53;Bretagne;29;4;11;247;Saint-Évarzec;3529;114;3643
53;Bretagne;29;1;15;248;Saint-Frégant;823;8;831
53;Bretagne;29;2;06;249;Saint-Goazec;706;9;715
53;Bretagne;29;2;07;250;Saint-Hernin;759;17;776
53;Bretagne;29;3;20;251;Saint-Jean-du-Doigt;641;12;653
53;Bretagne;29;4;19;252;Saint-Jean-Trolimon;962;27;989
53;Bretagne;29;3;17;254;Saint-Martin-des-Champs;4593;145;4738
53;Bretagne;29;1;15;255;Saint-Méen;917;19;936
53;Bretagne;29;2;09;256;Saint-Nic;773;21;794
53;Bretagne;29;1;18;257;Saint-Pabu;2074;34;2108
53;Bretagne;29;3;26;259;Saint-Pol-de-Léon;6596;234;6830
53;Bretagne;29;1;27;260;Saint-Renan;8110;189;8299
53;Bretagne;29;2;07;261;Saint-Rivoal;194;3;197
53;Bretagne;29;3;14;262;Saint-Sauveur;790;10;800
53;Bretagne;29;2;21;263;Saint-Ségal;1081;24;1105
53;Bretagne;29;3;14;264;Saint-Servais;782;12;794
53;Bretagne;29;3;17;266;Saint-Thégonnec Loc-Eguiner;3010;76;3086
53;Bretagne;29;2;06;267;Saint-Thois;716;18;734
53;Bretagne;29;1;13;268;Saint-Thonan;1821;35;1856
53;Bretagne;29;4;25;269;Saint-Thurien;1032;14;1046
53;Bretagne;29;1;21;270;Saint-Urbain;1633;35;1668
53;Bretagne;29;3;14;271;Saint-Vougay;904;18;922
53;Bretagne;29;4;08;272;Saint-Yvi;3155;68;3223
53;Bretagne;29;3;17;265;Sainte-Sève;1016;30;1046
53;Bretagne;29;3;26;273;Santec;2409;62;2471
53;Bretagne;29;4;16;274;Scaër;5380;122;5502
53;Bretagne;29;2;07;275;Scrignac;757;20;777
53;Bretagne;29;3;26;276;Sibiril;1208;27;1235
53;Bretagne;29;3;14;277;Sizun;2265;78;2343
53;Bretagne;29;2;07;278;Spézet;1808;44;1852
53;Bretagne;29;3;17;279;Taulé;2938;77;3015
53;Bretagne;29;2;09;280;Telgruc-sur-Mer;2085;59;2144
53;Bretagne;29;4;08;281;Tourch;1026;28;1054
53;Bretagne;29;1;27;282;Trébabu;352;9;361
53;Bretagne;29;4;22;284;Treffiagat;2399;100;2499
53;Bretagne;29;3;26;285;Tréflaouénan;510;7;517
53;Bretagne;29;1;21;286;Tréflévénez;243;9;252
53;Bretagne;29;3;26;287;Tréflez;958;22;980
53;Bretagne;29;1;15;288;Trégarantec;601;8;609
53;Bretagne;29;2;09;289;Trégarvan;119;6;125
53;Bretagne;29;1;18;290;Tréglonou;670;6;676
53;Bretagne;29;2;06;291;Trégourez;972;17;989
53;Bretagne;29;4;19;292;Tréguennec;318;7;325
53;Bretagne;29;4;16;293;Trégunc;7041;225;7266
53;Bretagne;29;1;21;294;Le Tréhou;633;14;647
53;Bretagne;29;1;13;295;Trémaouézan;575;9;584
53;Bretagne;29;4;19;296;Tréméoc;1346;39;1385
53;Bretagne;29;4;25;297;Tréméven;2324;43;2367
53;Bretagne;29;4;19;298;Tréogat;581;12;593
53;Bretagne;29;1;27;299;Tréouergat;341;5;346
53;Bretagne;29;4;16;300;Le Trévoux;1606;51;1657
53;Bretagne;29;3;14;301;Trézilidé;382;2;384
76;Occitanie;30;2;20;001;Aigaliers;507;13;520
76;Occitanie;30;3;15;002;Aigremont;791;13;804
76;Occitanie;30;2;01;003;Aigues-Mortes;8325;76;8401
76;Occitanie;30;2;21;004;Aigues-Vives;3337;48;3385
76;Occitanie;30;2;14;005;Aiguèze;214;3;217
76;Occitanie;30;2;01;006;Aimargues;5647;53;5700
76;Occitanie;30;1;98;007;Alès;40219;651;40870
76;Occitanie;30;1;18;008;Allègre-les-Fumades;902;16;918
76;Occitanie;30;3;22;009;Alzon;177;3;180
76;Occitanie;30;1;02;010;Anduze;3436;41;3477
76;Occitanie;30;2;23;011;Les Angles;8349;202;8551
76;Occitanie;30;2;06;012;Aramon;4238;73;4311
76;Occitanie;30;2;16;013;Argilliers;483;22;505
76;Occitanie;30;2;20;014;Arpaillargues-et-Aureillac;1009;28;1037
76;Occitanie;30;3;22;015;Arphy;171;4;175
76;Occitanie;30;3;22;016;Arre;287;10;297
76;Occitanie;30;3;22;017;Arrigas;211;2;213
76;Occitanie;30;2;07;018;Aspères;512;13;525
76;Occitanie;30;2;01;019;Aubais;2762;58;2820
76;Occitanie;30;2;21;020;Aubord;2375;44;2419
76;Occitanie;30;2;20;021;Aubussargues;323;4;327
76;Occitanie;30;1;08;022;Aujac;178;7;185
76;Occitanie;30;2;07;023;Aujargues;846;17;863
76;Occitanie;30;3;22;024;Aulas;477;7;484
76;Occitanie;30;3;22;025;Aumessas;228;3;231
76;Occitanie;30;3;22;026;Avèze;1080;32;1112
76;Occitanie;30;1;02;027;Bagard;2574;65;2639
76;Occitanie;30;2;05;028;Bagnols-sur-Cèze;18258;342;18600
76;Occitanie;30;1;18;029;Barjac;1596;24;1620
76;Occitanie;30;2;20;030;Baron;356;4;360
76;Occitanie;30;2;20;031;La Bastide-d'Engras;196;2;198
76;Occitanie;30;2;06;032;Beaucaire;15963;144;16107
76;Occitanie;30;2;21;033;Beauvoisin;4780;54;4834
76;Occitanie;30;2;06;034;Bellegarde;7129;81;7210
76;Occitanie;30;2;03;035;Belvézet;245;1;246
76;Occitanie;30;2;21;036;Bernis;3420;27;3447
76;Occitanie;30;1;18;037;Bessèges;2844;35;2879
76;Occitanie;30;3;22;038;Bez-et-Esparon;336;11;347
76;Occitanie;30;2;16;039;Bezouce;2299;32;2331
76;Occitanie;30;3;22;040;Blandas;135;2;137
76;Occitanie;30;2;20;041;Blauzac;1196;20;1216
76;Occitanie;30;1;02;042;Boisset-et-Gaujac;2545;45;2590
76;Occitanie;30;2;07;043;Boissières;565;11;576
76;Occitanie;30;1;08;044;Bonnevaux;88;0;88
76;Occitanie;30;1;18;045;Bordezac;393;4;397
76;Occitanie;30;1;15;046;Boucoiran-et-Nozières;947;14;961
76;Occitanie;30;2;09;047;Bouillargues;6328;131;6459
76;Occitanie;30;1;03;048;Bouquet;176;3;179
76;Occitanie;30;2;20;049;Bourdic;380;11;391
76;Occitanie;30;3;15;050;Bragassargues;175;5;180
76;Occitanie;30;1;08;051;Branoux-les-Taillades;1340;30;1370
76;Occitanie;30;3;22;052;Bréau-Mars;616;20;636
76;Occitanie;30;1;15;053;Brignon;771;12;783
76;Occitanie;30;1;03;055;Brouzet-lès-Alès;649;12;661
76;Occitanie;30;3;15;054;Brouzet-lès-Quissac;291;4;295
76;Occitanie;30;2;20;056;La Bruguière;328;7;335
76;Occitanie;30;2;16;057;Cabrières;1623;28;1651
76;Occitanie;30;3;22;058;La Cadière-et-Cambo;210;10;220
76;Occitanie;30;2;01;059;Le Cailar;2412;29;2441
76;Occitanie;30;2;09;060;Caissargues;4027;78;4105
76;Occitanie;30;2;20;061;La Calmette;2200;23;2223
76;Occitanie;30;2;07;062;Calvisson;5745;97;5842
76;Occitanie;30;3;22;064;Campestre-et-Luc;99;1;100
76;Occitanie;30;3;15;065;Canaules-et-Argentières;434;4;438
76;Occitanie;30;2;07;066;Cannes-et-Clairan;540;12;552
76;Occitanie;30;2;20;067;La Capelle-et-Masmolène;439;6;445
76;Occitanie;30;3;15;068;Cardet;871;21;892
76;Occitanie;30;3;15;069;Carnas;479;12;491
76;Occitanie;30;2;14;070;Carsan;685;23;708
76;Occitanie;30;3;15;071;Cassagnoles;403;2;405
76;Occitanie;30;1;04;072;Castelnau-Valence;454;10;464
76;Occitanie;30;2;16;073;Castillon-du-Gard;1684;79;1763
76;Occitanie;30;3;22;074;Causse-Bégon;20;0;20
76;Occitanie;30;2;19;075;Caveirac;4181;112;4293
76;Occitanie;30;2;05;076;Cavillargues;843;29;872
76;Occitanie;30;1;08;077;Cendras;1841;30;1871
76;Occitanie;30;1;08;079;Chambon;266;6;272
76;Occitanie;30;1;08;080;Chamborigaud;852;5;857
76;Occitanie;30;2;05;081;Chusclan;967;29;996
76;Occitanie;30;2;19;082;Clarensac;4263;98;4361
76;Occitanie;30;2;21;083;Codognan;2423;48;2471
76;Occitanie;30;2;17;084;Codolet;660;12;672
76;Occitanie;30;2;16;085;Collias;1090;15;1105
76;Occitanie;30;2;20;086;Collorgues;608;10;618
76;Occitanie;30;3;15;087;Colognac;221;6;227
76;Occitanie;30;2;07;088;Combas;628;14;642
76;Occitanie;30;2;06;089;Comps;1784;25;1809
76;Occitanie;30;1;08;090;Concoules;258;4;262
76;Occitanie;30;2;07;091;Congénies;1668;35;1703
76;Occitanie;30;2;05;092;Connaux;1674;34;1708
76;Occitanie;30;3;22;093;Conqueyrac;97;2;99
76;Occitanie;30;1;08;094;Corbès;154;1;155
76;Occitanie;30;3;15;095;Corconne;542;26;568
76;Occitanie;30;2;14;096;Cornillon;934;21;955
76;Occitanie;30;1;18;097;Courry;279;4;283
76;Occitanie;30;2;07;098;Crespian;423;4;427
76;Occitanie;30;3;15;099;Cros;249;8;257
76;Occitanie;30;1;15;100;Cruviers-Lascours;702;8;710
76;Occitanie;30;1;04;101;Deaux;648;16;664
76;Occitanie;30;2;20;102;Dions;584;11;595
76;Occitanie;30;2;16;103;Domazan;930;11;941
76;Occitanie;30;2;15;104;Domessargues;753;18;771
76;Occitanie;30;3;22;105;Dourbies;145;5;150
76;Occitanie;30;3;15;106;Durfort-et-Saint-Martin-de-Sossenac;685;18;703
76;Occitanie;30;2;16;107;Estézargues;579;12;591
76;Occitanie;30;3;22;108;L' Estréchure;161;5;166
76;Occitanie;30;1;04;109;Euzet;439;7;446
76;Occitanie;30;2;20;110;Flaux;375;9;384
76;Occitanie;30;2;20;111;Foissac;423;6;429
76;Occitanie;30;2;07;112;Fons;1506;14;1520
76;Occitanie;30;2;03;113;Fons-sur-Lussan;237;3;240
76;Occitanie;30;2;07;114;Fontanès;690;12;702
76;Occitanie;30;2;20;115;Fontarèches;263;5;268
76;Occitanie;30;2;16;116;Fournès;1085;13;1098
76;Occitanie;30;2;06;117;Fourques;2891;44;2935
76;Occitanie;30;3;15;119;Fressac;162;5;167
76;Occitanie;30;1;18;120;Gagnières;1121;14;1135
76;Occitanie;30;3;15;121;Gailhan;246;4;250
76;Occitanie;30;2;07;122;Gajan;668;22;690
76;Occitanie;30;2;01;123;Gallargues-le-Montueux;3708;75;3783
76;Occitanie;30;2;14;124;Le Garn;213;2;215
76;Occitanie;30;2;09;125;Garons;4895;49;4944
76;Occitanie;30;2;20;126;Garrigues-Sainte-Eulalie;731;20;751
76;Occitanie;30;2;05;127;Gaujac;1096;26;1122
76;Occitanie;30;2;19;128;Générac;4118;56;4174
76;Occitanie;30;1;02;129;Générargues;699;20;719
76;Occitanie;30;1;08;130;Génolhac;841;20;861
76;Occitanie;30;2;14;131;Goudargues;1100;23;1123
76;Occitanie;30;1;08;132;La Grand-Combe;5041;97;5138
76;Occitanie;30;2;01;133;Le Grau-du-Roi;8517;78;8595
76;Occitanie;30;2;14;134;Issirac;310;6;316
76;Occitanie;30;2;06;135;Jonquières-Saint-Vincent;3779;37;3816
76;Occitanie;30;2;07;136;Junas;1107;17;1124
76;Occitanie;30;1;08;137;Lamelouze;139;4;143
76;Occitanie;30;2;19;138;Langlade;2190;55;2245
76;Occitanie;30;3;22;139;Lanuéjols;357;23;380
76;Occitanie;30;3;22;140;Lasalle;1140;12;1152
76;Occitanie;30;2;17;141;Laudun-l'Ardoise;6292;117;6409
76;Occitanie;30;1;08;142;Laval-Pradel;1161;23;1184
76;Occitanie;30;2;14;143;Laval-Saint-Roman;217;5;222
76;Occitanie;30;2;07;144;Lecques;470;3;473
76;Occitanie;30;2;16;145;Lédenon;1556;24;1580
76;Occitanie;30;3;15;146;Lédignan;1462;24;1486
76;Occitanie;30;1;15;147;Lézan;1537;26;1563
76;Occitanie;30;3;15;148;Liouc;281;6;287
76;Occitanie;30;2;17;149;Lirac;904;20;924
76;Occitanie;30;3;15;150;Logrian-Florian;264;7;271
76;Occitanie;30;2;03;151;Lussan;486;7;493
76;Occitanie;30;1;18;152;Les Mages;2074;35;2109
76;Occitanie;30;1;08;153;Malons-et-Elze;125;0;125
76;Occitanie;30;3;22;154;Mandagout;401;7;408
76;Occitanie;30;2;09;155;Manduel;6814;95;6909
76;Occitanie;30;2;09;156;Marguerittes;8586;158;8744
76;Occitanie;30;1;04;158;Martignargues;424;9;433
76;Occitanie;30;1;18;159;Le Martinet;750;5;755
76;Occitanie;30;3;15;160;Maruéjols-lès-Gardon;243;4;247
76;Occitanie;30;1;15;161;Massanes;194;6;200
76;Occitanie;30;1;15;162;Massillargues-Attuech;662;16;678
76;Occitanie;30;2;15;163;Mauressargues;158;6;164
76;Occitanie;30;1;18;164;Méjannes-le-Clap;710;14;724
76;Occitanie;30;1;04;165;Méjannes-lès-Alès;1222;30;1252
76;Occitanie;30;2;16;166;Meynes;2456;152;2608
76;Occitanie;30;1;18;167;Meyrannes;825;17;842
76;Occitanie;30;1;08;168;Mialet;624;17;641
76;Occitanie;30;2;19;169;Milhaud;5636;134;5770
76;Occitanie;30;3;22;170;Molières-Cavaillac;938;33;971
76;Occitanie;30;1;18;171;Molières-sur-Cèze;1297;14;1311
76;Occitanie;30;3;15;172;Monoblet;728;13;741
76;Occitanie;30;1;03;173;Mons;1677;31;1708
76;Occitanie;30;2;15;354;Montagnac;208;4;212
76;Occitanie;30;2;20;174;Montaren-et-Saint-Médiers;1434;34;1468
76;Occitanie;30;2;14;175;Montclus;206;1;207
76;Occitanie;30;3;22;176;Montdardier;201;4;205
76;Occitanie;30;1;04;177;Monteils;656;10;666
76;Occitanie;30;2;17;178;Montfaucon;1492;37;1529
76;Occitanie;30;2;16;179;Montfrin;3189;54;3243
76;Occitanie;30;2;07;180;Montignargues;597;10;607
76;Occitanie;30;2;07;181;Montmirat;433;5;438
76;Occitanie;30;2;07;182;Montpezat;1234;19;1253
76;Occitanie;30;2;15;183;Moulézan;648;3;651
76;Occitanie;30;2;15;184;Moussac;1485;12;1497
76;Occitanie;30;2;21;185;Mus;1410;19;1429
76;Occitanie;30;2;07;186;Nages-et-Solorgues;1736;49;1785
76;Occitanie;30;1;18;187;Navacelles;325;8;333
76;Occitanie;30;1;15;188;Ners;702;13;715
76;Occitanie;30;2;99;189;Nîmes;150610;2342;152952
76;Occitanie;30;2;05;191;Orsan;1145;27;1172
76;Occitanie;30;3;15;192;Orthoux-Sérignac-Quilhan;416;7;423
76;Occitanie;30;2;07;193;Parignargues;678;4;682
76;Occitanie;30;1;18;194;Peyremale;285;2;287
76;Occitanie;30;3;22;195;Peyrolles;33;3;36
76;Occitanie;30;2;05;196;Le Pin;426;8;434
76;Occitanie;30;1;03;197;Les Plans;252;7;259
76;Occitanie;30;3;22;198;Les Plantiers;257;6;263
76;Occitanie;30;3;22;199;Pommiers;56;1;57
76;Occitanie;30;3;22;200;Pompignan;957;14;971
76;Occitanie;30;2;14;202;Pont-Saint-Esprit;10336;183;10519
76;Occitanie;30;1;08;201;Ponteils-et-Brésis;364;7;371
76;Occitanie;30;1;08;203;Portes;344;8;352
76;Occitanie;30;1;18;204;Potelières;373;9;382
76;Occitanie;30;2;20;205;Pougnadoresse;246;4;250
76;Occitanie;30;2;09;206;Poulx;3933;114;4047
76;Occitanie;30;2;16;207;Pouzilhac;713;6;719
76;Occitanie;30;3;15;208;Puechredon;40;0;40
76;Occitanie;30;2;23;209;Pujaut;4136;138;4274
76;Occitanie;30;3;15;210;Quissac;3216;35;3251
76;Occitanie;30;2;16;211;Redessan;4115;57;4172
76;Occitanie;30;2;16;212;Remoulins;2281;42;2323
76;Occitanie;30;3;22;213;Revens;21;0;21
76;Occitanie;30;1;02;214;Ribaute-les-Tavernes;2209;42;2251
76;Occitanie;30;1;18;215;Rivières;362;3;365
76;Occitanie;30;1;18;216;Robiac-Rochessadoule;840;15;855
76;Occitanie;30;2;23;217;Rochefort-du-Gard;7532;177;7709
76;Occitanie;30;1;18;218;Rochegude;252;3;255
76;Occitanie;30;2;09;356;Rodilhan;2878;197;3075
76;Occitanie;30;3;22;219;Rogues;107;2;109
76;Occitanie;30;2;14;222;La Roque-sur-Cèze;184;4;188
76;Occitanie;30;3;22;220;Roquedur;257;7;264
76;Occitanie;30;2;17;221;Roquemaure;5481;65;5546
76;Occitanie;30;1;18;223;Rousson;4106;71;4177
76;Occitanie;30;2;07;224;La Rouvière;598;14;612
76;Occitanie;30;2;05;225;Sabran;1674;51;1725
76;Occitanie;30;2;14;226;Saint-Alexandre;1232;25;1257
76;Occitanie;30;1;18;227;Saint-Ambroix;3162;39;3201
76;Occitanie;30;2;14;232;Saint-André-d'Olérargues;429;14;443
76;Occitanie;30;3;22;229;Saint-André-de-Majencoules;592;16;608
76;Occitanie;30;2;14;230;Saint-André-de-Roquepertuis;594;9;603
76;Occitanie;30;3;22;231;Saint-André-de-Valborgne;382;11;393
76;Occitanie;30;2;07;233;Saint-Bauzély;649;11;660
76;Occitanie;30;3;15;234;Saint-Bénézet;274;7;281
76;Occitanie;30;1;08;236;Saint-Bonnet-de-Salendrinque;120;3;123
76;Occitanie;30;2;16;235;Saint-Bonnet-du-Gard;835;11;846
76;Occitanie;30;1;18;237;Saint-Brès;652;12;664
76;Occitanie;30;3;22;238;Saint-Bresson;54;2;56
76;Occitanie;30;1;04;240;Saint-Césaire-de-Gauzignan;382;5;387
76;Occitanie;30;2;20;241;Saint-Chaptes;1865;29;1894
76;Occitanie;30;2;14;242;Saint-Christol-de-Rodières;160;2;162
76;Occitanie;30;1;02;243;Saint-Christol-lez-Alès;7030;189;7219
76;Occitanie;30;2;07;244;Saint-Clément;379;6;385
76;Occitanie;30;2;19;245;Saint-Côme-et-Maruéjols;790;14;804
76;Occitanie;30;1;18;247;Saint-Denis;294;9;303
76;Occitanie;30;2;20;248;Saint-Dézéry;450;4;454
76;Occitanie;30;2;19;249;Saint-Dionisy;1039;13;1052
76;Occitanie;30;1;04;250;Saint-Étienne-de-l'Olm;388;11;399
76;Occitanie;30;2;05;251;Saint-Étienne-des-Sorts;557;12;569
76;Occitanie;30;3;15;252;Saint-Félix-de-Pallières;252;7;259
76;Occitanie;30;1;18;253;Saint-Florent-sur-Auzonnet;1173;16;1189
76;Occitanie;30;2;17;254;Saint-Geniès-de-Comolas;1969;40;2009
76;Occitanie;30;2;07;255;Saint-Geniès-de-Malgoirès;3007;31;3038
76;Occitanie;30;2;14;256;Saint-Gervais;720;16;736
76;Occitanie;30;2;16;257;Saint-Gervasy;1899;27;1926
76;Occitanie;30;2;19;258;Saint-Gilles;13607;104;13711
76;Occitanie;30;2;16;260;Saint-Hilaire-d'Ozilhan;1069;21;1090
76;Occitanie;30;1;04;259;Saint-Hilaire-de-Brethmas;4313;106;4419
76;Occitanie;30;1;04;261;Saint-Hippolyte-de-Caton;213;4;217
76;Occitanie;30;2;20;262;Saint-Hippolyte-de-Montaigu;260;8;268
76;Occitanie;30;3;22;263;Saint-Hippolyte-du-Fort;3939;104;4043
76;Occitanie;30;1;04;264;Saint-Jean-de-Ceyrargues;164;1;165
76;Occitanie;30;3;15;265;Saint-Jean-de-Crieulon;246;2;248
76;Occitanie;30;1;18;266;Saint-Jean-de-Maruéjols-et-Avéjan;920;11;931
76;Occitanie;30;1;15;267;Saint-Jean-de-Serres;521;11;532
76;Occitanie;30;1;18;268;Saint-Jean-de-Valériscle;669;10;679
76;Occitanie;30;1;08;269;Saint-Jean-du-Gard;2433;171;2604
76;Occitanie;30;1;02;270;Saint-Jean-du-Pin;1511;39;1550
76;Occitanie;30;1;18;271;Saint-Julien-de-Cassagnas;698;15;713
76;Occitanie;30;3;22;272;Saint-Julien-de-la-Nef;141;6;147
76;Occitanie;30;2;14;273;Saint-Julien-de-Peyrolas;1402;26;1428
76;Occitanie;30;1;18;274;Saint-Julien-les-Rosiers;3348;62;3410
76;Occitanie;30;1;03;275;Saint-Just-et-Vacquières;302;2;304
76;Occitanie;30;2;01;276;Saint-Laurent-d'Aigouze;3474;42;3516
76;Occitanie;30;2;14;277;Saint-Laurent-de-Carnols;496;9;505
76;Occitanie;30;2;17;278;Saint-Laurent-des-Arbres;3072;36;3108
76;Occitanie;30;2;20;279;Saint-Laurent-la-Vernède;681;11;692
76;Occitanie;30;3;22;280;Saint-Laurent-le-Minier;341;11;352
76;Occitanie;30;2;07;281;Saint-Mamert-du-Gard;1634;21;1655
76;Occitanie;30;2;14;282;Saint-Marcel-de-Careiret;845;17;862
76;Occitanie;30;3;22;283;Saint-Martial;179;3;182
76;Occitanie;30;1;03;284;Saint-Martin-de-Valgalgues;4419;61;4480
76;Occitanie;30;1;04;285;Saint-Maurice-de-Cazevieille;727;8;735
76;Occitanie;30;2;20;286;Saint-Maximin;746;18;764
76;Occitanie;30;2;14;287;Saint-Michel-d'Euzet;636;12;648
76;Occitanie;30;2;14;288;Saint-Nazaire;1229;19;1248
76;Occitanie;30;3;15;289;Saint-Nazaire-des-Gardies;83;2;85
76;Occitanie;30;1;08;291;Saint-Paul-la-Coste;285;6;291
76;Occitanie;30;2;17;355;Saint-Paul-les-Fonts;1031;21;1052
76;Occitanie;30;2;14;290;Saint-Paulet-de-Caisson;1810;43;1853
76;Occitanie;30;2;05;292;Saint-Pons-la-Calm;438;10;448
76;Occitanie;30;1;18;293;Saint-Privat-de-Champclos;344;5;349
76;Occitanie;30;1;03;294;Saint-Privat-des-Vieux;5182;127;5309
76;Occitanie;30;2;20;295;Saint-Quentin-la-Poterie;3054;63;3117
76;Occitanie;30;3;22;296;Saint-Roman-de-Codières;157;15;172
76;Occitanie;30;3;22;297;Saint-Sauveur-Camprieu;245;14;259
76;Occitanie;30;1;08;298;Saint-Sébastien-d'Aigrefeuille;500;20;520
76;Occitanie;30;2;20;299;Saint-Siffret;1067;36;1103
76;Occitanie;30;3;15;300;Saint-Théodorit;532;6;538
76;Occitanie;30;1;18;303;Saint-Victor-de-Malcap;833;21;854
76;Occitanie;30;2;20;301;Saint-Victor-des-Oules;306;4;310
76;Occitanie;30;2;17;302;Saint-Victor-la-Coste;2073;42;2115
76;Occitanie;30;2;20;228;Sainte-Anastasie;1686;27;1713
76;Occitanie;30;1;08;239;Sainte-Cécile-d'Andorge;586;3;589
76;Occitanie;30;1;08;246;Sainte-Croix-de-Caderle;113;7;120
76;Occitanie;30;2;14;304;Salazac;184;3;187
76;Occitanie;30;1;03;305;Salindres;3494;41;3535
76;Occitanie;30;2;07;306;Salinelles;573;8;581
76;Occitanie;30;1;08;307;Les Salles-du-Gardon;2600;26;2626
76;Occitanie;30;2;20;308;Sanilhac-Sagriès;780;51;831
76;Occitanie;30;3;15;309;Sardan;300;1;301
76;Occitanie;30;3;22;310;Saumane;276;6;282
76;Occitanie;30;3;15;311;Sauve;1928;22;1950
76;Occitanie;30;2;17;312;Sauveterre;2036;48;2084
76;Occitanie;30;2;07;313;Sauzet;747;7;754
76;Occitanie;30;3;15;314;Savignargues;239;4;243
76;Occitanie;30;2;23;315;Saze;2037;39;2076
76;Occitanie;30;1;08;316;Sénéchas;247;8;255
76;Occitanie;30;2;16;317;Sernhac;1755;23;1778
76;Occitanie;30;1;03;318;Servas;209;4;213
76;Occitanie;30;2;20;319;Serviers-et-Labaume;604;23;627
76;Occitanie;30;1;03;320;Seynes;161;2;163
76;Occitanie;30;2;07;321;Sommières;4917;62;4979
76;Occitanie;30;3;22;322;Soudorgues;275;7;282
76;Occitanie;30;1;08;323;Soustelle;123;3;126
76;Occitanie;30;2;07;324;Souvignargues;871;15;886
76;Occitanie;30;3;22;325;Sumène;1549;42;1591
76;Occitanie;30;2;17;326;Tavel;1979;35;2014
76;Occitanie;30;1;18;327;Tharaux;56;2;58
76;Occitanie;30;2;16;328;Théziers;1039;18;1057
76;Occitanie;30;1;08;329;Thoiras;436;16;452
76;Occitanie;30;1;15;330;Tornac;904;26;930
76;Occitanie;30;2;05;331;Tresques;1806;50;1856
76;Occitanie;30;3;22;332;Trèves;128;1;129
76;Occitanie;30;2;21;333;Uchaud;4315;41;4356
76;Occitanie;30;2;20;334;Uzès;8454;359;8813
76;Occitanie;30;1;08;335;Vabres;121;4;125
76;Occitanie;30;3;22;339;Val-d'Aigoual;1431;20;1451
76;Occitanie;30;2;06;336;Vallabrègues;1392;19;1411
76;Occitanie;30;2;20;337;Vallabrix;432;5;437
76;Occitanie;30;2;03;338;Vallérargues;140;4;144
76;Occitanie;30;2;16;340;Valliguières;584;11;595
76;Occitanie;30;2;21;341;Vauvert;11608;134;11742
76;Occitanie;30;2;14;342;Vénéjan;1246;41;1287
76;Occitanie;30;2;14;343;Verfeuil;600;7;607
76;Occitanie;30;2;21;344;Vergèze;5188;79;5267
76;Occitanie;30;1;08;345;La Vernarède;336;2;338
76;Occitanie;30;2;16;346;Vers-Pont-du-Gard;1850;35;1885
76;Occitanie;30;2;21;347;Vestric-et-Candiac;1406;17;1423
76;Occitanie;30;1;04;348;Vézénobres;1774;97;1871
76;Occitanie;30;3;15;349;Vic-le-Fesq;522;4;526
76;Occitanie;30;3;22;350;Le Vigan;3820;124;3944
76;Occitanie;30;2;23;351;Villeneuve-lès-Avignon;11698;405;12103
76;Occitanie;30;2;07;352;Villevieille;1709;44;1753
76;Occitanie;30;3;22;353;Vissec;60;1;61
76;Occitanie;31;2;06;001;Agassac;118;3;121
76;Occitanie;31;3;07;002;Aignes;245;6;251
76;Occitanie;31;3;07;003;Aigrefeuille;1275;37;1312
76;Occitanie;31;2;06;005;Alan;305;8;313
76;Occitanie;31;3;13;006;Albiac;210;5;215
76;Occitanie;31;2;06;007;Ambax;67;0;67
76;Occitanie;31;2;06;008;Anan;243;7;250
76;Occitanie;31;2;02;009;Antichan-de-Frontignes;157;3;160
76;Occitanie;31;2;02;010;Antignac;116;5;121
76;Occitanie;31;2;02;011;Arbas;263;6;269
76;Occitanie;31;2;02;012;Arbon;102;1;103
76;Occitanie;31;2;02;013;Ardiège;364;11;375
76;Occitanie;31;2;02;014;Arguenos;72;1;73
76;Occitanie;31;2;02;015;Argut-Dessous;23;1;24
76;Occitanie;31;2;02;017;Arlos;100;1;101
76;Occitanie;31;2;02;018;Arnaud-Guilhem;231;3;234
76;Occitanie;31;2;02;019;Artigue;30;1;31
76;Occitanie;31;2;02;020;Aspet;879;72;951
76;Occitanie;31;2;14;021;Aspret-Sarrat;136;5;141
76;Occitanie;31;3;05;022;Aucamville;8408;69;8477
76;Occitanie;31;2;06;023;Aulon;309;10;319
76;Occitanie;31;1;07;024;Auragne;427;5;432
76;Occitanie;31;3;04;025;Aureville;899;14;913
76;Occitanie;31;3;13;026;Auriac-sur-Vendinelle;1035;13;1048
76;Occitanie;31;1;01;027;Auribail;204;5;209
76;Occitanie;31;2;06;028;Aurignac;1193;72;1265
76;Occitanie;31;3;13;029;Aurin;332;6;338
76;Occitanie;31;2;02;030;Ausseing;72;5;77
76;Occitanie;31;2;14;031;Ausson;586;15;601
76;Occitanie;31;3;03;032;Aussonne;6984;73;7057
76;Occitanie;31;1;01;033;Auterive;9752;98;9850
76;Occitanie;31;2;02;034;Auzas;239;10;249
76;Occitanie;31;3;04;035;Auzeville-Tolosane;4126;249;4375
76;Occitanie;31;3;04;036;Auzielle;1500;45;1545
76;Occitanie;31;3;13;037;Avignonet-Lauragais;1534;12;1546
76;Occitanie;31;3;07;004;Ayguesvives;2655;49;2704
76;Occitanie;31;3;10;038;Azas;664;16;680
76;Occitanie;31;2;06;039;Bachas;71;1;72
76;Occitanie;31;2;02;040;Bachos;38;1;39
76;Occitanie;31;2;02;041;Bagiry;112;2;114
76;Occitanie;31;2;02;042;Bagnères-de-Luchon;2312;143;2455
76;Occitanie;31;2;14;043;Balesta;148;6;154
76;Occitanie;31;3;24;044;Balma;16568;310;16878
76;Occitanie;31;2;02;045;Barbazan;490;10;500
76;Occitanie;31;2;02;046;Baren;12;0;12
76;Occitanie;31;1;01;047;Bax;89;1;90
76;Occitanie;31;3;07;048;Baziège;3346;57;3403
76;Occitanie;31;3;10;049;Bazus;553;15;568
76;Occitanie;31;2;02;050;Beauchalot;640;9;649
76;Occitanie;31;1;06;051;Beaufort;462;6;468
76;Occitanie;31;1;01;052;Beaumont-sur-Lèze;1557;31;1588
76;Occitanie;31;3;24;053;Beaupuy;1340;28;1368
76;Occitanie;31;3;13;054;Beauteville;175;1;176
76;Occitanie;31;3;13;055;Beauville;170;3;173
76;Occitanie;31;3;03;056;Beauzelle;6387;76;6463
76;Occitanie;31;3;07;057;Belberaud;1503;51;1554
76;Occitanie;31;3;07;058;Belbèze-de-Lauragais;123;1;124
76;Occitanie;31;2;02;059;Belbèze-en-Comminges;113;6;119
76;Occitanie;31;3;13;060;Bélesta-en-Lauragais;115;5;120
76;Occitanie;31;3;08;061;Bellegarde-Sainte-Marie;192;12;204
76;Occitanie;31;3;08;062;Bellesserre;110;3;113
76;Occitanie;31;2;06;063;Benque;162;2;164
76;Occitanie;31;2;02;064;Benque-Dessous-et-Dessus;25;0;25
76;Occitanie;31;1;06;065;Bérat;3016;59;3075
76;Occitanie;31;3;27;066;Bessières;4073;59;4132
76;Occitanie;31;2;02;067;Bezins-Garraux;44;0;44
76;Occitanie;31;2;02;068;Billière;22;0;22
76;Occitanie;31;2;02;590;Binos;43;0;43
76;Occitanie;31;3;03;069;Blagnac;24517;492;25009
76;Occitanie;31;2;14;070;Blajan;504;9;513
76;Occitanie;31;1;01;071;Bois-de-la-Pierre;429;3;432
76;Occitanie;31;2;06;072;Boissède;70;2;72
76;Occitanie;31;3;27;073;Bondigoux;537;12;549
76;Occitanie;31;3;10;074;Bonrepos-Riquet;293;7;300
76;Occitanie;31;1;11;075;Bonrepos-sur-Aussonnelle;1187;22;1209
76;Occitanie;31;2;14;076;Bordes-de-Rivière;483;12;495
76;Occitanie;31;3;27;077;Le Born;548;14;562
76;Occitanie;31;2;14;078;Boudrac;144;2;146
76;Occitanie;31;3;27;079;Bouloc;4659;84;4743
76;Occitanie;31;2;14;080;Boulogne-sur-Gesse;1612;48;1660
76;Occitanie;31;2;02;081;Bourg-d'Oueil;6;0;6
76;Occitanie;31;3;13;082;Bourg-Saint-Bernard;1038;19;1057
76;Occitanie;31;2;06;083;Boussan;239;2;241
76;Occitanie;31;1;06;084;Boussens;1074;23;1097
76;Occitanie;31;2;02;085;Boutx;244;3;247
76;Occitanie;31;2;06;086;Bouzin;96;4;100
76;Occitanie;31;1;11;087;Bragayrac;326;2;328
76;Occitanie;31;3;21;088;Brax;2811;101;2912
76;Occitanie;31;3;08;089;Bretx;663;6;669
76;Occitanie;31;3;08;090;Brignemont;387;5;392
76;Occitanie;31;3;05;091;Bruguières;5832;84;5916
76;Occitanie;31;2;02;092;Burgalays;123;6;129
76;Occitanie;31;3;08;093;Le Burgaud;979;8;987
76;Occitanie;31;3;27;094;Buzet-sur-Tarn;2767;49;2816
76;Occitanie;31;2;02;095;Cabanac-Cazaux;126;1;127
76;Occitanie;31;3;08;096;Cabanac-Séguenville;170;1;171
76;Occitanie;31;3;13;097;Le Cabanial;454;13;467
76;Occitanie;31;3;08;098;Cadours;1086;18;1104
76;Occitanie;31;3;07;099;Caignac;356;4;360
76;Occitanie;31;3;07;100;Calmont;2371;31;2402
76;Occitanie;31;1;06;101;Cambernard;466;4;470
76;Occitanie;31;3;13;102;Cambiac;215;3;218
76;Occitanie;31;1;01;103;Canens;60;0;60
76;Occitanie;31;1;01;104;Capens;662;13;675
76;Occitanie;31;3;13;105;Caragoudes;223;8;231
76;Occitanie;31;3;13;106;Caraman;2500;45;2545
76;Occitanie;31;1;01;107;Carbonne;5712;104;5816
76;Occitanie;31;2;14;108;Cardeilhac;267;2;269
76;Occitanie;31;2;06;109;Cassagnabère-Tournas;461;3;464
76;Occitanie;31;2;02;110;Cassagne;634;13;647
76;Occitanie;31;1;01;111;Castagnac;288;4;292
76;Occitanie;31;2;02;112;Castagnède;189;4;193
76;Occitanie;31;3;04;113;Castanet-Tolosan;13529;197;13726
76;Occitanie;31;2;02;114;Castelbiague;251;2;253
76;Occitanie;31;2;06;115;Castelgaillard;61;1;62
76;Occitanie;31;3;05;116;Castelginest;10467;115;10582
76;Occitanie;31;3;10;117;Castelmaurou;4273;96;4369
76;Occitanie;31;3;27;118;Castelnau-d'Estrétefonds;6334;64;6398
76;Occitanie;31;1;06;119;Castelnau-Picampeau;215;5;220
76;Occitanie;31;3;08;120;Le Castéra;736;18;754
76;Occitanie;31;2;14;121;Castéra-Vignoles;64;1;65
76;Occitanie;31;1;06;122;Casties-Labrande;117;2;119
76;Occitanie;31;2;02;123;Castillon-de-Larboust;63;1;64
76;Occitanie;31;2;02;124;Castillon-de-Saint-Martory;382;9;391
76;Occitanie;31;2;02;125;Cathervielle;36;0;36
76;Occitanie;31;3;08;126;Caubiac;382;10;392
76;Occitanie;31;2;02;127;Caubous;4;1;5
76;Occitanie;31;1;01;128;Caujac;837;12;849
76;Occitanie;31;2;06;593;Cazac;88;0;88
76;Occitanie;31;2;14;130;Cazaril-Tambourès;88;3;91
76;Occitanie;31;2;02;129;Cazarilh-Laspènes;24;6;30
76;Occitanie;31;2;02;131;Cazaunous;72;0;72
76;Occitanie;31;2;02;132;Cazaux-Layrisse;60;1;61
76;Occitanie;31;2;02;133;Cazeaux-de-Larboust;97;4;101
76;Occitanie;31;2;06;134;Cazeneuve-Montaut;74;0;74
76;Occitanie;31;1;06;135;Cazères;4889;65;4954
76;Occitanie;31;3;27;136;Cépet;1878;21;1899
76;Occitanie;31;3;13;137;Cessales;167;0;167
76;Occitanie;31;2;14;138;Charlas;242;6;248
76;Occitanie;31;2;02;139;Chaum;189;4;193
76;Occitanie;31;2;02;140;Chein-Dessus;182;7;189
76;Occitanie;31;2;14;141;Ciadoux;232;1;233
76;Occitanie;31;2;02;142;Cier-de-Luchon;248;7;255
76;Occitanie;31;2;02;143;Cier-de-Rivière;279;7;286
76;Occitanie;31;2;02;144;Cierp-Gaud;734;12;746
76;Occitanie;31;1;01;145;Cintegabelle;2904;65;2969
76;Occitanie;31;2;02;146;Cirès;13;0;13
76;Occitanie;31;2;14;147;Clarac;630;11;641
76;Occitanie;31;3;04;148;Clermont-le-Fort;506;27;533
76;Occitanie;31;3;21;149;Colomiers;38951;474;39425
76;Occitanie;31;3;03;150;Cornebarrieu;6592;93;6685
76;Occitanie;31;3;07;151;Corronsac;813;22;835
76;Occitanie;31;2;06;152;Coueilles;94;5;99
76;Occitanie;31;1;06;153;Couladère;425;12;437
76;Occitanie;31;2;02;155;Couret;239;2;241
76;Occitanie;31;3;08;156;Cox;341;1;342
76;Occitanie;31;3;26;157;Cugnaux;17974;223;18197
76;Occitanie;31;2;14;158;Cuguron;185;4;189
76;Occitanie;31;2;14;159;Le Cuing;465;5;470
76;Occitanie;31;3;08;160;Daux;2361;26;2387
76;Occitanie;31;3;07;161;Deyme;1192;21;1213
76;Occitanie;31;3;07;162;Donneville;1009;75;1084
76;Occitanie;31;3;24;163;Drémil-Lafage;2652;79;2731
76;Occitanie;31;3;08;164;Drudas;216;6;222
76;Occitanie;31;1;12;165;Eaunes;6162;94;6256
76;Occitanie;31;1;11;166;Empeaux;256;5;261
76;Occitanie;31;2;02;167;Encausse-les-Thermes;694;14;708
76;Occitanie;31;2;06;168;Eoux;119;0;119
76;Occitanie;31;3;07;169;Escalquens;6660;153;6813
76;Occitanie;31;2;14;170;Escanecrabe;246;10;256
76;Occitanie;31;2;02;591;Escoulis;80;0;80
76;Occitanie;31;3;07;171;Espanès;325;4;329
76;Occitanie;31;2;06;172;Esparron;57;2;59
76;Occitanie;31;1;01;173;Esperce;259;3;262
76;Occitanie;31;2;02;174;Estadens;528;4;532
76;Occitanie;31;2;14;175;Estancarbon;606;10;616
76;Occitanie;31;2;02;176;Esténos;187;5;192
76;Occitanie;31;2;02;177;Eup;133;2;135
76;Occitanie;31;2;06;178;Fabas;201;3;204
76;Occitanie;31;3;13;179;Le Faget;343;6;349
76;Occitanie;31;3;13;180;Falga;124;6;130
76;Occitanie;31;1;09;181;Le Fauga;2048;27;2075
76;Occitanie;31;3;05;182;Fenouillet;5161;58;5219
76;Occitanie;31;2;02;183;Figarol;305;9;314
76;Occitanie;31;3;24;184;Flourens;1963;38;2001
76;Occitanie;31;3;13;185;Folcarde;118;1;119
76;Occitanie;31;3;05;186;Fonbeauzard;2973;30;3003
76;Occitanie;31;1;11;187;Fonsorbes;11743;272;12015
76;Occitanie;31;1;11;188;Fontenilles;5935;124;6059
76;Occitanie;31;1;06;189;Forgues;212;4;216
76;Occitanie;31;2;02;190;Fos;237;0;237
76;Occitanie;31;2;02;191;Fougaron;95;2;97
76;Occitanie;31;3;07;192;Fourquevaux;771;21;792
76;Occitanie;31;1;06;193;Le Fousseret;1897;30;1927
76;Occitanie;31;3;13;194;Francarville;174;2;176
76;Occitanie;31;2;02;195;Francazal;29;0;29
76;Occitanie;31;1;06;196;Francon;243;3;246
76;Occitanie;31;2;14;197;Franquevielle;332;8;340
76;Occitanie;31;2;02;198;Le Fréchet;103;3;106
76;Occitanie;31;2;02;199;Fronsac;210;10;220
76;Occitanie;31;2;02;200;Frontignan-de-Comminges;77;4;81
76;Occitanie;31;2;06;201;Frontignan-Savès;70;0;70
76;Occitanie;31;3;27;202;Fronton;6079;143;6222
76;Occitanie;31;1;09;203;Frouzins;9022;155;9177
76;Occitanie;31;1;06;204;Fustignac;80;3;83
76;Occitanie;31;3;05;205;Gagnac-sur-Garonne;3110;27;3137
76;Occitanie;31;1;01;206;Gaillac-Toulza;1265;13;1278
76;Occitanie;31;2;02;207;Galié;82;6;88
76;Occitanie;31;2;02;208;Ganties;327;5;332
76;Occitanie;31;3;08;209;Garac;154;4;158
76;Occitanie;31;3;13;210;Gardouch;1268;23;1291
76;Occitanie;31;3;27;211;Gargas;685;9;694
76;Occitanie;31;3;10;212;Garidech;1768;12;1780
76;Occitanie;31;2;02;213;Garin;145;3;148
76;Occitanie;31;3;10;215;Gauré;494;16;510
76;Occitanie;31;3;10;216;Gémil;270;10;280
76;Occitanie;31;2;02;217;Génos;70;1;71
76;Occitanie;31;2;14;218;Gensac-de-Boulogne;125;4;129
76;Occitanie;31;1;01;219;Gensac-sur-Garonne;442;3;445
76;Occitanie;31;3;07;220;Gibel;361;6;367
76;Occitanie;31;2;02;221;Gouaux-de-Larboust;67;0;67
76;Occitanie;31;2;02;222;Gouaux-de-Luchon;46;0;46
76;Occitanie;31;2;06;223;Goudex;47;1;48
76;Occitanie;31;2;02;224;Gourdan-Polignan;1203;186;1389
76;Occitanie;31;1;01;225;Goutevernisse;187;3;190
76;Occitanie;31;1;01;226;Gouzens;81;10;91
76;Occitanie;31;3;04;227;Goyrans;843;36;879
76;Occitanie;31;3;10;228;Gragnague;1817;39;1856
76;Occitanie;31;1;06;229;Gratens;684;18;702
76;Occitanie;31;3;05;230;Gratentour;4158;92;4250
76;Occitanie;31;1;01;231;Grazac;587;8;595
76;Occitanie;31;3;08;232;Grenade;8847;99;8946
76;Occitanie;31;1;01;233;Grépiac;982;26;1008
76;Occitanie;31;3;08;234;Le Grès;433;8;441
76;Occitanie;31;2;02;235;Guran;44;1;45
76;Occitanie;31;2;02;236;Herran;75;1;76
76;Occitanie;31;2;02;237;His;223;30;253
76;Occitanie;31;2;02;238;Huos;489;11;500
76;Occitanie;31;2;06;239;L' Isle-en-Dodon;1631;23;1654
76;Occitanie;31;3;07;240;Issus;595;10;605
76;Occitanie;31;2;02;241;Izaut-de-l'Hôtel;314;5;319
76;Occitanie;31;2;02;242;Jurvielle;20;2;22
76;Occitanie;31;3;13;243;Juzes;85;5;90
76;Occitanie;31;2;02;245;Juzet-d'Izaut;188;5;193
76;Occitanie;31;2;02;244;Juzet-de-Luchon;369;16;385
76;Occitanie;31;2;14;246;Labarthe-Inard;852;13;865
76;Occitanie;31;2;14;247;Labarthe-Rivière;1332;29;1361
76;Occitanie;31;1;12;248;Labarthe-sur-Lèze;6178;101;6279
76;Occitanie;31;3;07;249;Labastide-Beauvoir;1272;26;1298
76;Occitanie;31;1;06;250;Labastide-Clermont;664;8;672
76;Occitanie;31;2;06;251;Labastide-Paumès;146;1;147
76;Occitanie;31;3;10;252;Labastide-Saint-Sernin;1909;21;1930
76;Occitanie;31;1;09;253;Labastidette;2563;33;2596
76;Occitanie;31;3;04;254;Labège;4044;147;4191
76;Occitanie;31;2;02;255;Labroquère;323;16;339
76;Occitanie;31;1;01;256;Labruyère-Dorsa;284;6;290
76;Occitanie;31;1;01;258;Lacaugne;218;5;223
76;Occitanie;31;3;04;259;Lacroix-Falgarde;2068;48;2116
76;Occitanie;31;2;02;260;Laffite-Toupière;103;1;104
76;Occitanie;31;1;01;261;Lafitte-Vigordane;1188;18;1206
76;Occitanie;31;3;13;262;Lagarde;409;11;420
76;Occitanie;31;1;12;263;Lagardelle-sur-Lèze;3045;45;3090
76;Occitanie;31;1;01;264;Lagrâce-Dieu;571;7;578
76;Occitanie;31;3;08;265;Lagraulet-Saint-Nicolas;251;4;255
76;Occitanie;31;1;06;266;Lahage;208;1;209
76;Occitanie;31;1;01;267;Lahitère;60;0;60
76;Occitanie;31;2;14;268;Lalouret-Laffiteau;134;3;137
76;Occitanie;31;1;09;269;Lamasquère;1462;14;1476
76;Occitanie;31;2;14;270;Landorthe;991;33;1024
76;Occitanie;31;3;13;271;Lanta;2070;40;2110
76;Occitanie;31;1;01;272;Lapeyrère;68;1;69
76;Occitanie;31;3;10;273;Lapeyrouse-Fossat;2821;58;2879
76;Occitanie;31;2;14;274;Larcan;177;4;181
76;Occitanie;31;3;08;275;Laréole;171;5;176
76;Occitanie;31;3;08;592;Larra;1891;30;1921
76;Occitanie;31;2;14;276;Larroque;292;5;297
76;Occitanie;31;3;08;277;Lasserre-Pradère;1522;42;1564
76;Occitanie;31;2;06;278;Latoue;323;5;328
76;Occitanie;31;1;01;279;Latour;77;1;78
76;Occitanie;31;1;01;280;Latrape;364;13;377
76;Occitanie;31;3;08;281;Launac;1382;34;1416
76;Occitanie;31;3;22;282;Launaguet;8880;108;8988
76;Occitanie;31;1;06;283;Lautignac;265;1;266
76;Occitanie;31;3;07;284;Lauzerville;1588;52;1640
76;Occitanie;31;3;10;285;Lavalette;738;13;751
76;Occitanie;31;1;01;286;Lavelanet-de-Comminges;625;8;633
76;Occitanie;31;1;09;287;Lavernose-Lacasse;3050;77;3127
76;Occitanie;31;3;27;288;Layrac-sur-Tarn;322;9;331
76;Occitanie;31;2;14;289;Lécussan;268;3;271
76;Occitanie;31;2;02;290;Lège;43;1;44
76;Occitanie;31;3;08;291;Léguevin;9196;248;9444
76;Occitanie;31;1;06;292;Lescuns;72;0;72
76;Occitanie;31;3;05;293;Lespinasse;2737;20;2757
76;Occitanie;31;2;14;294;Lespiteau;103;1;104
76;Occitanie;31;2;14;295;Lespugue;81;0;81
76;Occitanie;31;2;02;296;Lestelle-de-Saint-Martory;440;8;448
76;Occitanie;31;3;08;297;Lévignac;2113;39;2152
76;Occitanie;31;1;06;299;Lherm;3678;79;3757
76;Occitanie;31;2;14;300;Lieoux;126;0;126
76;Occitanie;31;2;06;301;Lilhac;130;1;131
76;Occitanie;31;2;14;302;Lodes;292;7;299
76;Occitanie;31;1;01;303;Longages;3082;34;3116
76;Occitanie;31;3;13;304;Loubens-Lauragais;461;10;471
76;Occitanie;31;2;14;305;Loudet;196;6;202
76;Occitanie;31;2;02;306;Lourde;92;0;92
76;Occitanie;31;2;02;308;Luscan;55;0;55
76;Occitanie;31;1;06;309;Lussan-Adeilhac;227;2;229
76;Occitanie;31;3;13;310;Lux;344;5;349
76;Occitanie;31;3;27;311;La Magdelaine-sur-Tarn;1171;21;1192
76;Occitanie;31;1;01;312;Mailholas;34;0;34
76;Occitanie;31;2;02;313;Malvezie;115;2;117
76;Occitanie;31;2;02;314;Mancioux;409;4;413
76;Occitanie;31;2;02;315;Mane;963;40;1003
76;Occitanie;31;2;02;316;Marignac;484;8;492
76;Occitanie;31;1;06;317;Marignac-Lasclares;478;19;497
76;Occitanie;31;1;06;318;Marignac-Laspeyres;218;6;224
76;Occitanie;31;1;01;319;Marliac;145;1;146
76;Occitanie;31;1;01;320;Marquefave;967;53;1020
76;Occitanie;31;2;02;321;Marsoulas;123;8;131
76;Occitanie;31;2;06;322;Martisserre;61;2;63
76;Occitanie;31;2;02;323;Martres-de-Rivière;357;11;368
76;Occitanie;31;1;06;324;Martres-Tolosane;2383;42;2425
76;Occitanie;31;3;13;325;Mascarville;179;12;191
76;Occitanie;31;1;01;326;Massabrac;89;0;89
76;Occitanie;31;1;06;327;Mauran;233;1;234
76;Occitanie;31;3;13;328;Mauremont;323;10;333
76;Occitanie;31;3;13;329;Maurens;206;2;208
76;Occitanie;31;1;01;330;Mauressac;518;5;523
76;Occitanie;31;3;13;331;Maureville;304;12;316
76;Occitanie;31;3;07;332;Mauvaisin;233;4;237
76;Occitanie;31;2;06;333;Mauvezin;93;2;95
76;Occitanie;31;1;01;334;Mauzac;1281;23;1304
76;Occitanie;31;2;02;335;Mayrègne;25;2;27
76;Occitanie;31;2;02;336;Mazères-sur-Salat;621;12;633
76;Occitanie;31;2;02;337;Melles;89;1;90
76;Occitanie;31;3;08;338;Menville;768;23;791
76;Occitanie;31;3;08;339;Mérenvielle;486;6;492
76;Occitanie;31;3;04;340;Mervilla;269;8;277
76;Occitanie;31;3;08;341;Merville;5615;95;5710
76;Occitanie;31;2;02;342;Milhas;177;0;177
76;Occitanie;31;2;06;343;Mirambeau;63;0;63
76;Occitanie;31;2;14;344;Miramont-de-Comminges;780;10;790
76;Occitanie;31;1;01;345;Miremont;2494;32;2526
76;Occitanie;31;3;27;346;Mirepoix-sur-Tarn;1014;13;1027
76;Occitanie;31;2;06;347;Molas;167;4;171
76;Occitanie;31;2;02;348;Moncaup;39;0;39
76;Occitanie;31;1;06;349;Mondavezan;905;18;923
76;Occitanie;31;2;14;350;Mondilhan;92;1;93
76;Occitanie;31;3;03;351;Mondonville;4546;63;4609
76;Occitanie;31;3;24;352;Mondouzil;235;6;241
76;Occitanie;31;1;06;353;Monès;96;1;97
76;Occitanie;31;3;07;354;Monestrol;62;0;62
76;Occitanie;31;3;24;355;Mons;1780;52;1832
76;Occitanie;31;2;02;369;Mont-de-Galié;42;1;43
76;Occitanie;31;3;08;356;Montaigut-sur-Save;1682;42;1724
76;Occitanie;31;2;02;357;Montastruc-de-Salies;288;2;290
76;Occitanie;31;3;10;358;Montastruc-la-Conseillère;3430;95;3525
76;Occitanie;31;1;06;359;Montastruc-Savès;77;1;78
76;Occitanie;31;2;02;360;Montauban-de-Luchon;496;7;503
76;Occitanie;31;1;01;361;Montaut;506;4;510
76;Occitanie;31;1;06;362;Montberaud;211;4;215
76;Occitanie;31;2;06;363;Montbernard;222;5;227
76;Occitanie;31;3;10;364;Montberon;2925;62;2987
76;Occitanie;31;1;01;365;Montbrun-Bocage;476;11;487
76;Occitanie;31;3;07;366;Montbrun-Lauragais;611;20;631
76;Occitanie;31;1;06;367;Montclar-de-Comminges;84;5;89
76;Occitanie;31;3;13;368;Montclar-Lauragais;246;3;249
76;Occitanie;31;1;06;370;Montégut-Bourjac;135;1;136
76;Occitanie;31;3;13;371;Montégut-Lauragais;442;15;457
76;Occitanie;31;2;02;372;Montespan;455;6;461
76;Occitanie;31;2;06;373;Montesquieu-Guittaut;176;2;178
76;Occitanie;31;3;13;374;Montesquieu-Lauragais;977;13;990
76;Occitanie;31;1;01;375;Montesquieu-Volvestre;3032;69;3101
76;Occitanie;31;2;02;376;Montgaillard-de-Salies;103;3;106
76;Occitanie;31;3;13;377;Montgaillard-Lauragais;743;18;761
76;Occitanie;31;2;14;378;Montgaillard-sur-Save;84;2;86
76;Occitanie;31;1;01;379;Montgazin;197;5;202
76;Occitanie;31;3;07;380;Montgeard;487;8;495
76;Occitanie;31;3;07;381;Montgiscard;2430;57;2487
76;Occitanie;31;1;06;382;Montgras;106;1;107
76;Occitanie;31;3;10;383;Montjoire;1274;25;1299
76;Occitanie;31;3;07;384;Montlaur;1576;32;1608
76;Occitanie;31;2;14;385;Montmaurin;210;6;216
76;Occitanie;31;2;06;386;Montoulieu-Saint-Bernard;213;6;219
76;Occitanie;31;1;06;387;Montoussin;132;0;132
76;Occitanie;31;3;10;388;Montpitol;387;12;399
76;Occitanie;31;3;24;389;Montrabé;4106;77;4183
76;Occitanie;31;2;14;390;Montréjeau;2796;31;2827
76;Occitanie;31;2;02;391;Montsaunès;445;31;476
76;Occitanie;31;3;13;392;Mourvilles-Basses;75;0;75
76;Occitanie;31;3;13;393;Mourvilles-Hautes;169;14;183
76;Occitanie;31;2;02;394;Moustajon;136;3;139
76;Occitanie;31;1;09;395;Muret;24945;543;25488
76;Occitanie;31;3;07;396;Nailloux;3873;43;3916
76;Occitanie;31;2;14;397;Nénigan;65;0;65
76;Occitanie;31;2;14;398;Nizan-Gesse;87;1;88
76;Occitanie;31;1;01;399;Noé;2897;64;2961
76;Occitanie;31;3;13;400;Nogaret;83;0;83
76;Occitanie;31;3;07;401;Noueilles;401;4;405
76;Occitanie;31;3;07;402;Odars;872;31;903
76;Occitanie;31;3;08;403;Ondes;733;129;862
76;Occitanie;31;2;02;404;Oô;92;4;96
76;Occitanie;31;2;02;405;Ore;101;1;102
76;Occitanie;31;1;06;406;Palaminy;808;11;819
76;Occitanie;31;3;10;407;Paulhac;1236;29;1265
76;Occitanie;31;2;02;408;Payssous;90;3;93
76;Occitanie;31;3;04;409;Péchabou;2330;64;2394
76;Occitanie;31;3;10;410;Pechbonnieu;4425;86;4511
76;Occitanie;31;3;04;411;Pechbusque;882;21;903
76;Occitanie;31;2;14;412;Péguilhan;286;10;296
76;Occitanie;31;3;08;413;Pelleport;515;12;527
76;Occitanie;31;2;06;414;Peyrissas;85;2;87
76;Occitanie;31;2;06;415;Peyrouzet;84;2;86
76;Occitanie;31;1;01;416;Peyssies;570;6;576
76;Occitanie;31;3;21;417;Pibrac;8459;253;8712
76;Occitanie;31;3;24;418;Pin-Balma;903;18;921
76;Occitanie;31;1;06;419;Le Pin-Murelet;176;4;180
76;Occitanie;31;1;12;421;Pins-Justaret;4410;71;4481
76;Occitanie;31;1;12;420;Pinsaguel;2771;37;2808
76;Occitanie;31;1;06;422;Plagne;97;0;97
76;Occitanie;31;1;06;423;Plagnole;305;3;308
76;Occitanie;31;3;11;424;Plaisance-du-Touch;18715;360;19075
76;Occitanie;31;1;06;425;Le Plan;447;7;454
76;Occitanie;31;2;02;426;Pointis-de-Rivière;840;11;851
76;Occitanie;31;2;14;427;Pointis-Inard;924;14;938
76;Occitanie;31;1;06;428;Polastron;54;2;56
76;Occitanie;31;3;07;429;Pompertuzat;2312;38;2350
76;Occitanie;31;2;14;430;Ponlat-Taillebourg;619;16;635
76;Occitanie;31;2;02;431;Portet-d'Aspet;64;1;65
76;Occitanie;31;2;02;432;Portet-de-Luchon;39;4;43
76;Occitanie;31;1;12;433;Portet-sur-Garonne;9721;120;9841
76;Occitanie;31;2;02;434;Poubeau;76;4;80
76;Occitanie;31;1;06;435;Poucharramet;880;13;893
76;Occitanie;31;1;06;436;Pouy-de-Touges;407;10;417
76;Occitanie;31;3;07;437;Pouze;88;4;92
76;Occitanie;31;3;07;439;Préserville;707;15;722
76;Occitanie;31;2;02;440;Proupiary;73;1;74
76;Occitanie;31;3;13;441;Prunet;150;2;152
76;Occitanie;31;1;01;442;Puydaniel;518;8;526
76;Occitanie;31;2;06;443;Puymaurin;296;3;299
76;Occitanie;31;3;08;444;Puysségur;147;0;147
76;Occitanie;31;3;24;445;Quint-Fonsegrives;5674;113;5787
76;Occitanie;31;3;25;446;Ramonville-Saint-Agne;14388;337;14725
76;Occitanie;31;2;02;447;Razecueillé;37;0;37
76;Occitanie;31;3;04;448;Rebigue;478;25;503
76;Occitanie;31;2;14;449;Régades;133;4;137
76;Occitanie;31;3;13;450;Renneville;550;12;562
76;Occitanie;31;3;13;451;Revel;9582;311;9893
76;Occitanie;31;2;14;452;Rieucazé;54;0;54
76;Occitanie;31;3;13;453;Rieumajou;136;2;138
76;Occitanie;31;1;06;454;Rieumes;3509;83;3592
76;Occitanie;31;1;01;455;Rieux-Volvestre;2583;52;2635
76;Occitanie;31;2;06;456;Riolas;48;1;49
76;Occitanie;31;2;02;457;Roquefort-sur-Garonne;794;12;806
76;Occitanie;31;1;12;458;Roques;4550;52;4602
76;Occitanie;31;3;10;459;Roquesérière;689;17;706
76;Occitanie;31;1;12;460;Roquettes;4049;61;4110
76;Occitanie;31;2;02;461;Rouède;292;3;295
76;Occitanie;31;3;10;462;Rouffiac-Tolosan;1944;42;1986
76;Occitanie;31;3;13;463;Roumens;242;6;248
76;Occitanie;31;1;11;464;Sabonnères;315;4;319
76;Occitanie;31;2;02;465;Saccourvielle;15;0;15
76;Occitanie;31;1;11;466;Saiguède;790;21;811
76;Occitanie;31;3;05;467;Saint-Alban;6150;50;6200
76;Occitanie;31;2;06;468;Saint-André;223;8;231
76;Occitanie;31;1;06;469;Saint-Araille;152;5;157
76;Occitanie;31;2;02;470;Saint-Aventin;80;4;84
76;Occitanie;31;2;02;471;Saint-Béat-Lez;382;8;390
76;Occitanie;31;2;02;472;Saint-Bertrand-de-Comminges;244;6;250
76;Occitanie;31;3;08;473;Saint-Cézert;434;1;435
76;Occitanie;31;1;01;474;Saint-Christaud;244;4;248
76;Occitanie;31;1;09;475;Saint-Clar-de-Rivière;1338;25;1363
76;Occitanie;31;1;06;476;Saint-Élix-le-Château;883;19;902
76;Occitanie;31;2;06;477;Saint-Élix-Séglan;42;0;42
76;Occitanie;31;3;13;478;Saint-Félix-Lauragais;1271;34;1305
76;Occitanie;31;2;14;479;Saint-Ferréol-de-Comminges;58;1;59
76;Occitanie;31;2;06;482;Saint-Frajou;215;4;219
76;Occitanie;31;2;14;483;Saint-Gaudens;11517;565;12082
76;Occitanie;31;3;10;484;Saint-Geniès-Bellevue;2466;62;2528
76;Occitanie;31;3;13;485;Saint-Germier;111;3;114
76;Occitanie;31;1;09;486;Saint-Hilaire;1219;18;1237
76;Occitanie;31;2;14;487;Saint-Ignan;226;5;231
76;Occitanie;31;3;23;488;Saint-Jean;10694;139;10833
76;Occitanie;31;3;10;489;Saint-Jean-Lherm;371;11;382
76;Occitanie;31;3;05;490;Saint-Jory;5797;60;5857
76;Occitanie;31;3;13;491;Saint-Julia;412;13;425
76;Occitanie;31;1;01;492;Saint-Julien-sur-Garonne;553;4;557
76;Occitanie;31;2;14;493;Saint-Lary-Boujean;141;2;143
76;Occitanie;31;2;06;494;Saint-Laurent;181;1;182
76;Occitanie;31;3;07;495;Saint-Léon;1268;13;1281
76;Occitanie;31;3;10;497;Saint-Loup-Cammas;2164;45;2209
76;Occitanie;31;2;14;498;Saint-Loup-en-Comminges;36;0;36
76;Occitanie;31;1;11;499;Saint-Lys;9470;151;9621
76;Occitanie;31;2;02;500;Saint-Mamet;557;19;576
76;Occitanie;31;3;10;501;Saint-Marcel-Paulel;404;6;410
76;Occitanie;31;2;14;502;Saint-Marcet;360;9;369
76;Occitanie;31;2;02;503;Saint-Martory;981;11;992
76;Occitanie;31;2;02;504;Saint-Médard;221;11;232
76;Occitanie;31;1;06;505;Saint-Michel;318;6;324
76;Occitanie;31;3;04;506;Saint-Orens-de-Gameville;11830;204;12034
76;Occitanie;31;2;02;508;Saint-Paul-d'Oueil;34;0;34
76;Occitanie;31;3;08;507;Saint-Paul-sur-Save;1625;24;1649
76;Occitanie;31;2;02;509;Saint-Pé-d'Ardet;148;1;149
76;Occitanie;31;2;14;510;Saint-Pé-Delbosc;134;0;134
76;Occitanie;31;3;10;511;Saint-Pierre;239;8;247
76;Occitanie;31;3;13;512;Saint-Pierre-de-Lages;886;18;904
76;Occitanie;31;2;14;513;Saint-Plancard;364;6;370
76;Occitanie;31;3;13;514;Saint-Rome;51;2;53
76;Occitanie;31;3;27;515;Saint-Rustice;460;9;469
76;Occitanie;31;3;27;516;Saint-Sauveur;1766;16;1782
76;Occitanie;31;1;01;517;Saint-Sulpice-sur-Lèze;2389;42;2431
76;Occitanie;31;1;11;518;Saint-Thomas;573;15;588
76;Occitanie;31;3;13;519;Saint-Vincent;192;8;200
76;Occitanie;31;3;07;480;Sainte-Foy-d'Aigrefeuille;2011;61;2072
76;Occitanie;31;1;06;481;Sainte-Foy-de-Peyrolières;2074;47;2121
76;Occitanie;31;3;08;496;Sainte-Livrade;271;13;284
76;Occitanie;31;1;06;520;Sajas;125;3;128
76;Occitanie;31;2;02;521;Saleich;341;8;349
76;Occitanie;31;2;06;522;Salerm;56;2;58
76;Occitanie;31;2;02;523;Salies-du-Salat;1788;103;1891
76;Occitanie;31;2;02;524;Salles-et-Pratviel;133;2;135
76;Occitanie;31;1;01;525;Salles-sur-Garonne;573;15;588
76;Occitanie;31;3;13;527;La Salvetat-Lauragais;143;3;146
76;Occitanie;31;3;08;526;La Salvetat-Saint-Gilles;8321;192;8513
76;Occitanie;31;2;14;528;Saman;130;4;134
76;Occitanie;31;2;06;529;Samouillan;124;2;126
76;Occitanie;31;1;06;530;Sana;258;5;263
76;Occitanie;31;2;14;531;Sarrecave;78;0;78
76;Occitanie;31;2;14;532;Sarremezan;97;3;100
76;Occitanie;31;1;12;533;Saubens;2225;52;2277
76;Occitanie;31;3;13;534;Saussens;209;0;209
76;Occitanie;31;2;02;535;Sauveterre-de-Comminges;634;8;642
76;Occitanie;31;2;14;536;Saux-et-Pomarède;272;9;281
76;Occitanie;31;2;14;537;Savarthès;173;5;178
76;Occitanie;31;1;06;538;Savères;218;4;222
76;Occitanie;31;2;14;539;Sédeilhac;61;2;63
76;Occitanie;31;3;13;540;Ségreville;297;7;304
76;Occitanie;31;3;03;541;Seilh;3268;75;3343
76;Occitanie;31;2;02;542;Seilhan;207;3;210
76;Occitanie;31;1;06;543;Sénarens;104;2;106
76;Occitanie;31;2;02;544;Sengouagnet;206;4;210
76;Occitanie;31;2;02;545;Sepx;224;4;228
76;Occitanie;31;3;07;546;Seyre;133;3;136
76;Occitanie;31;1;09;547;Seysses;9055;119;9174
76;Occitanie;31;2;02;548;Signac;48;0;48
76;Occitanie;31;2;02;549;Sode;18;0;18
76;Occitanie;31;2;02;550;Soueich;531;10;541
76;Occitanie;31;3;13;551;Tarabel;460;7;467
76;Occitanie;31;2;06;552;Terrebasse;137;4;141
76;Occitanie;31;3;08;553;Thil;1176;28;1204
76;Occitanie;31;2;02;554;Touille;246;1;247
76;Occitanie;31;3;99;555;Toulouse;479553;5256;484809
76;Occitanie;31;3;26;557;Tournefeuille;26962;567;27529
76;Occitanie;31;2;14;556;Les Tourreilles;384;9;393
76;Occitanie;31;3;13;558;Toutens;335;4;339
76;Occitanie;31;2;02;559;Trébons-de-Luchon;5;0;5
76;Occitanie;31;3;13;560;Trébons-sur-la-Grasse;450;8;458
76;Occitanie;31;3;23;561;L' Union;11715;185;11900
76;Occitanie;31;2;02;562;Urau;123;1;124
76;Occitanie;31;3;27;563;Vacquiers;1307;35;1342
76;Occitanie;31;2;02;564;Valcabrère;143;1;144
76;Occitanie;31;2;14;565;Valentine;877;15;892
76;Occitanie;31;3;13;566;Vallègue;524;4;528
76;Occitanie;31;3;13;567;Vallesvilles;418;6;424
76;Occitanie;31;3;07;568;Varennes;271;4;275
76;Occitanie;31;3;13;569;Vaudreuille;379;10;389
76;Occitanie;31;3;13;570;Vaux;295;5;300
76;Occitanie;31;3;13;571;Vendine;284;4;288
76;Occitanie;31;1;12;572;Venerque;2548;80;2628
76;Occitanie;31;3;10;573;Verfeil;3595;70;3665
76;Occitanie;31;1;12;574;Vernet;2871;32;2903
76;Occitanie;31;3;04;575;Vieille-Toulouse;1169;37;1206
76;Occitanie;31;3;13;576;Vieillevigne;339;7;346
76;Occitanie;31;3;08;577;Vignaux;135;0;135
76;Occitanie;31;3;04;578;Vigoulet-Auzil;904;30;934
76;Occitanie;31;3;10;579;Villariès;792;13;805
76;Occitanie;31;1;12;580;Villate;920;19;939
76;Occitanie;31;3;27;581;Villaudric;1545;27;1572
76;Occitanie;31;3;13;582;Villefranche-de-Lauragais;4519;61;4580
76;Occitanie;31;3;27;583;Villematier;1053;24;1077
76;Occitanie;31;3;27;584;Villemur-sur-Tarn;5888;105;5993
76;Occitanie;31;2;14;585;Villeneuve-de-Rivière;1794;42;1836
76;Occitanie;31;2;14;586;Villeneuve-Lécussan;556;4;560
76;Occitanie;31;3;27;587;Villeneuve-lès-Bouloc;1622;21;1643
76;Occitanie;31;3;26;588;Villeneuve-Tolosane;9720;118;9838
76;Occitanie;31;3;13;589;Villenouvelle;1391;18;1409
76;Occitanie;32;3;01;001;Aignan;734;71;805
76;Occitanie;32;1;05;002;Ansan;78;6;84
76;Occitanie;32;1;10;003;Antras;47;2;49
76;Occitanie;32;3;01;004;Arblade-le-Bas;147;2;149
76;Occitanie;32;2;12;005;Arblade-le-Haut;309;5;314
76;Occitanie;32;2;11;007;Ardizas;216;5;221
76;Occitanie;32;3;16;008;Armentieux;76;0;76
76;Occitanie;32;3;16;009;Armous-et-Cau;86;5;91
76;Occitanie;32;3;03;010;Arrouède;110;0;110
76;Occitanie;32;1;05;012;Aubiet;1083;34;1117
76;Occitanie;32;1;99;013;Auch;21935;1132;23067
76;Occitanie;32;1;10;014;Augnax;109;5;114
76;Occitanie;32;3;03;015;Aujan-Mournède;89;1;90
76;Occitanie;32;1;13;016;Auradé;671;16;687
76;Occitanie;32;3;01;017;Aurensan;134;5;139
76;Occitanie;32;1;03;018;Aurimont;205;2;207
76;Occitanie;32;3;03;468;Aussos;81;1;82
76;Occitanie;32;1;06;019;Auterive;520;17;537
76;Occitanie;32;3;15;020;Aux-Aussat;275;8;283
76;Occitanie;32;2;11;021;Avensac;77;1;78
76;Occitanie;32;3;01;022;Avéron-Bergelle;143;6;149
76;Occitanie;32;2;09;023;Avezan;107;3;110
76;Occitanie;32;1;07;024;Ayguetinte;161;3;164
76;Occitanie;32;2;12;025;Ayzieu;159;6;165
76;Occitanie;32;2;11;026;Bajonnette;106;0;106
76;Occitanie;32;3;01;027;Barcelonne-du-Gers;1372;38;1410
76;Occitanie;32;3;15;028;Barcugnan;107;6;113
76;Occitanie;32;3;04;029;Barran;673;20;693
76;Occitanie;32;3;16;030;Bars;135;4;139
76;Occitanie;32;2;08;031;Bascous;170;3;173
76;Occitanie;32;3;16;032;Bassoues;321;6;327
76;Occitanie;32;1;08;033;Bazian;112;0;112
76;Occitanie;32;3;15;034;Bazugues;57;3;60
76;Occitanie;32;2;07;035;Beaucaire;256;4;260
76;Occitanie;32;3;16;036;Beaumarchés;664;40;704
76;Occitanie;32;2;02;037;Beaumont;136;6;142
76;Occitanie;32;1;11;038;Beaupuy;188;7;195
76;Occitanie;32;3;15;039;Beccas;118;4;122
76;Occitanie;32;1;03;040;Bédéchan;152;1;153
76;Occitanie;32;3;03;041;Bellegarde;190;0;190
76;Occitanie;32;3;15;042;Belloc-Saint-Clamens;129;5;134
76;Occitanie;32;1;08;043;Belmont;150;4;154
76;Occitanie;32;2;07;044;Béraut;331;9;340
76;Occitanie;32;3;15;045;Berdoues;424;20;444
76;Occitanie;32;3;01;046;Bernède;204;1;205
76;Occitanie;32;2;14;047;Berrac;103;1;104
76;Occitanie;32;1;17;048;Betcave-Aguin;85;3;88
76;Occitanie;32;2;12;049;Bétous;88;3;91
76;Occitanie;32;3;15;050;Betplan;99;4;103
76;Occitanie;32;1;17;051;Bézéril;128;2;130
76;Occitanie;32;1;08;052;Bezolles;139;4;143
76;Occitanie;32;3;03;053;Bézues-Bajon;190;4;194
76;Occitanie;32;1;10;054;Biran;386;9;395
76;Occitanie;32;2;09;055;Bivès;133;2;135
76;Occitanie;32;1;05;056;Blanquefort;57;2;59
76;Occitanie;32;2;07;057;Blaziert;134;3;137
76;Occitanie;32;3;16;058;Blousson-Sérian;42;2;44
76;Occitanie;32;1;10;059;Bonas;133;2;135
76;Occitanie;32;3;06;060;Boucagnères;209;4;213
76;Occitanie;32;1;03;061;Boulaur;179;2;181
76;Occitanie;32;2;12;062;Bourrouillan;157;2;159
76;Occitanie;32;3;01;063;Bouzon-Gellenave;193;4;197
76;Occitanie;32;2;02;064;Bretagne-d'Armagnac;422;12;434
76;Occitanie;32;3;04;065;Le Brouilh-Monbert;228;3;231
76;Occitanie;32;2;09;066;Brugnens;256;11;267
76;Occitanie;32;3;03;067;Cabas-Loumassès;52;4;56
76;Occitanie;32;2;09;068;Cadeilhan;139;3;142
76;Occitanie;32;1;17;069;Cadeillan;61;3;64
76;Occitanie;32;3;01;070;Cahuzac-sur-Adour;223;3;226
76;Occitanie;32;1;08;071;Caillavet;204;10;214
76;Occitanie;32;1;08;072;Callian;47;1;48
76;Occitanie;32;2;12;073;Campagne-d'Armagnac;224;3;227
76;Occitanie;32;2;02;075;Cassaigne;221;5;226
76;Occitanie;32;1;03;076;Castelnau-Barbarens;528;10;538
76;Occitanie;32;3;16;077;Castelnau-d'Anglès;89;3;92
76;Occitanie;32;2;09;078;Castelnau-d'Arbieu;234;9;243
76;Occitanie;32;2;02;079;Castelnau d'Auzan Labarrère;1252;30;1282
76;Occitanie;32;2;07;080;Castelnau-sur-l'Auvignon;147;6;153
76;Occitanie;32;3;01;081;Castelnavet;130;2;132
76;Occitanie;32;2;14;082;Castéra-Lectourois;350;7;357
76;Occitanie;32;1;07;083;Castéra-Verduzan;988;19;1007
76;Occitanie;32;2;09;084;Castéron;52;3;55
76;Occitanie;32;2;14;085;Castet-Arrouy;186;7;193
76;Occitanie;32;3;15;086;Castex;86;2;88
76;Occitanie;32;2;12;087;Castex-d'Armagnac;112;4;116
76;Occitanie;32;1;08;088;Castillon-Debats;323;0;323
76;Occitanie;32;1;10;089;Castillon-Massas;246;6;252
76;Occitanie;32;1;17;090;Castillon-Savès;344;8;352
76;Occitanie;32;1;10;091;Castin;343;16;359
76;Occitanie;32;2;11;092;Catonvielle;97;4;101
76;Occitanie;32;3;01;093;Caumont;102;7;109
76;Occitanie;32;2;12;094;Caupenne-d'Armagnac;424;16;440
76;Occitanie;32;2;07;095;Caussens;619;13;632
76;Occitanie;32;2;12;096;Cazaubon;1629;34;1663
76;Occitanie;32;1;08;097;Cazaux-d'Anglès;119;2;121
76;Occitanie;32;1;17;098;Cazaux-Savès;315;5;320
76;Occitanie;32;3;16;099;Cazaux-Villecomtal;71;3;74
76;Occitanie;32;2;02;100;Cazeneuve;148;4;152
76;Occitanie;32;2;09;101;Céran;222;3;225
76;Occitanie;32;2;09;102;Cézan;223;2;225
76;Occitanie;32;3;03;103;Chélan;175;8;183
76;Occitanie;32;3;15;104;Clermont-Pouyguillès;159;3;162
76;Occitanie;32;1;13;105;Clermont-Savès;326;9;335
76;Occitanie;32;2;11;106;Cologne;914;66;980
76;Occitanie;32;2;07;107;Condom;6530;205;6735
76;Occitanie;32;3;01;108;Corneillan;146;10;156
76;Occitanie;32;3;16;109;Couloumé-Mondebat;194;5;199
76;Occitanie;32;2;08;110;Courrensan;403;7;410
76;Occitanie;32;3;16;111;Courties;56;0;56
76;Occitanie;32;1;10;112;Crastes;254;15;269
76;Occitanie;32;2;12;113;Cravencères;92;3;95
76;Occitanie;32;3;03;114;Cuélas;124;5;129
76;Occitanie;32;2;08;115;Dému;337;3;340
76;Occitanie;32;3;15;116;Duffort;141;4;145
76;Occitanie;32;1;10;117;Duran;870;29;899
76;Occitanie;32;3;06;118;Durban;154;5;159
76;Occitanie;32;2;02;119;Eauze;3918;74;3992
76;Occitanie;32;2;11;120;Encausse;427;9;436
76;Occitanie;32;1;13;121;Endoufielle;527;17;544
76;Occitanie;32;3;03;122;Esclassan-Labastide;358;10;368
76;Occitanie;32;1;11;123;Escornebœuf;565;11;576
76;Occitanie;32;1;17;124;Espaon;190;0;190
76;Occitanie;32;2;12;125;Espas;123;1;124
76;Occitanie;32;3;15;126;Estampes;159;1;160
76;Occitanie;32;2;12;127;Estang;638;13;651
76;Occitanie;32;3;16;128;Estipouy;208;14;222
76;Occitanie;32;2;09;129;Estramiac;142;0;142
76;Occitanie;32;3;03;130;Faget-Abbatial;218;1;219
76;Occitanie;32;2;14;131;Flamarens;150;2;152
76;Occitanie;32;2;09;132;Fleurance;6021;111;6132
76;Occitanie;32;2;02;133;Fourcès;260;2;262
76;Occitanie;32;1;13;134;Frégouville;346;6;352
76;Occitanie;32;3;01;135;Fustérouau;134;5;139
76;Occitanie;32;3;16;136;Galiax;161;5;166
76;Occitanie;32;1;17;138;Garravet;157;4;161
76;Occitanie;32;2;09;139;Gaudonville;111;1;112
76;Occitanie;32;1;17;140;Gaujac;66;0;66
76;Occitanie;32;1;17;141;Gaujan;118;1;119
76;Occitanie;32;2;09;142;Gavarret-sur-Aulouste;142;2;144
76;Occitanie;32;2;14;143;Gazaupouy;296;12;308
76;Occitanie;32;1;08;144;Gazax-et-Baccarisse;80;0;80
76;Occitanie;32;3;01;145;Gée-Rivière;46;2;48
76;Occitanie;32;2;14;146;Gimbrède;283;4;287
76;Occitanie;32;1;11;147;Gimont;3032;50;3082
76;Occitanie;32;1;11;148;Giscaro;100;0;100
76;Occitanie;32;2;02;149;Gondrin;1194;32;1226
76;Occitanie;32;2;09;150;Goutz;205;6;211
76;Occitanie;32;3;01;151;Goux;67;0;67
76;Occitanie;32;3;15;152;Haget;331;11;342
76;Occitanie;32;3;06;153;Haulies;165;1;166
76;Occitanie;32;2;11;154;Homps;104;1;105
76;Occitanie;32;2;12;155;Le Houga;1170;51;1221
76;Occitanie;32;3;15;156;Idrac-Respaillès;214;4;218
76;Occitanie;32;1;05;157;L' Isle-Arné;180;2;182
76;Occitanie;32;2;14;158;L' Isle-Bouzon;245;10;255
76;Occitanie;32;3;16;159;L' Isle-de-Noé;543;16;559
76;Occitanie;32;1;13;160;L' Isle-Jourdain;8851;218;9069
76;Occitanie;32;3;16;161;Izotges;105;4;109
76;Occitanie;32;1;10;162;Jegun;1144;49;1193
76;Occitanie;32;3;16;163;Jû-Belloc;296;9;305
76;Occitanie;32;3;16;164;Juillac;121;2;123
76;Occitanie;32;1;05;165;Juilles;220;6;226
76;Occitanie;32;1;08;166;Justian;118;1;119
76;Occitanie;32;3;15;167;Laas;298;6;304
76;Occitanie;32;3;03;169;Labarthe;153;4;157
76;Occitanie;32;3;01;170;Labarthète;140;5;145
76;Occitanie;32;1;17;171;Labastide-Savès;174;1;175
76;Occitanie;32;3;15;172;Labéjan;303;15;318
76;Occitanie;32;2;11;173;Labrihe;209;8;217
76;Occitanie;32;3;16;174;Ladevèze-Rivière;214;4;218
76;Occitanie;32;3;16;175;Ladevèze-Ville;236;7;243
76;Occitanie;32;2;14;176;Lagarde;119;5;124
76;Occitanie;32;3;15;177;Lagarde-Hachan;164;6;170
76;Occitanie;32;2;07;178;Lagardère;78;3;81
76;Occitanie;32;2;02;180;Lagraulet-du-Gers;575;10;585
76;Occitanie;32;3;15;181;Laguian-Mazous;241;3;244
76;Occitanie;32;1;17;182;Lahas;180;3;183
76;Occitanie;32;1;05;183;Lahitte;247;11;258
76;Occitanie;32;2;09;184;Lalanne;137;3;140
76;Occitanie;32;3;03;185;Lalanne-Arqué;156;4;160
76;Occitanie;32;3;03;186;Lamaguère;81;0;81
76;Occitanie;32;3;15;187;Lamazère;121;7;128
76;Occitanie;32;2;09;188;Lamothe-Goas;78;3;81
76;Occitanie;32;2;12;191;Lanne-Soubiran;141;1;142
76;Occitanie;32;2;12;189;Lannemaignan;109;3;112
76;Occitanie;32;2;08;190;Lannepax;494;6;500
76;Occitanie;32;3;01;192;Lannux;245;9;254
76;Occitanie;32;2;12;193;Larée;230;3;233
76;Occitanie;32;2;02;194;Larressingle;214;7;221
76;Occitanie;32;2;14;195;Larroque-Engalin;49;2;51
76;Occitanie;32;2;07;196;Larroque-Saint-Sernin;167;0;167
76;Occitanie;32;2;02;197;Larroque-sur-l'Osse;236;6;242
76;Occitanie;32;1;03;198;Lartigue;183;4;187
76;Occitanie;32;3;16;199;Lasserade;197;9;206
76;Occitanie;32;3;04;200;Lasséran;385;11;396
76;Occitanie;32;3;06;201;Lasseube-Propre;340;7;347
76;Occitanie;32;2;12;202;Laujuzan;279;15;294
76;Occitanie;32;2;02;203;Lauraët;252;3;255
76;Occitanie;32;1;10;204;Lavardens;385;11;396
76;Occitanie;32;3;16;205;Laveraët;108;1;109
76;Occitanie;32;1;17;206;Laymont;210;3;213
76;Occitanie;32;1;05;207;Leboulin;346;18;364
76;Occitanie;32;2;14;208;Lectoure;3664;363;4027
76;Occitanie;32;3;01;209;Lelin-Lapujolle;278;3;281
76;Occitanie;32;1;13;210;Lias;620;13;633
76;Occitanie;32;2;12;211;Lias-d'Armagnac;196;7;203
76;Occitanie;32;2;14;212;Ligardes;217;4;221
76;Occitanie;32;1;17;213;Lombez;2134;36;2170
76;Occitanie;32;2;12;214;Loubédat;107;3;110
76;Occitanie;32;3;15;215;Loubersan;152;11;163
76;Occitanie;32;3;03;216;Lourties-Monbrun;158;1;159
76;Occitanie;32;3;16;217;Louslitges;67;2;69
76;Occitanie;32;3;01;218;Loussous-Débat;62;0;62
76;Occitanie;32;1;08;219;Lupiac;300;14;314
76;Occitanie;32;2;12;220;Luppé-Violles;157;3;160
76;Occitanie;32;1;05;221;Lussan;228;4;232
76;Occitanie;32;2;12;222;Magnan;239;2;241
76;Occitanie;32;2;09;223;Magnas;59;31;90
76;Occitanie;32;2;07;224;Maignaut-Tauzia;260;2;262
76;Occitanie;32;3;15;225;Malabat;114;5;119
76;Occitanie;32;3;15;226;Manas-Bastanous;81;4;85
76;Occitanie;32;2;12;227;Manciet;805;26;831
76;Occitanie;32;3;03;228;Manent-Montané;92;1;93
76;Occitanie;32;2;11;229;Mansempuy;86;1;87
76;Occitanie;32;2;02;230;Mansencôme;46;4;50
76;Occitanie;32;1;08;231;Marambat;442;13;455
76;Occitanie;32;2;11;232;Maravat;43;0;43
76;Occitanie;32;3;16;233;Marciac;1224;86;1310
76;Occitanie;32;1;13;234;Marestaing;319;7;326
76;Occitanie;32;3;01;235;Margouët-Meymes;176;8;184
76;Occitanie;32;2;12;236;Marguestau;75;0;75
76;Occitanie;32;1;05;237;Marsan;471;11;482
76;Occitanie;32;3;15;238;Marseillan;90;3;93
76;Occitanie;32;2;14;239;Marsolan;458;11;469
76;Occitanie;32;2;14;241;Mas-d'Auvignon;171;6;177
76;Occitanie;32;3;16;240;Mascaras;64;4;68
76;Occitanie;32;3;03;242;Masseube;1520;451;1971
76;Occitanie;32;2;12;243;Mauléon-d'Armagnac;275;3;278
76;Occitanie;32;3;01;244;Maulichères;169;4;173
76;Occitanie;32;3;01;245;Maumusson-Laguian;145;7;152
76;Occitanie;32;2;12;246;Maupas;203;3;206
76;Occitanie;32;1;11;247;Maurens;311;7;318
76;Occitanie;32;2;09;248;Mauroux;135;4;139
76;Occitanie;32;2;11;249;Mauvezin;2179;48;2227
76;Occitanie;32;3;03;250;Meilhan;80;1;81
76;Occitanie;32;1;10;251;Mérens;64;0;64
76;Occitanie;32;3;15;252;Miélan;1139;23;1162
76;Occitanie;32;2;14;253;Miradoux;501;8;509
76;Occitanie;32;3;15;254;Miramont-d'Astarac;347;13;360
76;Occitanie;32;2;09;255;Miramont-Latour;163;3;166
76;Occitanie;32;3;15;256;Mirande;3468;326;3794
76;Occitanie;32;1;08;257;Mirannes;66;4;70
76;Occitanie;32;1;10;258;Mirepoix;225;4;229
76;Occitanie;32;3;03;260;Monbardon;83;4;87
76;Occitanie;32;1;17;261;Monblanc;351;8;359
76;Occitanie;32;2;11;262;Monbrun;385;12;397
76;Occitanie;32;3;15;263;Moncassin;134;3;137
76;Occitanie;32;2;12;264;Monclar;192;2;194
76;Occitanie;32;3;16;265;Monclar-sur-Losse;106;2;108
76;Occitanie;32;3;03;266;Moncorneil-Grazan;153;1;154
76;Occitanie;32;3;03;267;Monferran-Plavès;120;2;122
76;Occitanie;32;1;13;268;Monferran-Savès;803;29;832
76;Occitanie;32;2;11;269;Monfort;492;5;497
76;Occitanie;32;1;17;270;Mongausy;75;2;77
76;Occitanie;32;2;12;271;Monguilhem;309;13;322
76;Occitanie;32;3;03;272;Monlaur-Bernet;161;4;165
76;Occitanie;32;3;16;273;Monlezun;199;10;209
76;Occitanie;32;2;12;274;Monlezun-d'Armagnac;201;3;204
76;Occitanie;32;3;16;275;Monpardiac;45;1;46
76;Occitanie;32;3;03;280;Mont-d'Astarac;104;2;106
76;Occitanie;32;3;15;281;Mont-de-Marrast;111;5;116
76;Occitanie;32;1;17;276;Montadet;74;1;75
76;Occitanie;32;1;17;277;Montamat;136;2;138
76;Occitanie;32;3;15;278;Montaut;117;7;124
76;Occitanie;32;1;10;279;Montaut-les-Créneaux;708;20;728
76;Occitanie;32;1;05;282;Montégut;667;12;679
76;Occitanie;32;3;15;283;Montégut-Arros;293;6;299
76;Occitanie;32;1;17;284;Montégut-Savès;64;1;65
76;Occitanie;32;3;16;285;Montesquiou;581;22;603
76;Occitanie;32;2;09;286;Montestruc-sur-Gers;705;11;716
76;Occitanie;32;3;03;287;Monties;77;1;78
76;Occitanie;32;1;05;288;Montiron;140;3;143
76;Occitanie;32;1;17;289;Montpézat;242;3;245
76;Occitanie;32;2;02;290;Montréal;1168;35;1203
76;Occitanie;32;2;12;291;Mormès;121;2;123
76;Occitanie;32;2;02;292;Mouchan;406;14;420
76;Occitanie;32;3;16;293;Mouchès;75;4;79
76;Occitanie;32;1;08;294;Mourède;86;3;89
76;Occitanie;32;1;17;295;Nizas;149;9;158
76;Occitanie;32;2;12;296;Nogaro;2009;165;2174
76;Occitanie;32;1;17;297;Noilhan;375;11;386
76;Occitanie;32;1;05;298;Nougaroulet;375;12;387
76;Occitanie;32;2;08;299;Noulens;104;0;104
76;Occitanie;32;3;06;300;Orbessan;288;3;291
76;Occitanie;32;1;10;301;Ordan-Larroque;916;36;952
76;Occitanie;32;3;06;302;Ornézan;229;9;238
76;Occitanie;32;3;16;303;Pallanne;59;4;63
76;Occitanie;32;3;03;304;Panassac;288;9;297
76;Occitanie;32;2;12;305;Panjas;400;5;405
76;Occitanie;32;2;09;306;Pauilhac;618;49;667
76;Occitanie;32;1;04;307;Pavie;2486;116;2602
76;Occitanie;32;1;17;308;Pébées;103;2;105
76;Occitanie;32;1;17;309;Pellefigue;116;5;121
76;Occitanie;32;2;12;310;Perchède;118;1;119
76;Occitanie;32;2;14;311;Pergain-Taillac;302;4;306
76;Occitanie;32;1;06;312;Pessan;671;14;685
76;Occitanie;32;2;09;313;Pessoulens;142;4;146
76;Occitanie;32;2;14;314;Peyrecave;72;5;77
76;Occitanie;32;1;08;315;Peyrusse-Grande;164;5;169
76;Occitanie;32;1;10;316;Peyrusse-Massas;104;3;107
76;Occitanie;32;1;08;317;Peyrusse-Vieille;70;0;70
76;Occitanie;32;2;09;318;Pis;113;2;115
76;Occitanie;32;3;16;319;Plaisance;1461;28;1489
76;Occitanie;32;2;14;320;Plieux;134;6;140
76;Occitanie;32;1;17;321;Polastron;272;5;277
76;Occitanie;32;1;17;322;Pompiac;191;3;194
76;Occitanie;32;3;15;323;Ponsampère;126;6;132
76;Occitanie;32;3;03;324;Ponsan-Soubiran;90;4;94
76;Occitanie;32;3;03;327;Pouy-Loubrin;84;0;84
76;Occitanie;32;2;14;328;Pouy-Roquelaure;122;6;128
76;Occitanie;32;3;01;325;Pouydraguin;131;2;133
76;Occitanie;32;3;16;326;Pouylebon;139;5;144
76;Occitanie;32;2;09;329;Préchac;171;3;174
76;Occitanie;32;3;16;330;Préchac-sur-Adour;199;5;204
76;Occitanie;32;1;10;331;Preignan;1276;33;1309
76;Occitanie;32;1;08;332;Préneron;135;3;138
76;Occitanie;32;3;01;333;Projan;184;0;184
76;Occitanie;32;1;13;334;Pujaudran;1523;39;1562
76;Occitanie;32;1;10;335;Puycasquier;447;10;457
76;Occitanie;32;1;17;336;Puylausic;163;9;172
76;Occitanie;32;2;09;337;Puységur;75;1;76
76;Occitanie;32;2;08;338;Ramouzens;163;3;166
76;Occitanie;32;1;11;339;Razengues;239;9;248
76;Occitanie;32;2;12;340;Réans;293;5;298
76;Occitanie;32;2;09;341;Réjaumont;240;4;244
76;Occitanie;32;3;16;342;Ricourt;67;1;68
76;Occitanie;32;1;08;343;Riguepeu;204;7;211
76;Occitanie;32;3;01;344;Riscle;1830;100;1930
76;Occitanie;32;2;14;345;La Romieu;575;15;590
76;Occitanie;32;1;08;346;Roquebrune;213;4;217
76;Occitanie;32;1;10;347;Roquefort;296;5;301
76;Occitanie;32;1;10;348;Roquelaure;572;23;595
76;Occitanie;32;2;11;349;Roquelaure-Saint-Aubin;118;5;123
76;Occitanie;32;2;07;350;Roquepine;36;2;38
76;Occitanie;32;1;08;351;Roques;104;0;104
76;Occitanie;32;1;08;352;Rozès;124;2;126
76;Occitanie;32;1;17;353;Sabaillan;148;7;155
76;Occitanie;32;3;01;354;Sabazan;136;1;137
76;Occitanie;32;3;15;355;Sadeillan;87;2;89
76;Occitanie;32;1;17;356;Saint-André;123;1;124
76;Occitanie;32;2;14;358;Saint-Antoine;198;4;202
76;Occitanie;32;2;11;359;Saint-Antonin;159;5;164
76;Occitanie;32;1;08;360;Saint-Arailles;135;4;139
76;Occitanie;32;3;03;361;Saint-Arroman;137;7;144
76;Occitanie;32;3;16;362;Saint-Aunix-Lengros;142;3;145
76;Occitanie;32;2;14;364;Saint-Avit-Frandat;99;2;101
76;Occitanie;32;3;03;365;Saint-Blancard;341;6;347
76;Occitanie;32;2;11;366;Saint-Brès;76;3;79
76;Occitanie;32;1;05;467;Saint-Caprais;139;0;139
76;Occitanie;32;3;16;367;Saint-Christaud;65;2;67
76;Occitanie;32;2;09;370;Saint-Clar;1015;67;1082
76;Occitanie;32;2;09;371;Saint-Créac;83;1;84
76;Occitanie;32;2;11;372;Saint-Cricq;293;4;297
76;Occitanie;32;1;17;374;Saint-Élix-d'Astarac;189;6;195
76;Occitanie;32;3;15;375;Saint-Élix-Theux;106;0;106
76;Occitanie;32;2;11;377;Saint-Georges;180;2;182
76;Occitanie;32;3;01;378;Saint-Germé;500;6;506
76;Occitanie;32;2;11;379;Saint-Germier;210;7;217
76;Occitanie;32;2;12;380;Saint-Griède;140;10;150
76;Occitanie;32;3;04;381;Saint-Jean-le-Comtal;411;21;432
76;Occitanie;32;1;08;382;Saint-Jean-Poutge;322;14;336
76;Occitanie;32;3;16;383;Saint-Justin;130;6;136
76;Occitanie;32;1;10;384;Saint-Lary;279;6;285
76;Occitanie;32;2;09;385;Saint-Léonard;182;1;183
76;Occitanie;32;1;17;386;Saint-Lizier-du-Planté;138;1;139
76;Occitanie;32;1;17;387;Saint-Loube;96;2;98
76;Occitanie;32;3;15;389;Saint-Martin;459;21;480
76;Occitanie;32;2;12;390;Saint-Martin-d'Armagnac;247;7;254
76;Occitanie;32;2;14;391;Saint-Martin-de-Goyne;126;6;132
76;Occitanie;32;1;03;392;Saint-Martin-Gimois;91;1;92
76;Occitanie;32;3;15;393;Saint-Maur;142;5;147
76;Occitanie;32;3;15;394;Saint-Médard;327;5;332
76;Occitanie;32;2;14;396;Saint-Mézard;225;2;227
76;Occitanie;32;3;15;397;Saint-Michel;253;16;269
76;Occitanie;32;3;01;398;Saint-Mont;320;10;330
76;Occitanie;32;2;11;399;Saint-Orens;80;3;83
76;Occitanie;32;2;07;400;Saint-Orens-Pouy-Petit;193;7;200
76;Occitanie;32;3;15;401;Saint-Ost;87;2;89
76;Occitanie;32;1;08;402;Saint-Paul-de-Baïse;102;3;105
76;Occitanie;32;1;08;403;Saint-Pierre-d'Aubézies;67;1;68
76;Occitanie;32;2;07;404;Saint-Puy;600;14;614
76;Occitanie;32;1;11;406;Saint-Sauvy;340;6;346
76;Occitanie;32;1;17;407;Saint-Soulan;160;4;164
76;Occitanie;32;2;11;357;Sainte-Anne;117;1;118
76;Occitanie;32;3;15;363;Sainte-Aurence-Cazaux;101;1;102
76;Occitanie;32;1;10;368;Sainte-Christie;553;11;564
76;Occitanie;32;2;12;369;Sainte-Christie-d'Armagnac;373;13;386
76;Occitanie;32;3;15;373;Sainte-Dode;209;9;218
76;Occitanie;32;2;11;376;Sainte-Gemme;119;4;123
76;Occitanie;32;1;11;388;Sainte-Marie;429;8;437
76;Occitanie;32;2;14;395;Sainte-Mère;215;4;219
76;Occitanie;32;2;09;405;Sainte-Radegonde;182;4;186
76;Occitanie;32;2;12;408;Salles-d'Armagnac;131;4;135
76;Occitanie;32;3;03;409;Samaran;90;0;90
76;Occitanie;32;1;17;410;Samatan;2370;103;2473
76;Occitanie;32;3;06;411;Sansan;99;3;102
76;Occitanie;32;1;03;412;Saramon;825;16;841
76;Occitanie;32;3;03;413;Sarcos;75;2;77
76;Occitanie;32;3;01;414;Sarragachies;237;6;243
76;Occitanie;32;3;15;415;Sarraguzan;86;2;88
76;Occitanie;32;2;11;416;Sarrant;368;14;382
76;Occitanie;32;2;09;417;La Sauvetat;368;12;380
76;Occitanie;32;1;17;418;Sauveterre;265;63;328
76;Occitanie;32;3;15;419;Sauviac;108;3;111
76;Occitanie;32;1;17;420;Sauvimont;66;2;68
76;Occitanie;32;1;17;421;Savignac-Mona;138;1;139
76;Occitanie;32;3;16;422;Scieurac-et-Flourès;40;1;41
76;Occitanie;32;2;08;423;Séailles;45;1;46
76;Occitanie;32;3;01;424;Ségos;229;8;237
76;Occitanie;32;1;13;425;Ségoufielle;1138;27;1165
76;Occitanie;32;3;03;426;Seissan;1091;11;1102
76;Occitanie;32;3;16;427;Sembouès;60;1;61
76;Occitanie;32;1;03;428;Sémézies-Cachan;66;4;70
76;Occitanie;32;2;14;429;Sempesserre;294;5;299
76;Occitanie;32;3;03;430;Sère;77;0;77
76;Occitanie;32;2;11;431;Sérempuy;34;0;34
76;Occitanie;32;1;17;432;Seysses-Savès;239;2;241
76;Occitanie;32;1;17;433;Simorre;710;17;727
76;Occitanie;32;2;12;434;Sion;103;3;106
76;Occitanie;32;2;11;435;Sirac;169;9;178
76;Occitanie;32;2;11;436;Solomiac;481;10;491
76;Occitanie;32;2;12;437;Sorbets;226;6;232
76;Occitanie;32;3;03;438;Tachoires;98;0;98
76;Occitanie;32;3;01;439;Tarsac;168;2;170
76;Occitanie;32;3;16;440;Tasque;255;6;261
76;Occitanie;32;2;09;441;Taybosc;62;0;62
76;Occitanie;32;3;01;443;Termes-d'Armagnac;191;3;194
76;Occitanie;32;2;14;442;Terraube;372;4;376
76;Occitanie;32;2;11;444;Thoux;253;7;260
76;Occitanie;32;3;16;445;Tieste-Uragnoux;167;4;171
76;Occitanie;32;3;16;446;Tillac;281;7;288
76;Occitanie;32;1;03;447;Tirent-Pontéjac;89;1;90
76;Occitanie;32;2;11;448;Touget;512;17;529
76;Occitanie;32;2;12;449;Toujouse;248;2;250
76;Occitanie;32;3;16;450;Tourdun;117;4;121
76;Occitanie;32;1;17;451;Tournan;182;2;184
76;Occitanie;32;2;09;452;Tournecoupe;263;8;271
76;Occitanie;32;1;10;453;Tourrenquets;113;6;119
76;Occitanie;32;3;03;454;Traversères;71;3;74
76;Occitanie;32;3;16;455;Troncens;184;4;188
76;Occitanie;32;1;08;456;Tudelle;59;0;59
76;Occitanie;32;2;09;457;Urdens;292;5;297
76;Occitanie;32;2;12;458;Urgosse;239;3;242
76;Occitanie;32;2;07;459;Valence-sur-Baïse;1135;19;1154
76;Occitanie;32;3;01;460;Vergoignan;299;8;307
76;Occitanie;32;3;01;461;Verlus;105;3;108
76;Occitanie;32;1;08;462;Vic-Fezensac;3474;84;3558
76;Occitanie;32;3;01;463;Viella;511;12;523
76;Occitanie;32;3;15;464;Villecomtal-sur-Arros;853;19;872
76;Occitanie;32;1;17;465;Villefranche;128;5;133
76;Occitanie;32;3;15;466;Viozan;113;2;115
75;Nouvelle-Aquitaine;33;5;21;001;Abzac;1937;26;1963
75;Nouvelle-Aquitaine;33;3;27;002;Aillas;822;14;836
75;Nouvelle-Aquitaine;33;2;26;003;Ambarès-et-Lagrave;16344;136;16480
75;Nouvelle-Aquitaine;33;2;26;004;Ambès;3128;20;3148
75;Nouvelle-Aquitaine;33;6;01;005;Andernos-les-Bains;11645;252;11897
75;Nouvelle-Aquitaine;33;1;13;006;Anglade;947;11;958
75;Nouvelle-Aquitaine;33;3;15;007;Arbanats;1272;6;1278
75;Nouvelle-Aquitaine;33;6;32;009;Arcachon;11284;244;11528
75;Nouvelle-Aquitaine;33;4;30;010;Arcins;490;3;493
75;Nouvelle-Aquitaine;33;6;01;011;Arès;6308;123;6431
75;Nouvelle-Aquitaine;33;4;30;012;Arsac;3592;46;3638
75;Nouvelle-Aquitaine;33;5;21;014;Les Artigues-de-Lussac;1108;21;1129
75;Nouvelle-Aquitaine;33;2;17;013;Artigues-près-Bordeaux;8639;89;8728
75;Nouvelle-Aquitaine;33;5;16;015;Arveyres;1960;40;2000
75;Nouvelle-Aquitaine;33;5;16;016;Asques;460;9;469
75;Nouvelle-Aquitaine;33;3;29;017;Aubiac;272;11;283
75;Nouvelle-Aquitaine;33;6;01;019;Audenge;7993;112;8105
75;Nouvelle-Aquitaine;33;3;27;020;Auriolles;140;0;140
75;Nouvelle-Aquitaine;33;3;27;021;Auros;1020;14;1034
75;Nouvelle-Aquitaine;33;4;30;022;Avensan;2953;40;2993
75;Nouvelle-Aquitaine;33;2;08;023;Ayguemorte-les-Graves;1256;15;1271
75;Nouvelle-Aquitaine;33;3;27;024;Bagas;295;9;304
75;Nouvelle-Aquitaine;33;3;12;025;Baigneaux;438;4;442
75;Nouvelle-Aquitaine;33;3;15;026;Balizac;503;5;508
75;Nouvelle-Aquitaine;33;3;27;027;Barie;296;9;305
75;Nouvelle-Aquitaine;33;5;10;028;Baron;1153;16;1169
75;Nouvelle-Aquitaine;33;6;15;029;Le Barp;5506;81;5587
75;Nouvelle-Aquitaine;33;3;15;030;Barsac;2063;22;2085
75;Nouvelle-Aquitaine;33;3;27;031;Bassanne;120;5;125
75;Nouvelle-Aquitaine;33;2;17;032;Bassens;7278;58;7336
75;Nouvelle-Aquitaine;33;2;11;033;Baurech;871;6;877
75;Nouvelle-Aquitaine;33;5;21;034;Bayas;456;3;459
75;Nouvelle-Aquitaine;33;1;13;035;Bayon-sur-Gironde;704;2;706
75;Nouvelle-Aquitaine;33;3;29;036;Bazas;4772;264;5036
75;Nouvelle-Aquitaine;33;2;08;037;Beautiran;2267;38;2305
75;Nouvelle-Aquitaine;33;4;22;038;Bégadan;909;8;917
75;Nouvelle-Aquitaine;33;2;96;039;Bègles;28601;354;28955
75;Nouvelle-Aquitaine;33;3;12;040;Béguey;1187;13;1200
75;Nouvelle-Aquitaine;33;6;15;042;Belin-Béliet;5529;52;5581
75;Nouvelle-Aquitaine;33;3;12;043;Bellebat;257;1;258
75;Nouvelle-Aquitaine;33;3;12;044;Bellefond;225;6;231
75;Nouvelle-Aquitaine;33;5;10;045;Belvès-de-Castillon;333;8;341
75;Nouvelle-Aquitaine;33;3;29;046;Bernos-Beaulac;1104;23;1127
75;Nouvelle-Aquitaine;33;1;13;047;Berson;1795;31;1826
75;Nouvelle-Aquitaine;33;3;27;048;Berthez;263;7;270
75;Nouvelle-Aquitaine;33;2;26;049;Beychac-et-Caillau;2227;24;2251
75;Nouvelle-Aquitaine;33;3;29;050;Bieujac;620;8;628
75;Nouvelle-Aquitaine;33;6;01;051;Biganos;10706;117;10823
75;Nouvelle-Aquitaine;33;5;16;052;Les Billaux;1191;36;1227
75;Nouvelle-Aquitaine;33;3;29;053;Birac;231;1;232
75;Nouvelle-Aquitaine;33;3;27;054;Blaignac;287;5;292
75;Nouvelle-Aquitaine;33;4;22;055;Blaignan-Prignac;469;5;474
75;Nouvelle-Aquitaine;33;2;25;056;Blanquefort;15833;585;16418
75;Nouvelle-Aquitaine;33;3;27;057;Blasimon;906;19;925
75;Nouvelle-Aquitaine;33;1;13;058;Blaye;4835;112;4947
75;Nouvelle-Aquitaine;33;2;12;059;Blésignac;303;6;309
75;Nouvelle-Aquitaine;33;3;29;060;Bommes;465;67;532
75;Nouvelle-Aquitaine;33;2;11;061;Bonnetan;947;17;964
75;Nouvelle-Aquitaine;33;5;21;062;Bonzac;747;12;759
75;Nouvelle-Aquitaine;33;2;97;063;Bordeaux;254436;3368;257804
75;Nouvelle-Aquitaine;33;5;10;064;Bossugan;39;0;39
75;Nouvelle-Aquitaine;33;2;09;065;Bouliac;3631;70;3701
75;Nouvelle-Aquitaine;33;3;27;066;Bourdelles;93;1;94
75;Nouvelle-Aquitaine;33;1;13;067;Bourg;2243;42;2285
75;Nouvelle-Aquitaine;33;3;29;068;Bourideys;79;3;82
75;Nouvelle-Aquitaine;33;2;07;069;Le Bouscat;23824;266;24090
75;Nouvelle-Aquitaine;33;4;30;070;Brach;667;1;668
75;Nouvelle-Aquitaine;33;5;10;071;Branne;1288;17;1305
75;Nouvelle-Aquitaine;33;3;27;072;Brannens;239;4;243
75;Nouvelle-Aquitaine;33;1;13;073;Braud-et-Saint-Louis;1605;13;1618
75;Nouvelle-Aquitaine;33;2;08;213;La Brède;4280;486;4766
75;Nouvelle-Aquitaine;33;3;27;074;Brouqueyran;194;4;198
75;Nouvelle-Aquitaine;33;2;07;075;Bruges;17924;163;18087
75;Nouvelle-Aquitaine;33;3;15;076;Budos;787;14;801
75;Nouvelle-Aquitaine;33;2;08;077;Cabanac-et-Villagrains;2393;25;2418
75;Nouvelle-Aquitaine;33;5;10;078;Cabara;513;12;525
75;Nouvelle-Aquitaine;33;5;16;079;Cadarsac;357;6;363
75;Nouvelle-Aquitaine;33;2;08;080;Cadaujac;6097;62;6159
75;Nouvelle-Aquitaine;33;3;12;081;Cadillac;2789;28;2817
75;Nouvelle-Aquitaine;33;5;16;082;Cadillac-en-Fronsadais;1249;15;1264
75;Nouvelle-Aquitaine;33;2;11;083;Camarsac;1004;13;1017
75;Nouvelle-Aquitaine;33;2;11;084;Cambes;1625;17;1642
75;Nouvelle-Aquitaine;33;2;11;085;Camblanes-et-Meynac;2885;142;3027
75;Nouvelle-Aquitaine;33;5;10;086;Camiac-et-Saint-Denis;362;5;367
75;Nouvelle-Aquitaine;33;3;27;087;Camiran;412;5;417
75;Nouvelle-Aquitaine;33;5;21;088;Camps-sur-l'Isle;603;10;613
75;Nouvelle-Aquitaine;33;1;13;089;Campugnan;496;9;505
75;Nouvelle-Aquitaine;33;2;23;090;Canéjan;5539;66;5605
75;Nouvelle-Aquitaine;33;3;12;093;Capian;721;17;738
75;Nouvelle-Aquitaine;33;5;27;094;Caplong;225;7;232
75;Nouvelle-Aquitaine;33;3;29;095;Captieux;1281;22;1303
75;Nouvelle-Aquitaine;33;2;26;096;Carbon-Blanc;8091;81;8172
75;Nouvelle-Aquitaine;33;4;30;097;Carcans;2413;46;2459
75;Nouvelle-Aquitaine;33;3;12;098;Cardan;498;2;500
75;Nouvelle-Aquitaine;33;2;11;099;Carignan-de-Bordeaux;3859;40;3899
75;Nouvelle-Aquitaine;33;1;13;100;Cars;1187;21;1208
75;Nouvelle-Aquitaine;33;1;13;101;Cartelègue;1244;21;1265
75;Nouvelle-Aquitaine;33;3;27;102;Casseuil;398;4;402
75;Nouvelle-Aquitaine;33;3;27;103;Castelmoron-d'Albret;53;0;53
75;Nouvelle-Aquitaine;33;4;30;104;Castelnau-de-Médoc;4778;41;4819
75;Nouvelle-Aquitaine;33;3;27;105;Castelviel;219;12;231
75;Nouvelle-Aquitaine;33;3;89;106;Castets et Castillon;1452;18;1470
75;Nouvelle-Aquitaine;33;5;10;108;Castillon-la-Bataille;3166;36;3202
75;Nouvelle-Aquitaine;33;2;08;109;Castres-Gironde;2352;19;2371
75;Nouvelle-Aquitaine;33;3;12;111;Caudrot;1180;16;1196
75;Nouvelle-Aquitaine;33;3;27;112;Caumont;147;2;149
75;Nouvelle-Aquitaine;33;3;29;113;Cauvignac;169;4;173
75;Nouvelle-Aquitaine;33;1;20;114;Cavignac;2065;15;2080
75;Nouvelle-Aquitaine;33;3;29;115;Cazalis;236;1;237
75;Nouvelle-Aquitaine;33;3;29;116;Cazats;426;8;434
75;Nouvelle-Aquitaine;33;3;27;117;Cazaugitat;244;3;247
75;Nouvelle-Aquitaine;33;2;11;118;Cénac;1907;32;1939
75;Nouvelle-Aquitaine;33;2;09;119;Cenon;24729;246;24975
75;Nouvelle-Aquitaine;33;3;15;120;Cérons;2084;21;2105
75;Nouvelle-Aquitaine;33;3;12;121;Cessac;194;2;196
75;Nouvelle-Aquitaine;33;2;23;122;Cestas;16922;259;17181
75;Nouvelle-Aquitaine;33;1;20;123;Cézac;2571;33;2604
75;Nouvelle-Aquitaine;33;5;21;124;Chamadelle;733;4;737
75;Nouvelle-Aquitaine;33;4;22;125;Cissac-Médoc;2146;24;2170
75;Nouvelle-Aquitaine;33;1;20;126;Civrac-de-Blaye;857;20;877
75;Nouvelle-Aquitaine;33;4;22;128;Civrac-en-Médoc;692;6;698
75;Nouvelle-Aquitaine;33;5;10;127;Civrac-sur-Dordogne;223;5;228
75;Nouvelle-Aquitaine;33;3;27;129;Cleyrac;160;1;161
75;Nouvelle-Aquitaine;33;3;27;130;Coimères;1034;27;1061
75;Nouvelle-Aquitaine;33;3;12;131;Coirac;202;2;204
75;Nouvelle-Aquitaine;33;1;13;132;Comps;540;8;548
75;Nouvelle-Aquitaine;33;5;10;133;Coubeyrac;71;1;72
75;Nouvelle-Aquitaine;33;4;22;134;Couquèques;272;5;277
75;Nouvelle-Aquitaine;33;3;12;135;Courpiac;125;2;127
75;Nouvelle-Aquitaine;33;3;27;136;Cours-de-Monségur;284;4;288
75;Nouvelle-Aquitaine;33;3;29;137;Cours-les-Bains;222;4;226
75;Nouvelle-Aquitaine;33;5;21;138;Coutras;8606;156;8762
75;Nouvelle-Aquitaine;33;3;27;139;Coutures;96;4;100
75;Nouvelle-Aquitaine;33;2;11;140;Créon;4697;74;4771
75;Nouvelle-Aquitaine;33;2;11;141;Croignon;642;7;649
75;Nouvelle-Aquitaine;33;1;20;142;Cubnezais;1499;25;1524
75;Nouvelle-Aquitaine;33;1;20;143;Cubzac-les-Ponts;2466;25;2491
75;Nouvelle-Aquitaine;33;3;29;144;Cudos;802;163;965
75;Nouvelle-Aquitaine;33;2;11;145;Cursan;650;17;667
75;Nouvelle-Aquitaine;33;4;30;146;Cussac-Fort-Médoc;2240;27;2267
75;Nouvelle-Aquitaine;33;5;10;147;Daignac;476;6;482
75;Nouvelle-Aquitaine;33;5;10;148;Dardenac;85;3;88
75;Nouvelle-Aquitaine;33;3;27;149;Daubèze;153;1;154
75;Nouvelle-Aquitaine;33;3;27;150;Dieulivol;344;2;346
75;Nouvelle-Aquitaine;33;1;20;151;Donnezac;899;18;917
75;Nouvelle-Aquitaine;33;3;12;152;Donzac;118;5;123
75;Nouvelle-Aquitaine;33;5;10;153;Doulezon;265;4;269
75;Nouvelle-Aquitaine;33;5;21;154;Les Églisottes-et-Chalaures;2152;111;2263
75;Nouvelle-Aquitaine;33;3;29;155;Escaudes;153;3;156
75;Nouvelle-Aquitaine;33;3;12;156;Escoussans;299;8;307
75;Nouvelle-Aquitaine;33;5;10;157;Espiet;776;15;791
75;Nouvelle-Aquitaine;33;3;27;158;Les Esseintes;238;6;244
75;Nouvelle-Aquitaine;33;1;13;159;Étauliers;1493;15;1508
75;Nouvelle-Aquitaine;33;5;27;160;Eynesse;587;17;604
75;Nouvelle-Aquitaine;33;1;13;161;Eyrans;773;9;782
75;Nouvelle-Aquitaine;33;2;25;162;Eysines;23462;290;23752
75;Nouvelle-Aquitaine;33;3;12;163;Faleyras;424;6;430
75;Nouvelle-Aquitaine;33;3;29;164;Fargues;1652;33;1685
75;Nouvelle-Aquitaine;33;2;11;165;Fargues-Saint-Hilaire;2889;30;2919
75;Nouvelle-Aquitaine;33;5;21;166;Le Fieu;523;4;527
75;Nouvelle-Aquitaine;33;5;10;168;Flaujagues;591;9;600
75;Nouvelle-Aquitaine;33;2;09;167;Floirac;17463;91;17554
75;Nouvelle-Aquitaine;33;3;27;169;Floudès;108;3;111
75;Nouvelle-Aquitaine;33;3;27;170;Fontet;793;16;809
75;Nouvelle-Aquitaine;33;3;27;171;Fossès-et-Baleyssac;224;3;227
75;Nouvelle-Aquitaine;33;1;13;172;Fours;318;8;326
75;Nouvelle-Aquitaine;33;5;21;173;Francs;189;7;196
75;Nouvelle-Aquitaine;33;5;16;174;Fronsac;1153;34;1187
75;Nouvelle-Aquitaine;33;3;12;175;Frontenac;731;10;741
75;Nouvelle-Aquitaine;33;3;12;176;Gabarnac;365;4;369
75;Nouvelle-Aquitaine;33;4;22;177;Gaillan-en-Médoc;2323;25;2348
75;Nouvelle-Aquitaine;33;3;29;178;Gajac;380;4;384
75;Nouvelle-Aquitaine;33;5;16;179;Galgon;3014;51;3065
75;Nouvelle-Aquitaine;33;3;29;180;Gans;188;8;196
75;Nouvelle-Aquitaine;33;5;10;181;Gardegan-et-Tourtirac;281;12;293
75;Nouvelle-Aquitaine;33;1;13;182;Gauriac;748;16;764
75;Nouvelle-Aquitaine;33;1;20;183;Gauriaguet;1283;14;1297
75;Nouvelle-Aquitaine;33;1;20;184;Générac;541;11;552
75;Nouvelle-Aquitaine;33;5;10;185;Génissac;1948;34;1982
75;Nouvelle-Aquitaine;33;5;10;186;Gensac;771;10;781
75;Nouvelle-Aquitaine;33;3;27;187;Gironde-sur-Dropt;1261;24;1285
75;Nouvelle-Aquitaine;33;3;29;188;Giscos;180;3;183
75;Nouvelle-Aquitaine;33;3;12;189;Gornac;435;10;445
75;Nouvelle-Aquitaine;33;3;29;190;Goualade;91;1;92
75;Nouvelle-Aquitaine;33;5;21;191;Gours;571;3;574
75;Nouvelle-Aquitaine;33;2;24;192;Gradignan;25552;412;25964
75;Nouvelle-Aquitaine;33;4;22;193;Grayan-et-l'Hôpital;1371;19;1390
75;Nouvelle-Aquitaine;33;5;10;194;Grézillac;695;15;710
75;Nouvelle-Aquitaine;33;3;29;195;Grignols;1207;8;1215
75;Nouvelle-Aquitaine;33;5;10;196;Guillac;163;4;167
75;Nouvelle-Aquitaine;33;3;15;197;Guillos;450;6;456
75;Nouvelle-Aquitaine;33;5;21;198;Guîtres;1589;33;1622
75;Nouvelle-Aquitaine;33;6;14;199;Gujan-Mestras;21152;450;21602
75;Nouvelle-Aquitaine;33;2;18;200;Le Haillan;11018;179;11197
75;Nouvelle-Aquitaine;33;2;12;201;Haux;827;16;843
75;Nouvelle-Aquitaine;33;3;15;202;Hostens;1329;19;1348
75;Nouvelle-Aquitaine;33;4;30;203;Hourtin;3506;50;3556
75;Nouvelle-Aquitaine;33;3;27;204;Hure;513;8;521
75;Nouvelle-Aquitaine;33;3;15;205;Illats;1407;20;1427
75;Nouvelle-Aquitaine;33;2;08;206;Isle-Saint-Georges;522;3;525
75;Nouvelle-Aquitaine;33;5;16;207;Izon;5810;65;5875
75;Nouvelle-Aquitaine;33;4;22;208;Jau-Dignac-et-Loirac;973;10;983
75;Nouvelle-Aquitaine;33;5;10;209;Jugazan;298;4;302
75;Nouvelle-Aquitaine;33;5;10;210;Juillac;240;4;244
75;Nouvelle-Aquitaine;33;4;30;211;Labarde;591;2;593
75;Nouvelle-Aquitaine;33;3;29;212;Labescau;117;1;118
75;Nouvelle-Aquitaine;33;4;30;214;Lacanau;4914;71;4985
75;Nouvelle-Aquitaine;33;3;12;215;Ladaux;195;6;201
75;Nouvelle-Aquitaine;33;3;27;216;Lados;174;5;179
75;Nouvelle-Aquitaine;33;5;21;218;Lagorce;1667;16;1683
75;Nouvelle-Aquitaine;33;5;16;222;Lalande-de-Pomerol;655;15;670
75;Nouvelle-Aquitaine;33;4;30;220;Lamarque;1308;13;1321
75;Nouvelle-Aquitaine;33;3;27;221;Lamothe-Landerron;1226;40;1266
75;Nouvelle-Aquitaine;33;5;16;219;La Lande-de-Fronsac;2412;24;2436
75;Nouvelle-Aquitaine;33;3;27;223;Landerrouat;208;3;211
75;Nouvelle-Aquitaine;33;3;27;224;Landerrouet-sur-Ségur;97;0;97
75;Nouvelle-Aquitaine;33;3;15;225;Landiras;2227;37;2264
75;Nouvelle-Aquitaine;33;3;12;226;Langoiran;2152;31;2183
75;Nouvelle-Aquitaine;33;3;29;227;Langon;7375;156;7531
75;Nouvelle-Aquitaine;33;1;13;228;Lansac;739;7;746
75;Nouvelle-Aquitaine;33;6;01;229;Lanton;6912;131;7043
75;Nouvelle-Aquitaine;33;5;21;230;Lapouyade;498;10;508
75;Nouvelle-Aquitaine;33;3;12;231;Laroque;279;8;287
75;Nouvelle-Aquitaine;33;3;29;232;Lartigue;40;0;40
75;Nouvelle-Aquitaine;33;1;20;233;Laruscade;2765;20;2785
75;Nouvelle-Aquitaine;33;2;11;234;Latresne;3497;146;3643
75;Nouvelle-Aquitaine;33;3;29;235;Lavazan;227;2;229
75;Nouvelle-Aquitaine;33;6;01;236;Lège-Cap-Ferret;8409;175;8584
75;Nouvelle-Aquitaine;33;3;29;237;Léogeats;805;20;825
75;Nouvelle-Aquitaine;33;2;08;238;Léognan;10372;174;10546
75;Nouvelle-Aquitaine;33;3;29;239;Lerm-et-Musset;482;5;487
75;Nouvelle-Aquitaine;33;4;22;240;Lesparre-Médoc;5801;99;5900
75;Nouvelle-Aquitaine;33;3;12;241;Lestiac-sur-Garonne;580;8;588
75;Nouvelle-Aquitaine;33;5;27;242;Les Lèves-et-Thoumeyragues;557;10;567
75;Nouvelle-Aquitaine;33;5;16;243;Libourne;24845;555;25400
75;Nouvelle-Aquitaine;33;3;29;244;Lignan-de-Bazas;409;8;417
75;Nouvelle-Aquitaine;33;2;11;245;Lignan-de-Bordeaux;822;15;837
75;Nouvelle-Aquitaine;33;5;27;246;Ligueux;166;7;173
75;Nouvelle-Aquitaine;33;3;27;247;Listrac-de-Durèze;171;3;174
75;Nouvelle-Aquitaine;33;4;30;248;Listrac-Médoc;2764;38;2802
75;Nouvelle-Aquitaine;33;2;17;249;Lormont;23538;333;23871
75;Nouvelle-Aquitaine;33;3;27;250;Loubens;301;8;309
75;Nouvelle-Aquitaine;33;3;15;251;Louchats;724;9;733
75;Nouvelle-Aquitaine;33;2;11;252;Loupes;795;11;806
75;Nouvelle-Aquitaine;33;3;12;253;Loupiac;1112;11;1123
75;Nouvelle-Aquitaine;33;3;27;254;Loupiac-de-la-Réole;497;8;505
75;Nouvelle-Aquitaine;33;3;29;255;Lucmau;241;8;249
75;Nouvelle-Aquitaine;33;2;25;256;Ludon-Médoc;4771;41;4812
75;Nouvelle-Aquitaine;33;5;10;257;Lugaignac;479;6;485
75;Nouvelle-Aquitaine;33;3;12;258;Lugasson;295;7;302
75;Nouvelle-Aquitaine;33;5;16;259;Lugon-et-l'Île-du-Carnay;1281;23;1304
75;Nouvelle-Aquitaine;33;6;15;260;Lugos;927;20;947
75;Nouvelle-Aquitaine;33;5;21;261;Lussac;1261;38;1299
75;Nouvelle-Aquitaine;33;2;30;262;Macau;4225;24;4249
75;Nouvelle-Aquitaine;33;2;11;263;Madirac;245;4;249
75;Nouvelle-Aquitaine;33;5;21;264;Maransin;1016;10;1026
75;Nouvelle-Aquitaine;33;1;20;266;Marcenais;772;18;790
75;Nouvelle-Aquitaine;33;6;14;555;Marcheprime;4724;54;4778
75;Nouvelle-Aquitaine;33;4;30;268;Margaux-Cantenac;2965;43;3008
75;Nouvelle-Aquitaine;33;5;27;269;Margueron;397;4;401
75;Nouvelle-Aquitaine;33;3;29;270;Marimbault;186;8;194
75;Nouvelle-Aquitaine;33;3;29;271;Marions;208;2;210
75;Nouvelle-Aquitaine;33;1;20;272;Marsas;1204;22;1226
75;Nouvelle-Aquitaine;33;2;19;273;Martignas-sur-Jalle;7386;125;7511
75;Nouvelle-Aquitaine;33;2;08;274;Martillac;3067;37;3104
75;Nouvelle-Aquitaine;33;3;12;275;Martres;113;1;114
75;Nouvelle-Aquitaine;33;3;29;276;Masseilles;145;5;150
75;Nouvelle-Aquitaine;33;3;27;277;Massugas;227;6;233
75;Nouvelle-Aquitaine;33;3;27;278;Mauriac;244;5;249
75;Nouvelle-Aquitaine;33;3;29;279;Mazères;761;10;771
75;Nouvelle-Aquitaine;33;1;13;280;Mazion;525;4;529
75;Nouvelle-Aquitaine;33;2;98;281;Mérignac;70105;710;70815
75;Nouvelle-Aquitaine;33;3;27;282;Mérignas;341;4;345
75;Nouvelle-Aquitaine;33;3;27;283;Mesterrieux;222;3;225
75;Nouvelle-Aquitaine;33;6;14;284;Mios;9959;119;10078
75;Nouvelle-Aquitaine;33;1;13;285;Mombrier;423;8;431
75;Nouvelle-Aquitaine;33;3;27;287;Mongauzy;595;5;600
75;Nouvelle-Aquitaine;33;3;12;288;Monprimblanc;300;6;306
75;Nouvelle-Aquitaine;33;3;27;289;Monségur;1584;72;1656
75;Nouvelle-Aquitaine;33;5;21;290;Montagne;1524;139;1663
75;Nouvelle-Aquitaine;33;3;27;291;Montagoudin;181;4;185
75;Nouvelle-Aquitaine;33;3;12;292;Montignac;139;8;147
75;Nouvelle-Aquitaine;33;2;17;293;Montussan;3212;48;3260
75;Nouvelle-Aquitaine;33;3;27;294;Morizès;545;8;553
75;Nouvelle-Aquitaine;33;5;16;295;Mouillac;88;9;97
75;Nouvelle-Aquitaine;33;5;10;296;Mouliets-et-Villemartin;1061;15;1076
75;Nouvelle-Aquitaine;33;4;30;297;Moulis-en-Médoc;1830;33;1863
75;Nouvelle-Aquitaine;33;5;10;298;Moulon;999;18;1017
75;Nouvelle-Aquitaine;33;3;12;299;Mourens;385;8;393
75;Nouvelle-Aquitaine;33;4;22;300;Naujac-sur-Mer;1090;16;1106
75;Nouvelle-Aquitaine;33;5;10;301;Naujan-et-Postiac;580;7;587
75;Nouvelle-Aquitaine;33;5;21;302;Néac;386;12;398
75;Nouvelle-Aquitaine;33;5;10;303;Nérigean;839;15;854
75;Nouvelle-Aquitaine;33;3;27;304;Neuffons;150;4;154
75;Nouvelle-Aquitaine;33;3;29;305;Le Nizan;520;11;531
75;Nouvelle-Aquitaine;33;3;27;306;Noaillac;466;6;472
75;Nouvelle-Aquitaine;33;3;29;307;Noaillan;1679;37;1716
75;Nouvelle-Aquitaine;33;3;12;308;Omet;296;2;298
75;Nouvelle-Aquitaine;33;4;22;309;Ordonnac;510;7;517
75;Nouvelle-Aquitaine;33;3;15;310;Origne;182;2;184
75;Nouvelle-Aquitaine;33;3;12;311;Paillet;1213;25;1238
75;Nouvelle-Aquitaine;33;2;25;312;Parempuyre;8709;80;8789
75;Nouvelle-Aquitaine;33;4;22;314;Pauillac;4841;104;4945
75;Nouvelle-Aquitaine;33;5;21;315;Les Peintures;1583;19;1602
75;Nouvelle-Aquitaine;33;3;27;316;Pellegrue;1099;18;1117
75;Nouvelle-Aquitaine;33;5;20;317;Périssac;1198;17;1215
75;Nouvelle-Aquitaine;33;2;99;318;Pessac;63808;706;64514
75;Nouvelle-Aquitaine;33;5;10;319;Pessac-sur-Dordogne;449;9;458
75;Nouvelle-Aquitaine;33;5;21;320;Petit-Palais-et-Cornemps;723;11;734
75;Nouvelle-Aquitaine;33;1;20;321;Peujard;2173;27;2200
75;Nouvelle-Aquitaine;33;2;25;322;Le Pian-Médoc;6649;138;6787
75;Nouvelle-Aquitaine;33;3;12;323;Le Pian-sur-Garonne;852;17;869
75;Nouvelle-Aquitaine;33;5;27;324;Pineuilh;4394;114;4508
75;Nouvelle-Aquitaine;33;1;13;325;Plassac;885;21;906
75;Nouvelle-Aquitaine;33;1;13;326;Pleine-Selve;219;5;224
75;Nouvelle-Aquitaine;33;3;15;327;Podensac;3215;48;3263
75;Nouvelle-Aquitaine;33;5;16;328;Pomerol;607;13;620
75;Nouvelle-Aquitaine;33;3;29;329;Pompéjac;260;7;267
75;Nouvelle-Aquitaine;33;2;11;330;Pompignac;2980;51;3031
75;Nouvelle-Aquitaine;33;3;27;331;Pondaurat;470;14;484
75;Nouvelle-Aquitaine;33;5;21;332;Porchères;881;9;890
75;Nouvelle-Aquitaine;33;4;30;333;Le Porge;3185;47;3232
75;Nouvelle-Aquitaine;33;3;12;008;Porte-de-Benauge;505;8;513
75;Nouvelle-Aquitaine;33;3;15;334;Portets;2702;33;2735
75;Nouvelle-Aquitaine;33;2;11;335;Le Pout;603;7;610
75;Nouvelle-Aquitaine;33;3;29;336;Préchac;1010;11;1021
75;Nouvelle-Aquitaine;33;3;15;337;Preignac;2140;34;2174
75;Nouvelle-Aquitaine;33;1;13;339;Prignac-et-Marcamps;1379;29;1408
75;Nouvelle-Aquitaine;33;1;13;341;Pugnac;2288;31;2319
75;Nouvelle-Aquitaine;33;5;21;342;Puisseguin;856;22;878
75;Nouvelle-Aquitaine;33;5;10;344;Pujols;538;6;544
75;Nouvelle-Aquitaine;33;3;15;343;Pujols-sur-Ciron;780;15;795
75;Nouvelle-Aquitaine;33;3;27;345;Le Puy;403;4;407
75;Nouvelle-Aquitaine;33;3;27;346;Puybarban;423;6;429
75;Nouvelle-Aquitaine;33;5;21;347;Puynormand;302;7;309
75;Nouvelle-Aquitaine;33;4;22;348;Queyrac;1382;13;1395
75;Nouvelle-Aquitaine;33;2;11;349;Quinsac;2189;22;2211
75;Nouvelle-Aquitaine;33;5;10;350;Rauzan;1211;27;1238
75;Nouvelle-Aquitaine;33;1;13;351;Reignac;1599;31;1630
75;Nouvelle-Aquitaine;33;3;27;352;La Réole;4356;85;4441
75;Nouvelle-Aquitaine;33;3;27;353;Rimons;192;4;196
75;Nouvelle-Aquitaine;33;5;27;354;Riocaud;181;8;189
75;Nouvelle-Aquitaine;33;3;12;355;Rions;1556;20;1576
75;Nouvelle-Aquitaine;33;5;16;356;La Rivière;423;1;424
75;Nouvelle-Aquitaine;33;3;29;357;Roaillan;1700;29;1729
75;Nouvelle-Aquitaine;33;3;12;358;Romagne;460;16;476
75;Nouvelle-Aquitaine;33;3;27;359;Roquebrune;280;3;283
75;Nouvelle-Aquitaine;33;5;27;360;La Roquille;328;3;331
75;Nouvelle-Aquitaine;33;3;27;361;Ruch;600;10;610
75;Nouvelle-Aquitaine;33;5;21;362;Sablons;1314;16;1330
75;Nouvelle-Aquitaine;33;2;11;363;Sadirac;4244;36;4280
75;Nouvelle-Aquitaine;33;5;16;364;Saillans;403;4;407
75;Nouvelle-Aquitaine;33;5;16;365;Saint-Aignan;207;9;216
75;Nouvelle-Aquitaine;33;1;20;366;Saint-André-de-Cubzac;11464;163;11627
75;Nouvelle-Aquitaine;33;3;12;367;Saint-André-du-Bois;434;5;439
75;Nouvelle-Aquitaine;33;5;27;369;Saint-André-et-Appelles;686;12;698
75;Nouvelle-Aquitaine;33;1;13;370;Saint-Androny;551;8;559
75;Nouvelle-Aquitaine;33;3;27;372;Saint-Antoine-du-Queyret;59;2;61
75;Nouvelle-Aquitaine;33;5;21;373;Saint-Antoine-sur-l'Isle;585;7;592
75;Nouvelle-Aquitaine;33;1;13;374;Saint-Aubin-de-Blaye;821;18;839
75;Nouvelle-Aquitaine;33;5;10;375;Saint-Aubin-de-Branne;351;6;357
75;Nouvelle-Aquitaine;33;2;28;376;Saint-Aubin-de-Médoc;7362;171;7533
75;Nouvelle-Aquitaine;33;5;27;377;Saint-Avit-de-Soulège;78;3;81
75;Nouvelle-Aquitaine;33;5;27;378;Saint-Avit-Saint-Nazaire;1469;22;1491
75;Nouvelle-Aquitaine;33;3;27;379;Saint-Brice;316;7;323
75;Nouvelle-Aquitaine;33;2;11;381;Saint-Caprais-de-Bordeaux;3222;32;3254
75;Nouvelle-Aquitaine;33;1;20;382;Saint-Christoly-de-Blaye;1973;19;1992
75;Nouvelle-Aquitaine;33;4;22;383;Saint-Christoly-Médoc;283;3;286
75;Nouvelle-Aquitaine;33;5;21;385;Saint-Christophe-de-Double;732;8;740
75;Nouvelle-Aquitaine;33;5;21;384;Saint-Christophe-des-Bardes;442;7;449
75;Nouvelle-Aquitaine;33;5;21;386;Saint-Cibard;183;6;189
75;Nouvelle-Aquitaine;33;5;21;387;Saint-Ciers-d'Abzac;1446;25;1471
75;Nouvelle-Aquitaine;33;1;13;388;Saint-Ciers-de-Canesse;825;13;838
75;Nouvelle-Aquitaine;33;1;13;389;Saint-Ciers-sur-Gironde;3012;42;3054
75;Nouvelle-Aquitaine;33;3;29;391;Saint-Côme;320;4;324
75;Nouvelle-Aquitaine;33;5;21;393;Saint-Denis-de-Pile;5535;65;5600
75;Nouvelle-Aquitaine;33;5;10;394;Saint-Émilion;1874;48;1922
75;Nouvelle-Aquitaine;33;4;22;395;Saint-Estèphe;1615;51;1666
75;Nouvelle-Aquitaine;33;5;10;396;Saint-Étienne-de-Lisse;231;5;236
75;Nouvelle-Aquitaine;33;3;27;398;Saint-Exupéry;168;1;169
75;Nouvelle-Aquitaine;33;3;27;399;Saint-Félix-de-Foncaude;288;13;301
75;Nouvelle-Aquitaine;33;3;27;400;Saint-Ferme;349;5;354
75;Nouvelle-Aquitaine;33;1;13;405;Saint-Genès-de-Blaye;485;12;497
75;Nouvelle-Aquitaine;33;5;10;406;Saint-Genès-de-Castillon;393;4;397
75;Nouvelle-Aquitaine;33;5;20;407;Saint-Genès-de-Fronsac;794;8;802
75;Nouvelle-Aquitaine;33;2;11;408;Saint-Genès-de-Lombaud;391;17;408
75;Nouvelle-Aquitaine;33;3;12;409;Saint-Genis-du-Bois;89;1;90
75;Nouvelle-Aquitaine;33;4;22;412;Saint-Germain-d'Esteuil;1234;19;1253
75;Nouvelle-Aquitaine;33;3;12;411;Saint-Germain-de-Grave;166;3;169
75;Nouvelle-Aquitaine;33;5;16;414;Saint-Germain-de-la-Rivière;386;5;391
75;Nouvelle-Aquitaine;33;5;10;413;Saint-Germain-du-Puch;2156;36;2192
75;Nouvelle-Aquitaine;33;1;20;415;Saint-Gervais;1878;18;1896
75;Nouvelle-Aquitaine;33;1;20;416;Saint-Girons-d'Aiguevives;950;19;969
75;Nouvelle-Aquitaine;33;3;27;418;Saint-Hilaire-de-la-Noaille;381;7;388
75;Nouvelle-Aquitaine;33;3;27;419;Saint-Hilaire-du-Bois;78;0;78
75;Nouvelle-Aquitaine;33;5;10;420;Saint-Hippolyte;134;1;135
75;Nouvelle-Aquitaine;33;2;19;422;Saint-Jean-d'Illac;8377;153;8530
75;Nouvelle-Aquitaine;33;5;10;421;Saint-Jean-de-Blaignac;440;7;447
75;Nouvelle-Aquitaine;33;4;22;423;Saint-Julien-Beychevelle;595;1;596
75;Nouvelle-Aquitaine;33;1;20;425;Saint-Laurent-d'Arce;1449;25;1474
75;Nouvelle-Aquitaine;33;5;10;426;Saint-Laurent-des-Combes;260;1;261
75;Nouvelle-Aquitaine;33;3;12;427;Saint-Laurent-du-Bois;250;5;255
75;Nouvelle-Aquitaine;33;3;12;428;Saint-Laurent-du-Plan;92;0;92
75;Nouvelle-Aquitaine;33;4;30;424;Saint-Laurent-Médoc;4673;84;4757
75;Nouvelle-Aquitaine;33;3;15;429;Saint-Léger-de-Balson;337;5;342
75;Nouvelle-Aquitaine;33;2;12;431;Saint-Léon;339;4;343
75;Nouvelle-Aquitaine;33;3;29;432;Saint-Loubert;228;2;230
75;Nouvelle-Aquitaine;33;2;26;433;Saint-Loubès;9509;106;9615
75;Nouvelle-Aquitaine;33;2;26;434;Saint-Louis-de-Montferrand;2153;16;2169
75;Nouvelle-Aquitaine;33;3;12;435;Saint-Macaire;2076;94;2170
75;Nouvelle-Aquitaine;33;6;15;436;Saint-Magne;967;20;987
75;Nouvelle-Aquitaine;33;5;10;437;Saint-Magne-de-Castillon;1998;12;2010
75;Nouvelle-Aquitaine;33;3;12;438;Saint-Maixant;1919;49;1968
75;Nouvelle-Aquitaine;33;1;20;439;Saint-Mariens;1602;20;1622
75;Nouvelle-Aquitaine;33;3;12;440;Saint-Martial;242;5;247
75;Nouvelle-Aquitaine;33;5;21;442;Saint-Martin-de-Laye;544;5;549
75;Nouvelle-Aquitaine;33;3;27;443;Saint-Martin-de-Lerm;143;3;146
75;Nouvelle-Aquitaine;33;3;12;444;Saint-Martin-de-Sescas;589;10;599
75;Nouvelle-Aquitaine;33;5;21;445;Saint-Martin-du-Bois;862;14;876
75;Nouvelle-Aquitaine;33;3;27;446;Saint-Martin-du-Puy;183;1;184
75;Nouvelle-Aquitaine;33;1;13;441;Saint-Martin-Lacaussade;1118;100;1218
75;Nouvelle-Aquitaine;33;2;08;448;Saint-Médard-d'Eyrans;2971;33;3004
75;Nouvelle-Aquitaine;33;5;21;447;Saint-Médard-de-Guizières;2380;23;2403
75;Nouvelle-Aquitaine;33;2;28;449;Saint-Médard-en-Jalles;31145;516;31661
75;Nouvelle-Aquitaine;33;3;29;450;Saint-Michel-de-Castelnau;237;3;240
75;Nouvelle-Aquitaine;33;5;16;451;Saint-Michel-de-Fronsac;522;4;526
75;Nouvelle-Aquitaine;33;3;27;453;Saint-Michel-de-Lapujade;233;0;233
75;Nouvelle-Aquitaine;33;3;15;452;Saint-Michel-de-Rieufret;781;12;793
75;Nouvelle-Aquitaine;33;2;08;454;Saint-Morillon;1694;21;1715
75;Nouvelle-Aquitaine;33;1;13;456;Saint-Palais;505;11;516
75;Nouvelle-Aquitaine;33;3;29;457;Saint-Pardon-de-Conques;579;14;593
75;Nouvelle-Aquitaine;33;1;13;458;Saint-Paul;935;17;952
75;Nouvelle-Aquitaine;33;5;10;459;Saint-Pey-d'Armens;196;3;199
75;Nouvelle-Aquitaine;33;5;10;460;Saint-Pey-de-Castets;622;18;640
75;Nouvelle-Aquitaine;33;5;10;461;Saint-Philippe-d'Aiguille;374;5;379
75;Nouvelle-Aquitaine;33;5;27;462;Saint-Philippe-du-Seignal;476;3;479
75;Nouvelle-Aquitaine;33;3;12;463;Saint-Pierre-d'Aurillac;1321;19;1340
75;Nouvelle-Aquitaine;33;3;12;464;Saint-Pierre-de-Bat;308;6;314
75;Nouvelle-Aquitaine;33;3;29;465;Saint-Pierre-de-Mons;1198;20;1218
75;Nouvelle-Aquitaine;33;5;10;466;Saint-Quentin-de-Baron;2442;23;2465
75;Nouvelle-Aquitaine;33;5;27;467;Saint-Quentin-de-Caplong;243;4;247
75;Nouvelle-Aquitaine;33;5;16;470;Saint-Romain-la-Virvée;873;24;897
75;Nouvelle-Aquitaine;33;4;22;471;Saint-Sauveur;1312;17;1329
75;Nouvelle-Aquitaine;33;5;21;472;Saint-Sauveur-de-Puynormand;348;7;355
75;Nouvelle-Aquitaine;33;1;20;473;Saint-Savin;3208;37;3245
75;Nouvelle-Aquitaine;33;2;08;474;Saint-Selve;3026;37;3063
75;Nouvelle-Aquitaine;33;1;13;475;Saint-Seurin-de-Bourg;404;6;410
75;Nouvelle-Aquitaine;33;4;22;476;Saint-Seurin-de-Cadourne;710;12;722
75;Nouvelle-Aquitaine;33;1;13;477;Saint-Seurin-de-Cursac;774;17;791
75;Nouvelle-Aquitaine;33;5;21;478;Saint-Seurin-sur-l'Isle;3155;26;3181
75;Nouvelle-Aquitaine;33;3;27;479;Saint-Sève;254;2;256
75;Nouvelle-Aquitaine;33;5;10;480;Saint-Sulpice-de-Faleyrens;1348;30;1378
75;Nouvelle-Aquitaine;33;3;27;481;Saint-Sulpice-de-Guilleragues;229;3;232
75;Nouvelle-Aquitaine;33;3;27;482;Saint-Sulpice-de-Pommiers;225;3;228
75;Nouvelle-Aquitaine;33;2;26;483;Saint-Sulpice-et-Cameyrac;4614;67;4681
75;Nouvelle-Aquitaine;33;3;15;484;Saint-Symphorien;1837;33;1870
75;Nouvelle-Aquitaine;33;1;13;486;Saint-Trojan;342;9;351
75;Nouvelle-Aquitaine;33;2;26;487;Saint-Vincent-de-Paul;1007;10;1017
75;Nouvelle-Aquitaine;33;5;10;488;Saint-Vincent-de-Pertignas;385;7;392
75;Nouvelle-Aquitaine;33;1;20;489;Saint-Vivien-de-Blaye;356;5;361
75;Nouvelle-Aquitaine;33;4;22;490;Saint-Vivien-de-Médoc;1777;25;1802
75;Nouvelle-Aquitaine;33;3;27;491;Saint-Vivien-de-Monségur;366;6;372
75;Nouvelle-Aquitaine;33;1;20;492;Saint-Yzan-de-Soudiac;2380;23;2403
75;Nouvelle-Aquitaine;33;4;22;493;Saint-Yzans-de-Médoc;374;31;405
75;Nouvelle-Aquitaine;33;5;10;390;Sainte-Colombe;422;6;428
75;Nouvelle-Aquitaine;33;3;12;392;Sainte-Croix-du-Mont;899;13;912
75;Nouvelle-Aquitaine;33;2;26;397;Sainte-Eulalie;4631;53;4684
75;Nouvelle-Aquitaine;33;5;10;401;Sainte-Florence;149;2;151
75;Nouvelle-Aquitaine;33;5;27;402;Sainte-Foy-la-Grande;2554;30;2584
75;Nouvelle-Aquitaine;33;3;12;403;Sainte-Foy-la-Longue;122;0;122
75;Nouvelle-Aquitaine;33;3;27;404;Sainte-Gemme;186;7;193
75;Nouvelle-Aquitaine;33;4;30;417;Sainte-Hélène;2797;46;2843
75;Nouvelle-Aquitaine;33;5;10;468;Sainte-Radegonde;457;9;466
75;Nouvelle-Aquitaine;33;5;10;485;Sainte-Terre;1883;31;1914
75;Nouvelle-Aquitaine;33;4;30;494;Salaunes;1066;10;1076
75;Nouvelle-Aquitaine;33;2;11;496;Sallebœuf;2490;38;2528
75;Nouvelle-Aquitaine;33;6;15;498;Salles;7028;129;7157
75;Nouvelle-Aquitaine;33;5;10;499;Les Salles-de-Castillon;363;10;373
75;Nouvelle-Aquitaine;33;1;13;500;Samonac;426;9;435
75;Nouvelle-Aquitaine;33;2;08;501;Saucats;3056;47;3103
75;Nouvelle-Aquitaine;33;1;20;502;Saugon;475;5;480
75;Nouvelle-Aquitaine;33;4;30;503;Saumos;532;8;540
75;Nouvelle-Aquitaine;33;3;29;504;Sauternes;790;9;799
75;Nouvelle-Aquitaine;33;2;12;505;La Sauve;1483;70;1553
75;Nouvelle-Aquitaine;33;3;27;506;Sauveterre-de-Guyenne;1788;25;1813
75;Nouvelle-Aquitaine;33;3;29;507;Sauviac;327;11;338
75;Nouvelle-Aquitaine;33;3;27;508;Savignac;633;13;646
75;Nouvelle-Aquitaine;33;5;21;509;Savignac-de-l'Isle;504;9;513
75;Nouvelle-Aquitaine;33;3;12;510;Semens;206;1;207
75;Nouvelle-Aquitaine;33;3;29;511;Sendets;334;4;338
75;Nouvelle-Aquitaine;33;3;27;512;Sigalens;381;5;386
75;Nouvelle-Aquitaine;33;3;29;513;Sillas;118;2;120
75;Nouvelle-Aquitaine;33;4;22;514;Soulac-sur-Mer;2811;24;2835
75;Nouvelle-Aquitaine;33;3;12;515;Soulignac;432;8;440
75;Nouvelle-Aquitaine;33;3;27;516;Soussac;190;5;195
75;Nouvelle-Aquitaine;33;4;30;517;Soussans;1629;16;1645
75;Nouvelle-Aquitaine;33;2;12;518;Tabanac;1082;23;1105
75;Nouvelle-Aquitaine;33;2;28;519;Le Taillan-Médoc;10096;149;10245
75;Nouvelle-Aquitaine;33;3;27;520;Taillecavat;300;3;303
75;Nouvelle-Aquitaine;33;4;22;521;Talais;741;8;749
75;Nouvelle-Aquitaine;33;2;31;522;Talence;42606;968;43574
75;Nouvelle-Aquitaine;33;3;12;523;Targon;2077;24;2101
75;Nouvelle-Aquitaine;33;5;16;524;Tarnès;325;8;333
75;Nouvelle-Aquitaine;33;1;13;525;Tauriac;1289;22;1311
75;Nouvelle-Aquitaine;33;5;21;526;Tayac;133;3;136
75;Nouvelle-Aquitaine;33;6;14;527;Le Teich;7906;153;8059
75;Nouvelle-Aquitaine;33;4;30;528;Le Temple;615;5;620
75;Nouvelle-Aquitaine;33;6;32;529;La Teste-de-Buch;26078;360;26438
75;Nouvelle-Aquitaine;33;1;13;530;Teuillac;880;9;889
75;Nouvelle-Aquitaine;33;5;10;531;Tizac-de-Curton;330;5;335
75;Nouvelle-Aquitaine;33;5;21;532;Tizac-de-Lapouyade;474;9;483
75;Nouvelle-Aquitaine;33;3;29;533;Toulenne;2640;28;2668
75;Nouvelle-Aquitaine;33;2;12;534;Le Tourne;812;11;823
75;Nouvelle-Aquitaine;33;2;11;535;Tresses;4610;51;4661
75;Nouvelle-Aquitaine;33;3;15;536;Le Tuzan;278;6;284
75;Nouvelle-Aquitaine;33;3;29;537;Uzeste;430;10;440
75;Nouvelle-Aquitaine;33;1;13;380;Val-de-Livenne;1744;21;1765
75;Nouvelle-Aquitaine;33;1;20;018;Val de Virvée;3512;41;3553
75;Nouvelle-Aquitaine;33;4;22;538;Valeyrac;548;10;558
75;Nouvelle-Aquitaine;33;5;16;539;Vayres;3956;50;4006
75;Nouvelle-Aquitaine;33;4;22;540;Vendays-Montalivet;2445;39;2484
75;Nouvelle-Aquitaine;33;4;22;541;Vensac;986;18;1004
75;Nouvelle-Aquitaine;33;5;16;542;Vérac;923;14;937
75;Nouvelle-Aquitaine;33;3;12;543;Verdelais;1031;9;1040
75;Nouvelle-Aquitaine;33;4;22;544;Le Verdon-sur-Mer;1335;11;1346
75;Nouvelle-Aquitaine;33;4;22;545;Vertheuil;1286;21;1307
75;Nouvelle-Aquitaine;33;5;10;546;Vignonet;498;11;509
75;Nouvelle-Aquitaine;33;3;29;547;Villandraut;1059;25;1084
75;Nouvelle-Aquitaine;33;5;16;548;Villegouge;1263;23;1286
75;Nouvelle-Aquitaine;33;2;33;550;Villenave-d'Ornon;34090;200;34290
75;Nouvelle-Aquitaine;33;3;12;549;Villenave-de-Rions;317;3;320
75;Nouvelle-Aquitaine;33;1;13;551;Villeneuve;395;6;401
75;Nouvelle-Aquitaine;33;3;15;552;Virelade;1062;13;1075
75;Nouvelle-Aquitaine;33;1;20;553;Virsac;1112;5;1117
75;Nouvelle-Aquitaine;33;2;17;554;Yvrac;2812;24;2836
76;Occitanie;34;1;21;001;Abeilhan;1705;24;1729
76;Occitanie;34;1;14;002;Adissan;1212;26;1238
76;Occitanie;34;1;01;003;Agde;28609;414;29023
76;Occitanie;34;1;24;004;Agel;235;4;239
76;Occitanie;34;2;11;005;Agonès;265;6;271
76;Occitanie;34;1;24;006;Aigne;269;7;276
76;Occitanie;34;1;24;007;Aigues-Vives;469;7;476
76;Occitanie;34;1;06;008;Les Aires;608;12;620
76;Occitanie;34;1;21;009;Alignan-du-Vent;1737;28;1765
76;Occitanie;34;2;09;010;Aniane;2931;38;2969
76;Occitanie;34;2;09;011;Arboras;121;3;124
76;Occitanie;34;2;09;012;Argelliers;1012;25;1037
76;Occitanie;34;2;06;013;Aspiran;1648;28;1676
76;Occitanie;34;2;23;014;Assas;1520;44;1564
76;Occitanie;34;1;24;015;Assignan;162;3;165
76;Occitanie;34;2;09;016;Aumelas;526;17;543
76;Occitanie;34;1;14;017;Aumes;483;16;499
76;Occitanie;34;1;05;018;Autignac;911;15;926
76;Occitanie;34;1;06;019;Avène;287;8;295
76;Occitanie;34;1;24;020;Azillanet;365;12;377
76;Occitanie;34;1;24;021;Babeau-Bouldoux;296;6;302
76;Occitanie;34;3;07;022;Baillargues;7754;102;7856
76;Occitanie;34;3;08;024;Balaruc-le-Vieux;2628;38;2666
76;Occitanie;34;3;08;023;Balaruc-les-Bains;6751;107;6858
76;Occitanie;34;1;04;025;Bassan;2112;32;2144
76;Occitanie;34;1;24;026;Beaufort;219;4;223
76;Occitanie;34;3;07;027;Beaulieu;1946;44;1990
76;Occitanie;34;1;06;028;Bédarieux;5791;235;6026
76;Occitanie;34;2;09;029;Bélarga;632;9;641
76;Occitanie;34;1;24;030;Berlou;203;0;203
76;Occitanie;34;1;01;031;Bessan;5069;72;5141
76;Occitanie;34;1;98;032;Béziers;77177;1276;78453
76;Occitanie;34;3;12;033;Boisseron;1989;23;2012
76;Occitanie;34;1;24;034;Boisset;40;0;40
76;Occitanie;34;2;09;035;La Boissière;1021;19;1040
76;Occitanie;34;2;11;036;Le Bosc;1345;25;1370
76;Occitanie;34;1;04;037;Boujan-sur-Libron;3378;55;3433
76;Occitanie;34;1;06;038;Le Bousquet-d'Orb;1580;24;1604
76;Occitanie;34;3;14;039;Bouzigues;1655;24;1679
76;Occitanie;34;1;06;040;Brenas;53;0;53
76;Occitanie;34;2;06;041;Brignac;888;16;904
76;Occitanie;34;2;11;042;Brissac;613;14;627
76;Occitanie;34;2;23;043;Buzignargues;337;5;342
76;Occitanie;34;1;05;044;Cabrerolles;335;10;345
76;Occitanie;34;2;14;045;Cabrières;475;20;495
76;Occitanie;34;1;24;046;Cambon-et-Salvergues;48;0;48
76;Occitanie;34;2;09;047;Campagnan;674;10;684
76;Occitanie;34;3;12;048;Campagne;316;5;321
76;Occitanie;34;1;06;049;Camplong;234;3;237
76;Occitanie;34;3;13;050;Candillargues;1742;23;1765
76;Occitanie;34;2;06;051;Canet;3503;45;3548
76;Occitanie;34;1;24;052;Capestang;3233;58;3291
76;Occitanie;34;1;06;053;Carlencas-et-Levas;130;0;130
76;Occitanie;34;1;24;054;Cassagnoles;99;2;101
76;Occitanie;34;1;24;055;Castanet-le-Haut;206;3;209
76;Occitanie;34;1;21;056;Castelnau-de-Guers;1197;23;1220
76;Occitanie;34;3;20;057;Castelnau-le-Lez;20480;330;20810
76;Occitanie;34;3;07;058;Castries;6178;102;6280
76;Occitanie;34;1;24;059;La Caunette;306;6;312
76;Occitanie;34;2;11;060;Causse-de-la-Selle;392;5;397
76;Occitanie;34;1;05;061;Causses-et-Veyran;603;8;611
76;Occitanie;34;1;05;062;Caussiniojouls;130;1;131
76;Occitanie;34;1;21;063;Caux;2560;45;2605
76;Occitanie;34;2;11;064;Le Caylar;445;10;455
76;Occitanie;34;1;24;065;Cazedarnes;601;11;612
76;Occitanie;34;2;23;066;Cazevieille;185;2;187
76;Occitanie;34;2;11;067;Cazilhac;1517;40;1557
76;Occitanie;34;1;14;068;Cazouls-d'Hérault;406;11;417
76;Occitanie;34;1;05;069;Cazouls-lès-Béziers;4987;94;5081
76;Occitanie;34;1;24;070;Cébazan;616;11;627
76;Occitanie;34;1;06;071;Ceilhes-et-Rocozels;324;5;329
76;Occitanie;34;2;11;072;Celles;32;1;33
76;Occitanie;34;1;04;073;Cers;2566;41;2607
76;Occitanie;34;1;24;074;Cessenon-sur-Orb;2284;41;2325
76;Occitanie;34;1;24;075;Cesseras;392;19;411
76;Occitanie;34;2;06;076;Ceyras;1396;27;1423
76;Occitanie;34;3;20;077;Clapiers;5478;101;5579
76;Occitanie;34;2;11;078;Claret;1563;35;1598
76;Occitanie;34;2;06;079;Clermont-l'Hérault;8852;149;9001
76;Occitanie;34;1;24;080;Colombières-sur-Orb;479;14;493
76;Occitanie;34;1;05;081;Colombiers;2484;41;2525
76;Occitanie;34;2;23;082;Combaillaux;1487;41;1528
76;Occitanie;34;1;06;083;Combes;333;6;339
76;Occitanie;34;1;03;084;Corneilhan;1717;30;1747
76;Occitanie;34;1;21;085;Coulobres;360;4;364
76;Occitanie;34;1;24;086;Courniou;609;10;619
76;Occitanie;34;3;22;087;Cournonsec;3397;29;3426
76;Occitanie;34;3;22;088;Cournonterral;6110;72;6182
76;Occitanie;34;1;24;089;Creissan;1360;26;1386
76;Occitanie;34;3;07;090;Le Crès;9321;122;9443
76;Occitanie;34;2;11;091;Le Cros;55;0;55
76;Occitanie;34;1;24;092;Cruzy;988;17;1005
76;Occitanie;34;1;06;093;Dio-et-Valquières;149;5;154
76;Occitanie;34;3;12;246;Entre-Vignes;2136;44;2180
76;Occitanie;34;1;04;094;Espondeilhan;1033;30;1063
76;Occitanie;34;3;22;095;Fabrègues;7035;123;7158
76;Occitanie;34;1;05;096;Faugères;515;10;525
76;Occitanie;34;1;24;097;Félines-Minervois;478;6;484
76;Occitanie;34;1;24;098;Ferrals-les-Montagnes;170;4;174
76;Occitanie;34;2;11;099;Ferrières-les-Verreries;50;5;55
76;Occitanie;34;1;24;100;Ferrières-Poussarou;61;5;66
76;Occitanie;34;1;21;101;Florensac;5014;85;5099
76;Occitanie;34;2;11;102;Fontanès;348;9;357
76;Occitanie;34;2;14;103;Fontès;1015;18;1033
76;Occitanie;34;1;05;104;Fos;107;0;107
76;Occitanie;34;1;05;105;Fouzilhon;244;3;247
76;Occitanie;34;2;11;106;Fozières;167;10;177
76;Occitanie;34;1;24;107;Fraisse-sur-Agout;340;4;344
76;Occitanie;34;3;08;108;Frontignan;22762;184;22946
76;Occitanie;34;1;05;109;Gabian;841;19;860
76;Occitanie;34;3;12;110;Galargues;725;27;752
76;Occitanie;34;2;11;111;Ganges;4024;101;4125
76;Occitanie;34;3;12;112;Garrigues;177;4;181
76;Occitanie;34;3;08;113;Gigean;6426;80;6506
76;Occitanie;34;2;09;114;Gignac;6200;103;6303
76;Occitanie;34;2;11;115;Gorniès;127;3;130
76;Occitanie;34;3;15;116;Grabels;8430;95;8525
76;Occitanie;34;1;06;117;Graissessac;654;19;673
76;Occitanie;34;3;13;344;La Grande-Motte;8820;105;8925
76;Occitanie;34;2;23;118;Guzargues;510;12;522
76;Occitanie;34;1;06;119;Hérépian;1518;27;1545
76;Occitanie;34;3;20;120;Jacou;6791;102;6893
76;Occitanie;34;1;06;121;Joncels;313;4;317
76;Occitanie;34;2;09;122;Jonquières;476;12;488
76;Occitanie;34;3;10;123;Juvignac;11084;119;11203
76;Occitanie;34;2;06;124;Lacoste;325;11;336
76;Occitanie;34;2;09;125;Lagamas;111;4;115
76;Occitanie;34;1;06;126;Lamalou-les-Bains;2509;19;2528
76;Occitanie;34;3;13;127;Lansargues;3112;43;3155
76;Occitanie;34;2;11;128;Laroque;1624;31;1655
76;Occitanie;34;3;10;129;Lattes;16564;241;16805
76;Occitanie;34;1;05;130;Laurens;1702;29;1731
76;Occitanie;34;2;11;131;Lauret;599;18;617
76;Occitanie;34;2;11;132;Lauroux;200;2;202
76;Occitanie;34;2;11;133;Lavalette;62;0;62
76;Occitanie;34;3;10;134;Lavérune;3237;53;3290
76;Occitanie;34;1;02;135;Lespignan;3260;58;3318
76;Occitanie;34;1;14;136;Lézignan-la-Cèbe;1546;28;1574
76;Occitanie;34;2;06;137;Liausson;146;3;149
76;Occitanie;34;2;14;138;Lieuran-Cabrières;322;13;335
76;Occitanie;34;1;04;139;Lieuran-lès-Béziers;1396;26;1422
76;Occitanie;34;1;03;140;Lignan-sur-Orb;3199;84;3283
76;Occitanie;34;1;24;141;La Livinière;532;8;540
76;Occitanie;34;2;11;142;Lodève;7441;249;7690
76;Occitanie;34;3;14;143;Loupian;2160;37;2197
76;Occitanie;34;1;06;144;Lunas;668;14;682
76;Occitanie;34;3;12;145;Lunel;26239;260;26499
76;Occitanie;34;3;12;146;Lunel-Viel;3932;39;3971
76;Occitanie;34;1;05;147;Magalas;3349;51;3400
76;Occitanie;34;1;05;148;Maraussan;4414;82;4496
76;Occitanie;34;1;05;149;Margon;703;11;714
76;Occitanie;34;3;01;150;Marseillan;7778;110;7888
76;Occitanie;34;3;12;151;Marsillargues;6248;76;6324
76;Occitanie;34;2;11;152;Mas-de-Londres;671;5;676
76;Occitanie;34;2;23;153;Les Matelles;2003;41;2044
76;Occitanie;34;3;13;154;Mauguio;16919;180;17099
76;Occitanie;34;1;05;155;Maureilhan;2095;36;2131
76;Occitanie;34;2;06;156;Mérifons;43;3;46
76;Occitanie;34;3;14;157;Mèze;11587;161;11748
76;Occitanie;34;1;24;158;Minerve;121;0;121
76;Occitanie;34;3;08;159;Mireval;3283;49;3332
76;Occitanie;34;1;24;160;Mons;584;13;597
76;Occitanie;34;1;05;161;Montady;3935;72;4007
76;Occitanie;34;1;14;162;Montagnac;4336;47;4383
76;Occitanie;34;2;09;163;Montarnaud;3754;43;3797
76;Occitanie;34;3;07;164;Montaud;991;11;1002
76;Occitanie;34;3;14;165;Montbazin;2952;60;3012
76;Occitanie;34;1;21;166;Montblanc;2848;51;2899
76;Occitanie;34;1;24;167;Montels;252;4;256
76;Occitanie;34;1;05;168;Montesquieu;70;0;70
76;Occitanie;34;3;20;169;Montferrier-sur-Lez;3720;161;3881
76;Occitanie;34;1;24;170;Montouliers;212;5;217
76;Occitanie;34;2;11;171;Montoulieu;161;4;165
76;Occitanie;34;3;99;172;Montpellier;285121;3479;288600
76;Occitanie;34;2;09;173;Montpeyroux;1340;25;1365
76;Occitanie;34;2;11;174;Moulès-et-Baucels;877;26;903
76;Occitanie;34;2;06;175;Mourèze;197;5;202
76;Occitanie;34;3;13;176;Mudaison;2593;27;2620
76;Occitanie;34;2;23;177;Murles;308;10;318
76;Occitanie;34;1;05;178;Murviel-lès-Béziers;3075;53;3128
76;Occitanie;34;3;22;179;Murviel-lès-Montpellier;1883;30;1913
76;Occitanie;34;2;06;180;Nébian;1388;21;1409
76;Occitanie;34;1;05;181;Neffiès;1056;16;1072
76;Occitanie;34;1;21;182;Nézignan-l'Évêque;1820;29;1849
76;Occitanie;34;1;02;183;Nissan-lez-Enserune;3995;60;4055
76;Occitanie;34;1;14;184;Nizas;670;15;685
76;Occitanie;34;2;11;185;Notre-Dame-de-Londres;480;13;493
76;Occitanie;34;2;06;186;Octon;527;4;531
76;Occitanie;34;1;24;187;Olargues;679;14;693
76;Occitanie;34;2;11;188;Olmet-et-Villecun;180;4;184
76;Occitanie;34;1;24;189;Olonzac;1770;21;1791
76;Occitanie;34;1;24;190;Oupia;245;7;252
76;Occitanie;34;1;05;191;Pailhès;570;4;574
76;Occitanie;34;3;13;192;Palavas-les-Flots;5977;43;6020
76;Occitanie;34;1;24;193;Pardailhan;183;6;189
76;Occitanie;34;2;06;194;Paulhan;3937;49;3986
76;Occitanie;34;2;11;195;Pégairolles-de-Buèges;50;1;51
76;Occitanie;34;2;11;196;Pégairolles-de-l'Escalette;159;5;164
76;Occitanie;34;2;14;197;Péret;1020;18;1038
76;Occitanie;34;3;10;198;Pérols;8985;123;9108
76;Occitanie;34;1;21;199;Pézenas;8280;334;8614
76;Occitanie;34;1;06;200;Pézènes-les-Mines;241;6;247
76;Occitanie;34;1;24;201;Pierrerue;292;7;299
76;Occitanie;34;3;22;202;Pignan;7019;95;7114
76;Occitanie;34;1;21;203;Pinet;1745;37;1782
76;Occitanie;34;2;09;204;Plaissan;1196;16;1212
76;Occitanie;34;2;11;205;Les Plans;279;10;289
76;Occitanie;34;1;24;206;Poilhes;559;11;570
76;Occitanie;34;1;21;207;Pomérols;2293;45;2338
76;Occitanie;34;2;09;208;Popian;350;14;364
76;Occitanie;34;1;01;209;Portiragnes;3134;60;3194
76;Occitanie;34;2;09;210;Le Pouget;2054;46;2100
76;Occitanie;34;1;06;211;Le Poujol-sur-Orb;1083;20;1103
76;Occitanie;34;2;11;212;Poujols;164;1;165
76;Occitanie;34;3;14;213;Poussan;5972;79;6051
76;Occitanie;34;1;05;214;Pouzolles;1171;19;1190
76;Occitanie;34;2;09;215;Pouzols;967;21;988
76;Occitanie;34;1;06;216;Le Pradal;332;9;341
76;Occitanie;34;3;23;217;Prades-le-Lez;5467;104;5571
76;Occitanie;34;1;24;218;Prades-sur-Vernazobre;310;8;318
76;Occitanie;34;1;24;219;Prémian;518;7;525
76;Occitanie;34;2;11;220;Le Puech;242;5;247
76;Occitanie;34;2;09;221;Puéchabon;485;5;490
76;Occitanie;34;2;09;222;Puilacher;578;4;582
76;Occitanie;34;1;05;223;Puimisson;1077;22;1099
76;Occitanie;34;1;21;224;Puissalicon;1353;22;1375
76;Occitanie;34;1;24;225;Puisserguier;2912;52;2964
76;Occitanie;34;1;24;226;Quarante;1767;26;1793
76;Occitanie;34;3;07;227;Restinclières;1888;26;1914
76;Occitanie;34;1;24;228;Rieussec;66;2;68
76;Occitanie;34;1;24;229;Riols;767;23;790
76;Occitanie;34;2;11;230;Les Rives;144;4;148
76;Occitanie;34;2;11;231;Romiguières;23;2;25
76;Occitanie;34;1;24;232;Roquebrun;605;10;615
76;Occitanie;34;2;11;233;Roqueredonde;209;1;210
76;Occitanie;34;1;05;234;Roquessels;104;1;105
76;Occitanie;34;1;24;235;Rosis;287;5;292
76;Occitanie;34;2;11;236;Rouet;65;0;65
76;Occitanie;34;1;05;237;Roujan;2158;28;2186
76;Occitanie;34;2;11;238;Saint-André-de-Buèges;39;1;40
76;Occitanie;34;2;09;239;Saint-André-de-Sangonis;5927;86;6013
76;Occitanie;34;3;13;240;Saint-Aunès;3439;31;3470
76;Occitanie;34;2;09;241;Saint-Bauzille-de-la-Sylve;812;18;830
76;Occitanie;34;2;23;242;Saint-Bauzille-de-Montmel;1022;24;1046
76;Occitanie;34;2;11;243;Saint-Bauzille-de-Putois;1977;31;2008
76;Occitanie;34;3;07;244;Saint-Brès;2948;39;2987
76;Occitanie;34;1;24;245;Saint-Chinian;1677;36;1713
76;Occitanie;34;2;23;247;Saint-Clément-de-Rivière;4877;236;5113
76;Occitanie;34;3;07;249;Saint-Drézéry;2526;49;2575
76;Occitanie;34;1;24;250;Saint-Étienne-d'Albagnan;306;7;313
76;Occitanie;34;2;11;251;Saint-Étienne-de-Gourgas;494;16;510
76;Occitanie;34;1;06;252;Saint-Étienne-Estréchoux;260;5;265
76;Occitanie;34;2;11;253;Saint-Félix-de-l'Héras;34;1;35
76;Occitanie;34;2;06;254;Saint-Félix-de-Lodez;1169;32;1201
76;Occitanie;34;2;23;255;Saint-Gély-du-Fesc;9795;236;10031
76;Occitanie;34;1;05;258;Saint-Geniès-de-Fontedit;1593;29;1622
76;Occitanie;34;1;06;257;Saint-Geniès-de-Varensal;209;2;211
76;Occitanie;34;3;07;256;Saint-Geniès-des-Mourgues;1876;31;1907
76;Occitanie;34;3;22;259;Saint-Georges-d'Orques;5397;76;5473
76;Occitanie;34;1;06;260;Saint-Gervais-sur-Mare;858;17;875
76;Occitanie;34;2;09;261;Saint-Guilhem-le-Désert;253;9;262
76;Occitanie;34;2;09;262;Saint-Guiraud;221;0;221
76;Occitanie;34;2;23;263;Saint-Hilaire-de-Beauvoir;420;14;434
76;Occitanie;34;2;11;264;Saint-Jean-de-Buèges;197;0;197
76;Occitanie;34;2;23;265;Saint-Jean-de-Cornies;721;22;743
76;Occitanie;34;2;23;266;Saint-Jean-de-Cuculles;483;7;490
76;Occitanie;34;2;09;267;Saint-Jean-de-Fos;1696;32;1728
76;Occitanie;34;2;11;268;Saint-Jean-de-la-Blaquière;627;16;643
76;Occitanie;34;1;24;269;Saint-Jean-de-Minervois;148;6;154
76;Occitanie;34;3;10;270;Saint-Jean-de-Védas;10008;182;10190
76;Occitanie;34;1;24;271;Saint-Julien;220;3;223
76;Occitanie;34;3;12;272;Saint-Just;3255;43;3298
76;Occitanie;34;1;24;273;Saint-Martin-de-l'Arçon;139;5;144
76;Occitanie;34;2;11;274;Saint-Martin-de-Londres;2755;26;2781
76;Occitanie;34;2;23;276;Saint-Mathieu-de-Tréviers;4790;93;4883
76;Occitanie;34;2;11;277;Saint-Maurice-Navacelles;183;6;189
76;Occitanie;34;2;11;278;Saint-Michel;48;1;49
76;Occitanie;34;1;05;279;Saint-Nazaire-de-Ladarez;354;4;358
76;Occitanie;34;3;12;280;Saint-Nazaire-de-Pézan;626;7;633
76;Occitanie;34;2;09;281;Saint-Pargoire;2276;37;2313
76;Occitanie;34;2;09;282;Saint-Paul-et-Valmalle;1124;20;1144
76;Occitanie;34;2;11;283;Saint-Pierre-de-la-Fage;130;1;131
76;Occitanie;34;1;14;285;Saint-Pons-de-Mauchiens;659;11;670
76;Occitanie;34;1;24;284;Saint-Pons-de-Thomières;1885;175;2060
76;Occitanie;34;2;11;286;Saint-Privat;404;12;416
76;Occitanie;34;2;09;287;Saint-Saturnin-de-Lucian;276;7;283
76;Occitanie;34;3;12;288;Saint-Sériès;983;21;1004
76;Occitanie;34;1;21;289;Saint-Thibéry;2665;34;2699
76;Occitanie;34;1;24;291;Saint-Vincent-d'Olargues;357;23;380
76;Occitanie;34;2;23;290;Saint-Vincent-de-Barbeyrargues;666;9;675
76;Occitanie;34;2;23;248;Sainte-Croix-de-Quintillargues;902;16;918
76;Occitanie;34;2;06;292;Salasc;301;6;307
76;Occitanie;34;1;24;293;La Salvetat-sur-Agout;1141;21;1162
76;Occitanie;34;3;12;294;Saturargues;971;19;990
76;Occitanie;34;3;22;295;Saussan;1588;32;1620
76;Occitanie;34;3;12;296;Saussines;1033;22;1055
76;Occitanie;34;2;11;297;Sauteyrargues;410;8;418
76;Occitanie;34;1;04;298;Sauvian;5353;94;5447
76;Occitanie;34;1;02;299;Sérignan;6956;149;7105
76;Occitanie;34;1;04;300;Servian;4937;85;5022
76;Occitanie;34;3;25;301;Sète;43229;567;43796
76;Occitanie;34;1;24;302;Siran;733;8;741
76;Occitanie;34;2;11;303;Sorbs;35;0;35
76;Occitanie;34;2;11;304;Soubès;931;13;944
76;Occitanie;34;1;24;305;Le Soulié;130;0;130
76;Occitanie;34;2;11;306;Soumont;184;2;186
76;Occitanie;34;3;07;307;Sussargues;2751;55;2806
76;Occitanie;34;1;06;308;Taussac-la-Billière;446;11;457
76;Occitanie;34;2;23;309;Teyran;4586;106;4692
76;Occitanie;34;1;05;310;Thézan-lès-Béziers;2987;73;3060
76;Occitanie;34;1;06;312;La Tour-sur-Orb;1273;31;1304
76;Occitanie;34;1;21;311;Tourbes;1621;156;1777
76;Occitanie;34;2;09;313;Tressan;659;11;670
76;Occitanie;34;2;23;314;Le Triadou;462;16;478
76;Occitanie;34;2;14;315;Usclas-d'Hérault;418;5;423
76;Occitanie;34;2;11;316;Usclas-du-Bosc;218;2;220
76;Occitanie;34;2;11;317;La Vacquerie-et-Saint-Martin-de-Castries;190;7;197
76;Occitanie;34;2;11;318;Vacquières;651;11;662
76;Occitanie;34;1;05;319;Vailhan;158;5;163
76;Occitanie;34;2;23;320;Vailhauquès;2553;54;2607
76;Occitanie;34;3;13;321;Valergues;2071;28;2099
76;Occitanie;34;2;11;322;Valflaunès;763;24;787
76;Occitanie;34;2;06;323;Valmascle;40;1;41
76;Occitanie;34;1;02;324;Valras-Plage;4207;58;4265
76;Occitanie;34;1;21;325;Valros;1616;31;1647
76;Occitanie;34;1;24;326;Vélieux;86;0;86
76;Occitanie;34;3;07;327;Vendargues;6232;83;6315
76;Occitanie;34;2;09;328;Vendémian;1056;30;1086
76;Occitanie;34;1;02;329;Vendres;2702;79;2781
76;Occitanie;34;1;24;331;Verreries-de-Moussans;97;1;98
76;Occitanie;34;1;01;332;Vias;5719;67;5786
76;Occitanie;34;3;08;333;Vic-la-Gardiole;3261;35;3296
76;Occitanie;34;1;24;334;Vieussan;266;0;266
76;Occitanie;34;1;06;335;Villemagne-l'Argentière;433;12;445
76;Occitanie;34;1;04;336;Villeneuve-lès-Béziers;4207;53;4260
76;Occitanie;34;3;22;337;Villeneuve-lès-Maguelone;10012;120;10132
76;Occitanie;34;2;06;338;Villeneuvette;71;3;74
76;Occitanie;34;1;24;339;Villespassans;171;2;173
76;Occitanie;34;3;12;340;Villetelle;1433;41;1474
76;Occitanie;34;3;14;341;Villeveyrac;3795;67;3862
76;Occitanie;34;2;11;342;Viols-en-Laval;199;4;203
76;Occitanie;34;2;11;343;Viols-le-Fort;1211;28;1239
53;Bretagne;35;3;13;001;Acigné;6740;159;6899
53;Bretagne;35;1;12;002;Amanlis;1719;35;1754
53;Bretagne;35;3;01;003;Andouillé-Neuville;886;12;898
53;Bretagne;35;1;10;005;Arbrissel;306;12;318
53;Bretagne;35;1;10;006;Argentré-du-Plessis;4396;125;4521
53;Bretagne;35;3;01;007;Aubigné;474;2;476
53;Bretagne;35;1;10;008;Availles-sur-Seiche;684;18;702
53;Bretagne;35;4;07;009;Baguer-Morvan;1705;33;1738
53;Bretagne;35;4;07;010;Baguer-Pican;1681;13;1694
53;Bretagne;35;2;02;012;Bain-de-Bretagne;7331;165;7496
53;Bretagne;35;2;17;013;Bains-sur-Oust;3478;131;3609
53;Bretagne;35;1;10;014;Bais;2419;32;2451
53;Bretagne;35;1;27;015;Balazé;2228;48;2276
53;Bretagne;35;2;11;016;Baulon;2160;64;2224
53;Bretagne;35;4;06;017;La Baussaine;667;10;677
53;Bretagne;35;1;09;018;La Bazouge-du-Désert;1087;22;1109
53;Bretagne;35;1;01;019;Bazouges-la-Pérouse;1808;25;1833
53;Bretagne;35;1;09;021;Beaucé;1365;29;1394
53;Bretagne;35;3;15;022;Bécherel;669;11;680
53;Bretagne;35;3;16;023;Bédée;4308;71;4379
53;Bretagne;35;3;03;024;Betton;11735;292;12027
53;Bretagne;35;1;08;025;Billé;1052;14;1066
53;Bretagne;35;3;15;026;Bléruais;107;6;113
53;Bretagne;35;3;15;027;Boisgervilly;1664;33;1697
53;Bretagne;35;1;05;028;Boistrudan;710;14;724
53;Bretagne;35;4;06;029;Bonnemain;1566;20;1586
53;Bretagne;35;2;02;030;La Bosse-de-Bretagne;649;9;658
53;Bretagne;35;3;13;031;La Bouëxière;4447;112;4559
53;Bretagne;35;2;11;033;Bourg-des-Comptes;3264;68;3332
53;Bretagne;35;3;12;032;Bourgbarré;4132;56;4188
53;Bretagne;35;4;07;034;La Boussac;1181;23;1204
53;Bretagne;35;2;11;035;Bovel;605;10;615
53;Bretagne;35;3;24;037;Bréal-sous-Montfort;6131;79;6210
53;Bretagne;35;1;27;038;Bréal-sous-Vitré;646;9;655
53;Bretagne;35;3;13;039;Brécé;2106;43;2149
53;Bretagne;35;3;16;040;Breteil;3584;76;3660
53;Bretagne;35;1;12;041;Brie;950;16;966
53;Bretagne;35;1;10;042;Brielles;687;30;717
53;Bretagne;35;4;07;044;Broualan;373;9;382
53;Bretagne;35;2;17;045;Bruc-sur-Aff;863;22;885
53;Bretagne;35;2;11;046;Les Brulais;553;4;557
53;Bretagne;35;3;04;047;Bruz;18266;468;18734
53;Bretagne;35;4;25;049;Cancale;5121;90;5211
53;Bretagne;35;4;06;050;Cardroc;574;9;583
53;Bretagne;35;3;03;051;Cesson-Sévigné;17526;544;18070
53;Bretagne;35;1;27;052;Champeaux;504;16;520
53;Bretagne;35;2;02;054;Chanteloup;1815;43;1858
53;Bretagne;35;3;20;055;Chantepie;10435;218;10653
53;Bretagne;35;4;06;056;La Chapelle-aux-Filtzméens;815;19;834
53;Bretagne;35;2;11;057;La Chapelle-Bouëxic;1475;27;1502
53;Bretagne;35;3;15;058;La Chapelle-Chaussée;1271;15;1286
53;Bretagne;35;2;17;064;La Chapelle-de-Brain;969;23;992
53;Bretagne;35;3;03;059;La Chapelle-des-Fougeretz;4773;96;4869
53;Bretagne;35;3;15;060;La Chapelle du Lou du Lac;1003;19;1022
53;Bretagne;35;1;27;061;La Chapelle-Erbrée;698;17;715
53;Bretagne;35;1;09;062;La Chapelle-Janson;1450;27;1477
53;Bretagne;35;1;08;063;La Chapelle-Saint-Aubert;439;7;446
53;Bretagne;35;3;24;065;La Chapelle-Thouarault;2170;33;2203
53;Bretagne;35;3;04;066;Chartres-de-Bretagne;7800;126;7926
53;Bretagne;35;3;13;067;Chasné-sur-Illet;1537;27;1564
53;Bretagne;35;1;05;068;Châteaubourg;7064;146;7210
53;Bretagne;35;3;05;069;Châteaugiron;9966;253;10219
53;Bretagne;35;4;07;070;Châteauneuf-d'Ille-et-Vilaine;1722;30;1752
53;Bretagne;35;1;01;071;Le Châtellier;427;6;433
53;Bretagne;35;1;27;072;Châtillon-en-Vendelais;1679;35;1714
53;Bretagne;35;1;01;075;Chauvigné;845;20;865
53;Bretagne;35;3;24;076;Chavagne;4015;78;4093
53;Bretagne;35;1;10;077;Chelun;349;11;360
53;Bretagne;35;4;07;078;Cherrueix;1110;19;1129
53;Bretagne;35;3;03;079;Chevaigné;2265;67;2332
53;Bretagne;35;3;24;080;Cintré;2278;42;2320
53;Bretagne;35;3;14;081;Clayes;904;13;917
53;Bretagne;35;1;10;082;Coësmes;1474;34;1508
53;Bretagne;35;2;11;084;Comblessac;689;11;700
53;Bretagne;35;4;06;085;Combourg;5940;135;6075
53;Bretagne;35;1;08;086;Combourtillé;611;8;619
53;Bretagne;35;1;27;087;Cornillé;966;32;998
53;Bretagne;35;3;12;088;Corps-Nuds;3296;56;3352
53;Bretagne;35;2;02;089;La Couyère;479;12;491
53;Bretagne;35;2;02;090;Crevin;2828;39;2867
53;Bretagne;35;3;15;091;Le Crouais;574;7;581
53;Bretagne;35;4;06;092;Cuguen;839;10;849
53;Bretagne;35;4;26;093;Dinard;10027;545;10572
53;Bretagne;35;4;06;094;Dingé;1636;24;1660
53;Bretagne;35;4;07;095;Dol-de-Bretagne;5693;265;5958
53;Bretagne;35;1;05;096;Domagné;2305;42;2347
53;Bretagne;35;1;10;097;Domalain;2018;38;2056
53;Bretagne;35;2;02;098;La Dominelais;1377;26;1403
53;Bretagne;35;3;05;099;Domloup;3522;64;3586
53;Bretagne;35;3;13;101;Dourdain;1159;11;1170
53;Bretagne;35;1;10;102;Drouges;519;14;533
53;Bretagne;35;1;10;103;Eancé;403;9;412
53;Bretagne;35;4;07;104;Epiniac;1426;24;1450
53;Bretagne;35;1;27;105;Erbrée;1702;52;1754
53;Bretagne;35;2;02;106;Ercé-en-Lamée;1497;14;1511
53;Bretagne;35;3;13;107;Ercé-près-Liffré;1808;32;1840
53;Bretagne;35;1;10;108;Essé;1093;25;1118
53;Bretagne;35;1;10;109;Étrelles;2543;58;2601
53;Bretagne;35;3;01;110;Feins;977;19;996
53;Bretagne;35;1;09;111;Le Ferré;687;8;695
53;Bretagne;35;1;09;112;Fleurigné;974;26;1000
53;Bretagne;35;1;10;114;Forges-la-Forêt;265;6;271
53;Bretagne;35;1;97;115;Fougères;20418;680;21098
53;Bretagne;35;4;07;116;La Fresnais;2541;53;2594
53;Bretagne;35;3;15;117;Gaël;1634;25;1659
53;Bretagne;35;3;01;118;Gahard;1467;23;1490
53;Bretagne;35;1;10;119;Gennes-sur-Seiche;950;21;971
53;Bretagne;35;3;14;120;Gévezé;5301;102;5403
53;Bretagne;35;3;08;121;Gosné;1991;36;2027
53;Bretagne;35;4;25;122;La Gouesnière;1893;38;1931
53;Bretagne;35;2;11;123;Goven;4363;96;4459
53;Bretagne;35;2;02;124;Grand-Fougeray;2445;38;2483
53;Bretagne;35;1;10;125;La Guerche-de-Bretagne;4243;147;4390
53;Bretagne;35;2;11;126;Guichen;8568;198;8766
53;Bretagne;35;2;11;127;Guignen;3902;70;3972
53;Bretagne;35;3;14;128;Guipel;1696;38;1734
53;Bretagne;35;2;17;176;Guipry-Messac;6961;149;7110
53;Bretagne;35;4;14;130;Hédé-Bazouges;2247;53;2300
53;Bretagne;35;3;24;131;L' Hermitage;4437;80;4517
53;Bretagne;35;4;07;132;Hirel;1392;36;1428
53;Bretagne;35;3;16;133;Iffendic;4469;92;4561
53;Bretagne;35;4;06;134;Les Iffs;272;12;284
53;Bretagne;35;3;15;135;Irodouër;2262;27;2289
53;Bretagne;35;1;12;136;Janzé;8279;155;8434
53;Bretagne;35;1;08;137;Javené;2067;69;2136
53;Bretagne;35;1;09;138;Laignelet;1163;27;1190
53;Bretagne;35;3;04;139;Laillé;5026;143;5169
53;Bretagne;35;2;02;140;Lalleu;567;11;578
53;Bretagne;35;1;27;141;Landavran;692;21;713
53;Bretagne;35;1;09;142;Landéan;1205;20;1225
53;Bretagne;35;3;15;143;Landujan;934;31;965
53;Bretagne;35;3;15;144;Langan;979;19;998
53;Bretagne;35;2;17;145;Langon;1421;26;1447
53;Bretagne;35;3;14;146;Langouet;601;2;603
53;Bretagne;35;4;06;148;Lanrigan;152;0;152
53;Bretagne;35;2;11;149;Lassy;1702;38;1740
53;Bretagne;35;1;08;150;Lécousse;3233;103;3336
53;Bretagne;35;2;17;151;Lieuron;785;15;800
53;Bretagne;35;3;13;152;Liffré;7609;139;7748
53;Bretagne;35;4;07;153;Lillemer;358;10;368
53;Bretagne;35;3;08;154;Livré-sur-Changeon;1700;41;1741
53;Bretagne;35;2;17;155;Lohéac;649;15;664
53;Bretagne;35;4;06;156;Longaulnay;616;10;626
53;Bretagne;35;1;09;157;Le Loroux;653;15;668
53;Bretagne;35;4;06;159;Lourmais;326;2;328
53;Bretagne;35;2;11;160;Loutehel;258;5;263
53;Bretagne;35;1;05;161;Louvigné-de-Bais;1899;35;1934
53;Bretagne;35;1;09;162;Louvigné-du-Désert;3374;57;3431
53;Bretagne;35;1;89;163;Luitré-Dompierre;1851;30;1881
53;Bretagne;35;1;01;257;Maen Roch;4850;94;4944
53;Bretagne;35;1;01;164;Marcillé-Raoul;766;11;777
53;Bretagne;35;1;10;165;Marcillé-Robert;959;21;980
53;Bretagne;35;1;27;166;Marpiré;1053;17;1070
53;Bretagne;35;1;10;167;Martigné-Ferchaud;2603;65;2668
53;Bretagne;35;3;16;169;Maxent;1466;17;1483
53;Bretagne;35;1;27;170;Mecé;608;12;620
53;Bretagne;35;3;15;171;Médréac;1827;48;1875
53;Bretagne;35;4;06;172;Meillac;1848;29;1877
53;Bretagne;35;3;14;173;Melesse;6576;100;6676
53;Bretagne;35;1;09;174;Mellé;651;11;662
53;Bretagne;35;2;11;175;Mernel;1034;16;1050
53;Bretagne;35;4;06;308;Mesnil-Roc'h;4301;76;4377
53;Bretagne;35;3;14;177;La Mézière;4892;122;5014
53;Bretagne;35;3;08;178;Mézières-sur-Couesnon;1752;32;1784
53;Bretagne;35;4;07;179;Miniac-Morvan;3931;51;3982
53;Bretagne;35;3;15;180;Miniac-sous-Bécherel;774;16;790
53;Bretagne;35;4;26;181;Le Minihic-sur-Rance;1449;33;1482
53;Bretagne;35;1;27;183;Mondevert;819;21;840
53;Bretagne;35;4;07;186;Mont-Dol;1093;38;1131
53;Bretagne;35;3;15;184;Montauban-de-Bretagne;5840;242;6082
53;Bretagne;35;1;27;185;Montautour;264;6;270
53;Bretagne;35;3;16;187;Monterfil;1327;28;1355
53;Bretagne;35;3;16;188;Montfort-sur-Meu;6653;170;6823
53;Bretagne;35;3;03;189;Montgermont;3364;61;3425
53;Bretagne;35;1;09;190;Monthault;265;8;273
53;Bretagne;35;1;27;192;Montreuil-des-Landes;240;3;243
53;Bretagne;35;3;14;193;Montreuil-le-Gast;1936;43;1979
53;Bretagne;35;1;27;194;Montreuil-sous-Pérouse;1015;32;1047
53;Bretagne;35;3;01;195;Montreuil-sur-Ille;2383;35;2418
53;Bretagne;35;3;24;196;Mordelles;7363;139;7502
53;Bretagne;35;3;01;197;Mouazé;1586;18;1604
53;Bretagne;35;1;10;198;Moulins;716;24;740
53;Bretagne;35;1;10;199;Moussé;336;9;345
53;Bretagne;35;1;10;200;Moutiers;929;16;945
53;Bretagne;35;3;15;201;Muel;894;9;903
53;Bretagne;35;2;02;202;La Noë-Blanche;1002;9;1011
53;Bretagne;35;3;16;203;La Nouaye;357;5;362
53;Bretagne;35;3;12;204;Nouvoitou;3099;57;3156
53;Bretagne;35;3;04;206;Noyal-Châtillon-sur-Seiche;6919;125;7044
53;Bretagne;35;1;01;205;Noyal-sous-Bazouges;385;8;393
53;Bretagne;35;3;05;207;Noyal-sur-Vilaine;6008;146;6154
53;Bretagne;35;3;12;208;Orgères;4729;114;4843
53;Bretagne;35;3;23;210;Pacé;11739;297;12036
53;Bretagne;35;3;16;211;Paimpont;1711;38;1749
53;Bretagne;35;2;02;212;Pancé;1171;30;1201
53;Bretagne;35;1;08;214;Parcé;650;2;652
53;Bretagne;35;1;09;215;Parigné;1336;41;1377
53;Bretagne;35;3;14;216;Parthenay-de-Bretagne;1748;12;1760
53;Bretagne;35;1;10;217;Le Pertre;1389;30;1419
53;Bretagne;35;2;02;218;Le Petit-Fougeray;894;20;914
53;Bretagne;35;2;17;219;Pipriac;3745;55;3800
53;Bretagne;35;3;05;220;Piré-Chancé;2901;63;2964
53;Bretagne;35;2;02;221;Pléchâtel;2789;52;2841
53;Bretagne;35;4;07;222;Pleine-Fougères;1980;34;2014
53;Bretagne;35;3;16;223;Plélan-le-Grand;3949;73;4022
53;Bretagne;35;4;07;224;Plerguer;2722;49;2771
53;Bretagne;35;4;06;225;Plesder;790;16;806
53;Bretagne;35;4;06;226;Pleugueneuc;1903;25;1928
53;Bretagne;35;3;16;227;Pleumeleuc;3329;46;3375
53;Bretagne;35;4;26;228;Pleurtuit;6806;123;6929
53;Bretagne;35;1;27;229;Pocé-les-Bois;1293;51;1344
53;Bretagne;35;1;09;230;Poilley;378;4;382
53;Bretagne;35;2;02;231;Poligné;1201;31;1232
53;Bretagne;35;3;04;363;Pont-Péan;4463;129;4592
53;Bretagne;35;1;01;191;Les Portes du Coglais;2391;47;2438
53;Bretagne;35;1;27;232;Princé;380;5;385
53;Bretagne;35;4;06;233;Québriac;1579;37;1616
53;Bretagne;35;3;15;234;Quédillac;1186;21;1207
53;Bretagne;35;1;10;235;Rannée;1094;47;1141
53;Bretagne;35;2;17;236;Redon;9014;796;9810
53;Bretagne;35;2;17;237;Renac;1009;25;1034
53;Bretagne;35;3;98;238;Rennes;216815;4110;220925
53;Bretagne;35;1;10;239;Retiers;4357;94;4451
53;Bretagne;35;3;24;240;Le Rheu;8740;287;9027
53;Bretagne;35;4;26;241;La Richardais;2295;80;2375
53;Bretagne;35;1;01;242;Rimou;336;4;340
53;Bretagne;35;1;08;282;Rives-du-Couesnon;2858;53;2911
53;Bretagne;35;1;08;243;Romagné;2404;53;2457
53;Bretagne;35;1;01;244;Romazy;254;3;257
53;Bretagne;35;3;15;245;Romillé;3905;72;3977
53;Bretagne;35;4;07;246;Roz-Landrieux;1340;27;1367
53;Bretagne;35;4;07;247;Roz-sur-Couesnon;1003;12;1015
53;Bretagne;35;4;07;248;Sains;483;7;490
53;Bretagne;35;3;12;250;Saint-Armel;1981;35;2016
53;Bretagne;35;3;01;251;Saint-Aubin-d'Aubigné;3796;82;3878
53;Bretagne;35;1;27;252;Saint-Aubin-des-Landes;948;23;971
53;Bretagne;35;3;08;253;Saint-Aubin-du-Cormier;3837;161;3998
53;Bretagne;35;4;07;255;Saint-Benoît-des-Ondes;994;29;1023
53;Bretagne;35;4;26;256;Saint-Briac-sur-Mer;2070;62;2132
53;Bretagne;35;4;06;258;Saint-Brieuc-des-Iffs;340;9;349
53;Bretagne;35;4;07;259;Saint-Broladre;1132;22;1154
53;Bretagne;35;1;08;261;Saint-Christophe-de-Valains;225;2;227
53;Bretagne;35;1;27;260;Saint-Christophe-des-Bois;574;5;579
53;Bretagne;35;4;25;263;Saint-Coulomb;2707;84;2791
53;Bretagne;35;1;05;264;Saint-Didier;2052;27;2079
53;Bretagne;35;4;06;265;Saint-Domineuc;2532;49;2581
53;Bretagne;35;3;12;266;Saint-Erblon;3078;69;3147
53;Bretagne;35;2;17;268;Saint-Ganton;424;10;434
53;Bretagne;35;4;07;270;Saint-Georges-de-Gréhaigne;370;4;374
53;Bretagne;35;1;09;271;Saint-Georges-de-Reintembault;1498;25;1523
53;Bretagne;35;1;10;272;Saint-Germain-du-Pinel;915;15;930
53;Bretagne;35;1;01;273;Saint-Germain-en-Coglès;2051;30;2081
53;Bretagne;35;3;14;274;Saint-Germain-sur-Ille;925;14;939
53;Bretagne;35;3;14;275;Saint-Gilles;4984;82;5066
53;Bretagne;35;3;14;276;Saint-Gondran;537;11;548
53;Bretagne;35;3;16;277;Saint-Gonlay;354;5;359
53;Bretagne;35;3;03;278;Saint-Grégoire;9639;368;10007
53;Bretagne;35;4;07;279;Saint-Guinoux;1210;24;1234
53;Bretagne;35;1;01;280;Saint-Hilaire-des-Landes;1038;21;1059
53;Bretagne;35;3;22;281;Saint-Jacques-de-la-Lande;13087;152;13239
53;Bretagne;35;1;05;283;Saint-Jean-sur-Vilaine;1266;32;1298
53;Bretagne;35;4;26;284;Saint-Jouan-des-Guérets;2646;69;2715
53;Bretagne;35;2;17;285;Saint-Just;1065;26;1091
53;Bretagne;35;4;06;286;Saint-Léger-des-Prés;264;9;273
53;Bretagne;35;4;26;287;Saint-Lunaire;2356;83;2439
53;Bretagne;35;1;27;300;Saint-M'Hervé;1356;39;1395
53;Bretagne;35;4;99;288;Saint-Malo;46097;1265;47362
53;Bretagne;35;2;17;289;Saint-Malo-de-Phily;1084;19;1103
53;Bretagne;35;3;15;290;Saint-Malon-sur-Mel;576;12;588
53;Bretagne;35;1;01;292;Saint-Marc-le-Blanc;1689;24;1713
53;Bretagne;35;4;07;291;Saint-Marcan;448;9;457
53;Bretagne;35;3;15;295;Saint-Maugan;544;11;555
53;Bretagne;35;3;14;296;Saint-Médard-sur-Ille;1287;22;1309
53;Bretagne;35;3;15;297;Saint-Méen-le-Grand;4635;173;4808
53;Bretagne;35;4;25;299;Saint-Méloir-des-Ondes;4086;102;4188
53;Bretagne;35;3;15;302;Saint-Onen-la-Chapelle;1143;25;1168
53;Bretagne;35;1;08;304;Saint-Ouen-des-Alleux;1296;22;1318
53;Bretagne;35;3;16;305;Saint-Péran;410;8;418
53;Bretagne;35;4;07;306;Saint-Père-Marc-en-Poulet;2298;154;2452
53;Bretagne;35;3;15;307;Saint-Pern;1033;18;1051
53;Bretagne;35;1;01;309;Saint-Rémy-du-Plain;828;13;841
53;Bretagne;35;1;08;310;Saint-Sauveur-des-Landes;1511;26;1537
53;Bretagne;35;2;11;311;Saint-Séglin;566;6;572
53;Bretagne;35;2;11;312;Saint-Senoux;1840;48;1888
53;Bretagne;35;4;07;314;Saint-Suliac;907;29;936
53;Bretagne;35;2;02;316;Saint-Sulpice-des-Landes;809;9;818
53;Bretagne;35;3;13;315;Saint-Sulpice-la-Forêt;1332;38;1370
53;Bretagne;35;3;14;317;Saint-Symphorien;603;61;664
53;Bretagne;35;4;06;318;Saint-Thual;915;20;935
53;Bretagne;35;3;16;319;Saint-Thurial;2084;43;2127
53;Bretagne;35;3;15;320;Saint-Uniac;537;5;542
53;Bretagne;35;2;02;249;Sainte-Anne-sur-Vilaine;1018;14;1032
53;Bretagne;35;1;10;262;Sainte-Colombe;351;6;357
53;Bretagne;35;2;17;294;Sainte-Marie;2249;64;2313
53;Bretagne;35;2;02;321;Saulnières;773;10;783
53;Bretagne;35;2;02;322;Le Sel-de-Bretagne;1106;18;1124
53;Bretagne;35;1;09;324;La Selle-en-Luitré;613;16;629
53;Bretagne;35;1;10;325;La Selle-Guerchaise;154;7;161
53;Bretagne;35;3;01;326;Sens-de-Bretagne;2554;40;2594
53;Bretagne;35;3;05;327;Servon-sur-Vilaine;3676;85;3761
53;Bretagne;35;2;17;328;Sixt-sur-Aff;2129;44;2173
53;Bretagne;35;4;07;329;Sougéal;570;11;581
53;Bretagne;35;1;27;330;Taillis;1001;26;1027
53;Bretagne;35;3;16;331;Talensac;2488;54;2542
53;Bretagne;35;2;02;332;Teillay;1061;12;1073
53;Bretagne;35;1;10;333;Le Theil-de-Bretagne;1734;33;1767
53;Bretagne;35;3;13;334;Thorigné-Fouillard;8463;210;8673
53;Bretagne;35;1;10;335;Thourie;802;18;820
53;Bretagne;35;1;01;336;Le Tiercent;174;3;177
53;Bretagne;35;4;06;337;Tinténiac;3635;174;3809
53;Bretagne;35;1;10;338;Torcé;1187;25;1212
53;Bretagne;35;4;07;339;Trans-la-Forêt;583;4;587
53;Bretagne;35;3;16;340;Treffendel;1257;24;1281
53;Bretagne;35;4;06;342;Trémeheuc;343;12;355
53;Bretagne;35;2;02;343;Tresbœuf;1255;20;1275
53;Bretagne;35;4;06;345;Trévérien;884;23;907
53;Bretagne;35;4;06;346;Trimer;214;0;214
53;Bretagne;35;4;07;362;Le Tronchet;1161;8;1169
53;Bretagne;35;1;01;004;Val-Couesnon;4191;94;4285
53;Bretagne;35;2;11;168;Val d'Anast;3980;77;4057
53;Bretagne;35;1;27;347;Val-d'Izé;2590;58;2648
53;Bretagne;35;1;10;350;Vergéal;804;24;828
53;Bretagne;35;3;24;351;Le Verger;1445;24;1469
53;Bretagne;35;3;12;352;Vern-sur-Seiche;7911;195;8106
53;Bretagne;35;3;24;353;Vezin-le-Coquet;5727;102;5829
53;Bretagne;35;4;07;354;Vieux-Viel;315;2;317
53;Bretagne;35;3;01;355;Vieux-Vy-sur-Couesnon;1216;6;1222
53;Bretagne;35;3;14;356;Vignoc;1910;24;1934
53;Bretagne;35;1;09;357;Villamée;313;6;319
53;Bretagne;35;4;07;358;La Ville-ès-Nonais;1203;33;1236
53;Bretagne;35;1;10;359;Visseiche;823;17;840
53;Bretagne;35;1;27;360;Vitré;18037;539;18576
53;Bretagne;35;4;07;361;Le Vivier-sur-Mer;1039;10;1049
24;Centre-Val de Loire;36;3;11;001;Aigurande;1428;29;1457
24;Centre-Val de Loire;36;4;10;002;Aize;116;0;116
24;Centre-Val de Loire;36;4;01;003;Ambrault;894;20;914
24;Centre-Val de Loire;36;4;13;004;Anjouin;331;3;334
24;Centre-Val de Loire;36;2;01;005;Ardentes;3860;85;3945
24;Centre-Val de Loire;36;2;02;006;Argenton-sur-Creuse;4927;213;5140
24;Centre-Val de Loire;36;2;04;007;Argy;603;8;611
24;Centre-Val de Loire;36;2;04;008;Arpheuilles;223;9;232
24;Centre-Val de Loire;36;2;01;009;Arthon;1250;46;1296
24;Centre-Val de Loire;36;1;03;010;Azay-le-Ferron;862;19;881
24;Centre-Val de Loire;36;2;02;158;Badecon-le-Pin;751;10;761
24;Centre-Val de Loire;36;4;13;011;Bagneux;174;2;176
24;Centre-Val de Loire;36;2;02;012;Baraize;351;1;352
24;Centre-Val de Loire;36;2;10;013;Baudres;438;6;444
24;Centre-Val de Loire;36;2;02;014;Bazaiges;205;6;211
24;Centre-Val de Loire;36;1;12;015;Beaulieu;55;1;56
24;Centre-Val de Loire;36;1;12;016;Bélâbre;968;21;989
24;Centre-Val de Loire;36;3;08;017;La Berthenoux;397;5;402
24;Centre-Val de Loire;36;1;03;018;Le Blanc;6389;222;6611
24;Centre-Val de Loire;36;4;08;019;Bommiers;305;5;310
24;Centre-Val de Loire;36;1;12;020;Bonneuil;79;1;80
24;Centre-Val de Loire;36;4;09;021;Les Bordes;895;20;915
24;Centre-Val de Loire;36;2;02;022;Bouesse;439;4;443
24;Centre-Val de Loire;36;2;10;023;Bouges-le-Château;266;5;271
24;Centre-Val de Loire;36;2;10;024;Bretagne;147;1;148
24;Centre-Val de Loire;36;3;08;025;Briantes;605;11;616
24;Centre-Val de Loire;36;2;10;026;Brion;572;8;580
24;Centre-Val de Loire;36;4;08;027;Brives;258;2;260
24;Centre-Val de Loire;36;3;11;028;La Buxerette;109;2;111
24;Centre-Val de Loire;36;4;10;029;Buxeuil;222;3;225
24;Centre-Val de Loire;36;3;11;030;Buxières-d'Aillac;256;4;260
24;Centre-Val de Loire;36;2;04;031;Buzançais;4505;75;4580
24;Centre-Val de Loire;36;2;02;032;Ceaulmont;727;20;747
24;Centre-Val de Loire;36;2;02;033;Celon;407;4;411
24;Centre-Val de Loire;36;4;13;034;Chabris;2750;43;2793
24;Centre-Val de Loire;36;1;12;035;Chaillac;1095;13;1108
24;Centre-Val de Loire;36;1;12;036;Chalais;140;6;146
24;Centre-Val de Loire;36;4;10;037;La Champenoise;268;6;274
24;Centre-Val de Loire;36;3;08;038;Champillet;153;2;155
24;Centre-Val de Loire;36;2;04;040;La Chapelle-Orthemale;111;0;111
24;Centre-Val de Loire;36;4;10;041;La Chapelle-Saint-Laurian;148;2;150
24;Centre-Val de Loire;36;2;02;042;Chasseneuil;702;11;713
24;Centre-Val de Loire;36;3;11;043;Chassignolles;568;23;591
24;Centre-Val de Loire;36;2;99;044;Châteauroux;43741;1577;45318
24;Centre-Val de Loire;36;2;04;045;Châtillon-sur-Indre;2567;55;2622
24;Centre-Val de Loire;36;3;08;046;La Châtre;4109;120;4229
24;Centre-Val de Loire;36;1;12;047;La Châtre-Langlin;521;8;529
24;Centre-Val de Loire;36;2;02;048;Chavin;271;9;280
24;Centre-Val de Loire;36;1;12;049;Chazelet;122;2;124
24;Centre-Val de Loire;36;2;04;050;Chezelles;476;9;485
24;Centre-Val de Loire;36;1;12;051;Chitray;182;5;187
24;Centre-Val de Loire;36;4;09;052;Chouday;153;2;155
24;Centre-Val de Loire;36;1;03;053;Ciron;572;11;583
24;Centre-Val de Loire;36;2;04;054;Cléré-du-Bois;246;8;254
24;Centre-Val de Loire;36;2;04;055;Clion;1023;21;1044
24;Centre-Val de Loire;36;3;11;056;Cluis;996;15;1011
24;Centre-Val de Loire;36;2;10;057;Coings;880;24;904
24;Centre-Val de Loire;36;1;03;058;Concremiers;649;18;667
24;Centre-Val de Loire;36;4;08;059;Condé;238;10;248
24;Centre-Val de Loire;36;3;11;060;Crevant;718;14;732
24;Centre-Val de Loire;36;3;11;061;Crozon-sur-Vauvre;340;11;351
24;Centre-Val de Loire;36;2;02;062;Cuzion;441;6;447
24;Centre-Val de Loire;36;2;05;063;Déols;7513;152;7665
24;Centre-Val de Loire;36;2;01;064;Diors;785;22;807
24;Centre-Val de Loire;36;4;10;065;Diou;256;5;261
24;Centre-Val de Loire;36;1;03;066;Douadic;445;14;459
24;Centre-Val de Loire;36;4;13;068;Dun-le-Poëlier;426;6;432
24;Centre-Val de Loire;36;1;12;067;Dunet;101;3;104
24;Centre-Val de Loire;36;2;13;069;Écueillé;1261;21;1282
24;Centre-Val de Loire;36;2;02;070;Éguzon-Chantôme;1384;31;1415
24;Centre-Val de Loire;36;2;01;071;Étrechet;1008;24;1032
24;Centre-Val de Loire;36;3;08;073;Feusines;211;5;216
24;Centre-Val de Loire;36;2;04;074;Fléré-la-Rivière;552;9;561
24;Centre-Val de Loire;36;4;10;075;Fontenay;88;1;89
24;Centre-Val de Loire;36;1;03;076;Fontgombault;249;3;252
24;Centre-Val de Loire;36;2;13;077;Fontguenand;238;3;241
24;Centre-Val de Loire;36;3;11;078;Fougerolles;350;6;356
24;Centre-Val de Loire;36;2;10;079;Francillon;78;1;79
24;Centre-Val de Loire;36;2;13;080;Frédille;71;2;73
24;Centre-Val de Loire;36;2;02;081;Gargilesse-Dampierre;285;9;294
24;Centre-Val de Loire;36;2;13;082;Gehée;255;0;255
24;Centre-Val de Loire;36;4;10;083;Giroux;116;3;119
24;Centre-Val de Loire;36;3;11;084;Gournay;290;2;292
24;Centre-Val de Loire;36;4;10;085;Guilly;244;6;250
24;Centre-Val de Loire;36;2;13;086;Heugnes;394;8;402
24;Centre-Val de Loire;36;1;03;087;Ingrandes;317;5;322
24;Centre-Val de Loire;36;4;09;088;Issoudun;11905;294;12199
24;Centre-Val de Loire;36;2;01;089;Jeu-les-Bois;394;6;400
24;Centre-Val de Loire;36;2;13;090;Jeu-Maloches;127;1;128
24;Centre-Val de Loire;36;3;08;091;Lacs;653;19;672
24;Centre-Val de Loire;36;2;13;092;Langé;285;8;293
24;Centre-Val de Loire;36;2;10;093;Levroux;2947;36;2983
24;Centre-Val de Loire;36;1;12;094;Lignac;459;7;466
24;Centre-Val de Loire;36;3;08;095;Lignerolles;101;2;103
24;Centre-Val de Loire;36;1;03;096;Lingé;229;3;232
24;Centre-Val de Loire;36;4;10;097;Liniez;325;9;334
24;Centre-Val de Loire;36;4;10;098;Lizeray;82;1;83
24;Centre-Val de Loire;36;3;11;099;Lourdoueix-Saint-Michel;315;5;320
24;Centre-Val de Loire;36;3;08;100;Lourouer-Saint-Laurent;270;6;276
24;Centre-Val de Loire;36;2;12;101;Luant;1504;39;1543
24;Centre-Val de Loire;36;1;03;104;Lurais;249;3;252
24;Centre-Val de Loire;36;1;03;105;Lureuil;263;3;266
24;Centre-Val de Loire;36;1;12;106;Luzeret;153;1;154
24;Centre-Val de Loire;36;4;10;102;Luçay-le-Libre;99;6;105
24;Centre-Val de Loire;36;2;13;103;Luçay-le-Mâle;1366;9;1375
24;Centre-Val de Loire;36;2;13;107;Lye;740;13;753
24;Centre-Val de Loire;36;3;11;108;Lys-Saint-Georges;221;2;223
24;Centre-Val de Loire;36;3;11;109;Le Magny;1085;20;1105
24;Centre-Val de Loire;36;3;11;110;Maillet;263;6;269
24;Centre-Val de Loire;36;3;11;111;Malicornay;195;3;198
24;Centre-Val de Loire;36;2;01;112;Mâron;762;18;780
24;Centre-Val de Loire;36;1;03;113;Martizay;952;20;972
24;Centre-Val de Loire;36;1;12;114;Mauvières;310;8;318
24;Centre-Val de Loire;36;4;13;115;Menetou-sur-Nahon;118;2;120
24;Centre-Val de Loire;36;4;10;116;Ménétréols-sous-Vatan;118;1;119
24;Centre-Val de Loire;36;2;02;117;Le Menoux;430;7;437
24;Centre-Val de Loire;36;2;12;118;Méobecq;374;2;376
24;Centre-Val de Loire;36;1;03;119;Mérigny;537;13;550
24;Centre-Val de Loire;36;3;11;120;Mers-sur-Indre;653;10;663
24;Centre-Val de Loire;36;4;08;121;Meunet-Planches;174;6;180
24;Centre-Val de Loire;36;4;10;122;Meunet-sur-Vatan;194;2;196
24;Centre-Val de Loire;36;1;03;123;Mézières-en-Brenne;1001;20;1021
24;Centre-Val de Loire;36;1;12;124;Migné;275;11;286
24;Centre-Val de Loire;36;4;09;125;Migny;129;6;135
24;Centre-Val de Loire;36;3;11;126;Montchevrier;451;5;456
24;Centre-Val de Loire;36;3;11;127;Montgivray;1600;37;1637
24;Centre-Val de Loire;36;2;01;128;Montierchaume;1643;166;1809
24;Centre-Val de Loire;36;3;11;129;Montipouret;556;14;570
24;Centre-Val de Loire;36;3;08;130;Montlevicq;115;1;116
24;Centre-Val de Loire;36;2;02;131;Mosnay;474;7;481
24;Centre-Val de Loire;36;3;08;132;La Motte-Feuilly;58;3;61
24;Centre-Val de Loire;36;3;11;133;Mouhers;229;5;234
24;Centre-Val de Loire;36;1;12;134;Mouhet;414;14;428
24;Centre-Val de Loire;36;2;10;135;Moulins-sur-Céphons;293;6;299
24;Centre-Val de Loire;36;2;04;136;Murs;127;3;130
24;Centre-Val de Loire;36;1;03;137;Néons-sur-Creuse;381;16;397
24;Centre-Val de Loire;36;3;08;138;Néret;191;7;198
24;Centre-Val de Loire;36;2;12;139;Neuillay-les-Bois;659;16;675
24;Centre-Val de Loire;36;4;08;140;Neuvy-Pailloux;1196;20;1216
24;Centre-Val de Loire;36;3;11;141;Neuvy-Saint-Sépulchre;1653;38;1691
24;Centre-Val de Loire;36;2;04;142;Niherne;1586;32;1618
24;Centre-Val de Loire;36;3;08;143;Nohant-Vic;450;14;464
24;Centre-Val de Loire;36;1;12;144;Nuret-le-Ferron;305;7;312
24;Centre-Val de Loire;36;1;03;145;Obterre;191;3;194
24;Centre-Val de Loire;36;3;11;146;Orsennes;758;9;767
24;Centre-Val de Loire;36;4;13;147;Orville;138;3;141
24;Centre-Val de Loire;36;1;12;148;Oulches;409;3;412
24;Centre-Val de Loire;36;2;04;149;Palluau-sur-Indre;789;12;801
24;Centre-Val de Loire;36;1;12;150;Parnac;501;13;514
24;Centre-Val de Loire;36;4;10;152;Paudy;452;3;455
24;Centre-Val de Loire;36;1;03;153;Paulnay;323;7;330
24;Centre-Val de Loire;36;2;02;154;Le Pêchereau;1863;40;1903
24;Centre-Val de Loire;36;2;13;155;Pellevoisin;758;58;816
24;Centre-Val de Loire;36;3;08;156;Pérassay;362;2;364
24;Centre-Val de Loire;36;1;12;157;La Pérouille;457;13;470
24;Centre-Val de Loire;36;2;01;159;Le Poinçonnet;5851;170;6021
24;Centre-Val de Loire;36;2;02;160;Pommiers;224;6;230
24;Centre-Val de Loire;36;2;02;161;Le Pont-Chrétien-Chabenet;925;11;936
24;Centre-Val de Loire;36;4;13;162;Poulaines;845;20;865
24;Centre-Val de Loire;36;3;08;163;Pouligny-Notre-Dame;720;3;723
24;Centre-Val de Loire;36;3;08;164;Pouligny-Saint-Martin;222;4;226
24;Centre-Val de Loire;36;1;03;165;Pouligny-Saint-Pierre;1069;28;1097
24;Centre-Val de Loire;36;2;13;166;Préaux;161;1;162
24;Centre-Val de Loire;36;1;03;167;Preuilly-la-Ville;162;4;166
24;Centre-Val de Loire;36;1;12;168;Prissac;613;15;628
24;Centre-Val de Loire;36;4;08;169;Pruniers;515;10;525
24;Centre-Val de Loire;36;4;10;170;Reboursin;109;1;110
24;Centre-Val de Loire;36;4;10;171;Reuilly;2025;39;2064
24;Centre-Val de Loire;36;1;12;172;Rivarennes;566;5;571
24;Centre-Val de Loire;36;1;03;173;Rosnay;519;13;532
24;Centre-Val de Loire;36;1;12;174;Roussines;360;11;371
24;Centre-Val de Loire;36;2;10;175;Rouvres-les-Bois;286;3;289
24;Centre-Val de Loire;36;1;03;176;Ruffec;589;8;597
24;Centre-Val de Loire;36;1;12;177;Sacierges-Saint-Martin;318;6;324
24;Centre-Val de Loire;36;1;03;178;Saint-Aigny;282;12;294
24;Centre-Val de Loire;36;4;10;179;Saint-Aoustrille;227;0;227
24;Centre-Val de Loire;36;3;08;180;Saint-Août;836;14;850
24;Centre-Val de Loire;36;4;08;181;Saint-Aubin;180;4;184
24;Centre-Val de Loire;36;1;12;182;Saint-Benoît-du-Sault;602;20;622
24;Centre-Val de Loire;36;3;08;184;Saint-Chartier;510;8;518
24;Centre-Val de Loire;36;4;13;185;Saint-Christophe-en-Bazelle;379;3;382
24;Centre-Val de Loire;36;3;08;186;Saint-Christophe-en-Boucherie;257;3;260
24;Centre-Val de Loire;36;1;12;187;Saint-Civran;140;2;142
24;Centre-Val de Loire;36;2;04;188;Saint-Cyran-du-Jambot;216;149;365
24;Centre-Val de Loire;36;3;11;189;Saint-Denis-de-Jouhet;971;12;983
24;Centre-Val de Loire;36;4;10;191;Saint-Florentin;534;7;541
24;Centre-Val de Loire;36;1;12;192;Saint-Gaultier;1833;23;1856
24;Centre-Val de Loire;36;2;04;194;Saint-Genou;971;16;987
24;Centre-Val de Loire;36;4;09;195;Saint-Georges-sur-Arnon;575;14;589
24;Centre-Val de Loire;36;1;12;196;Saint-Gilles;110;1;111
24;Centre-Val de Loire;36;1;12;197;Saint-Hilaire-sur-Benaize;302;8;310
24;Centre-Val de Loire;36;2;04;198;Saint-Lactencin;423;14;437
24;Centre-Val de Loire;36;2;02;200;Saint-Marcel;1585;19;1604
24;Centre-Val de Loire;36;2;89;202;Saint-Maur;3642;75;3717
24;Centre-Val de Loire;36;2;04;203;Saint-Médard;48;0;48
24;Centre-Val de Loire;36;1;03;204;Saint-Michel-en-Brenne;323;7;330
24;Centre-Val de Loire;36;4;10;205;Saint-Pierre-de-Jards;122;2;124
24;Centre-Val de Loire;36;3;11;207;Saint-Plantaire;616;14;630
24;Centre-Val de Loire;36;4;10;209;Saint-Valentin;279;11;290
24;Centre-Val de Loire;36;4;01;190;Sainte-Fauste;274;1;275
24;Centre-Val de Loire;36;1;03;193;Sainte-Gemme;262;8;270
24;Centre-Val de Loire;36;4;10;199;Sainte-Lizaigne;1176;24;1200
24;Centre-Val de Loire;36;3;08;208;Sainte-Sévère-sur-Indre;776;13;789
24;Centre-Val de Loire;36;3;11;210;Sarzay;307;11;318
24;Centre-Val de Loire;36;2;01;211;Sassierges-Saint-Germain;477;8;485
24;Centre-Val de Loire;36;1;03;212;Saulnay;157;3;160
24;Centre-Val de Loire;36;1;03;213;Sauzelles;245;4;249
24;Centre-Val de Loire;36;3;08;214;Sazeray;302;10;312
24;Centre-Val de Loire;36;4;09;215;Ségry;504;13;517
24;Centre-Val de Loire;36;2;13;216;Selles-sur-Nahon;70;2;72
24;Centre-Val de Loire;36;4;13;217;Sembleçay;101;3;104
24;Centre-Val de Loire;36;2;04;218;Sougé;143;5;148
24;Centre-Val de Loire;36;2;02;219;Tendu;648;7;655
24;Centre-Val de Loire;36;1;12;220;Thenay;891;19;910
24;Centre-Val de Loire;36;3;08;221;Thevet-Saint-Julien;389;8;397
24;Centre-Val de Loire;36;4;08;222;Thizay;232;7;239
24;Centre-Val de Loire;36;1;12;223;Tilly;137;4;141
24;Centre-Val de Loire;36;1;03;224;Tournon-Saint-Martin;1159;25;1184
24;Centre-Val de Loire;36;2;04;225;Le Tranger;176;1;177
24;Centre-Val de Loire;36;3;11;226;Tranzault;352;1;353
24;Centre-Val de Loire;36;3;08;227;Urciers;250;3;253
24;Centre-Val de Loire;36;4;13;229;Val-Fouzon;996;10;1006
24;Centre-Val de Loire;36;2;13;228;Valençay;2367;108;2475
24;Centre-Val de Loire;36;4;10;230;Vatan;1988;41;2029
24;Centre-Val de Loire;36;2;02;231;Velles;985;21;1006
24;Centre-Val de Loire;36;2;12;232;Vendœuvres;1064;16;1080
24;Centre-Val de Loire;36;2;13;233;La Vernelle;748;7;755
24;Centre-Val de Loire;36;3;08;234;Verneuil-sur-Igneraie;309;9;318
24;Centre-Val de Loire;36;2;13;235;Veuil;376;8;384
24;Centre-Val de Loire;36;3;08;236;Vicq-Exemplet;319;4;323
24;Centre-Val de Loire;36;2;13;237;Vicq-sur-Nahon;729;19;748
24;Centre-Val de Loire;36;3;08;238;Vigoulant;102;3;105
24;Centre-Val de Loire;36;1;12;239;Vigoux;461;5;466
24;Centre-Val de Loire;36;3;08;240;Vijon;303;4;307
24;Centre-Val de Loire;36;2;04;241;Villedieu-sur-Indre;2697;48;2745
24;Centre-Val de Loire;36;2;10;242;Villegongis;113;1;114
24;Centre-Val de Loire;36;2;13;243;Villegouin;331;5;336
24;Centre-Val de Loire;36;2;13;244;Villentrois-Faverolles-en-Berry;892;7;899
24;Centre-Val de Loire;36;1;03;246;Villiers;170;2;172
24;Centre-Val de Loire;36;2;10;247;Vineuil;1228;22;1250
24;Centre-Val de Loire;36;4;01;248;Vouillon;234;3;237
24;Centre-Val de Loire;37;3;06;001;Abilly;1151;19;1170
24;Centre-Val de Loire;37;1;08;002;Ambillou;1786;29;1815
24;Centre-Val de Loire;37;3;01;003;Amboise;12610;371;12981
24;Centre-Val de Loire;37;1;13;004;Anché;416;11;427
24;Centre-Val de Loire;37;1;13;005;Antogny-le-Tillac;510;5;515
24;Centre-Val de Loire;37;2;11;006;Artannes-sur-Indre;2628;41;2669
24;Centre-Val de Loire;37;1;13;007;Assay;166;4;170
24;Centre-Val de Loire;37;3;03;008;Athée-sur-Cher;2673;37;2710
24;Centre-Val de Loire;37;3;04;009;Autrèche;427;4;431
24;Centre-Val de Loire;37;3;04;010;Auzouer-en-Touraine;2216;69;2285
24;Centre-Val de Loire;37;1;05;011;Avoine;1743;37;1780
24;Centre-Val de Loire;37;1;13;012;Avon-les-Roches;548;3;551
24;Centre-Val de Loire;37;1;08;013;Avrillé-les-Ponceaux;481;9;490
24;Centre-Val de Loire;37;2;05;014;Azay-le-Rideau;3491;98;3589
24;Centre-Val de Loire;37;2;03;015;Azay-sur-Cher;3082;68;3150
24;Centre-Val de Loire;37;3;09;016;Azay-sur-Indre;385;12;397
24;Centre-Val de Loire;37;2;02;018;Ballan-Miré;7975;134;8109
24;Centre-Val de Loire;37;3;06;019;Barrou;470;10;480
24;Centre-Val de Loire;37;3;09;020;Beaulieu-lès-Loches;1767;36;1803
24;Centre-Val de Loire;37;1;05;022;Beaumont-en-Véron;2699;124;2823
24;Centre-Val de Loire;37;1;04;021;Beaumont-Louestault;1684;18;1702
24;Centre-Val de Loire;37;3;09;023;Beaumont-Village;259;4;263
24;Centre-Val de Loire;37;1;08;024;Benais;922;30;952
24;Centre-Val de Loire;37;2;02;025;Berthenay;708;6;714
24;Centre-Val de Loire;37;3;06;026;Betz-le-Château;571;8;579
24;Centre-Val de Loire;37;3;03;027;Bléré;5272;72;5344
24;Centre-Val de Loire;37;3;06;028;Bossay-sur-Claise;758;22;780
24;Centre-Val de Loire;37;3;06;029;Bossée;330;5;335
24;Centre-Val de Loire;37;3;04;030;Le Boulay;793;7;800
24;Centre-Val de Loire;37;1;08;031;Bourgueil;3923;76;3999
24;Centre-Val de Loire;37;3;06;032;Bournan;272;7;279
24;Centre-Val de Loire;37;3;06;033;Boussay;218;6;224
24;Centre-Val de Loire;37;1;13;034;Braslou;306;7;313
24;Centre-Val de Loire;37;1;13;035;Braye-sous-Faye;310;6;316
24;Centre-Val de Loire;37;1;08;036;Braye-sur-Maulne;172;5;177
24;Centre-Val de Loire;37;1;08;037;Brèches;248;4;252
24;Centre-Val de Loire;37;2;05;038;Bréhémont;769;7;776
24;Centre-Val de Loire;37;3;09;039;Bridoré;524;10;534
24;Centre-Val de Loire;37;1;13;040;Brizay;280;10;290
24;Centre-Val de Loire;37;1;04;041;Bueil-en-Touraine;319;9;328
24;Centre-Val de Loire;37;1;05;042;Candes-Saint-Martin;199;3;202
24;Centre-Val de Loire;37;3;01;043;Cangey;1062;24;1086
24;Centre-Val de Loire;37;3;06;044;La Celle-Guenand;372;5;377
24;Centre-Val de Loire;37;3;06;045;La Celle-Saint-Avant;1080;24;1104
24;Centre-Val de Loire;37;3;03;046;Céré-la-Ronde;459;3;462
24;Centre-Val de Loire;37;1;04;047;Cerelles;1198;26;1224
24;Centre-Val de Loire;37;3;06;048;Chambon;321;5;326
24;Centre-Val de Loire;37;3;09;049;Chambourg-sur-Indre;1291;25;1316
24;Centre-Val de Loire;37;2;10;050;Chambray-lès-Tours;11578;270;11848
24;Centre-Val de Loire;37;1;13;051;Champigny-sur-Veude;851;8;859
24;Centre-Val de Loire;37;3;09;053;Chanceaux-près-Loches;129;8;137
24;Centre-Val de Loire;37;2;19;054;Chanceaux-sur-Choisille;3515;48;3563
24;Centre-Val de Loire;37;1;08;055;Channay-sur-Lathan;841;14;855
24;Centre-Val de Loire;37;2;19;052;Chançay;1137;19;1156
24;Centre-Val de Loire;37;2;05;056;La Chapelle-aux-Naux;571;8;579
24;Centre-Val de Loire;37;3;06;057;La Chapelle-Blanche-Saint-Martin;685;14;699
24;Centre-Val de Loire;37;1;08;058;La Chapelle-sur-Loire;1433;28;1461
24;Centre-Val de Loire;37;1;04;059;Charentilly;1257;30;1287
24;Centre-Val de Loire;37;3;01;060;Chargé;1304;26;1330
24;Centre-Val de Loire;37;3;06;061;Charnizay;502;17;519
24;Centre-Val de Loire;37;1;08;062;Château-la-Vallière;1780;16;1796
24;Centre-Val de Loire;37;3;04;063;Château-Renault;5001;79;5080
24;Centre-Val de Loire;37;3;06;064;Chaumussay;226;7;233
24;Centre-Val de Loire;37;1;13;065;Chaveignes;552;5;557
24;Centre-Val de Loire;37;3;09;066;Chédigny;558;6;564
24;Centre-Val de Loire;37;2;05;067;Cheillé;1801;21;1822
24;Centre-Val de Loire;37;1;04;068;Chemillé-sur-Dême;719;9;728
24;Centre-Val de Loire;37;3;09;069;Chemillé-sur-Indrois;222;8;230
24;Centre-Val de Loire;37;3;03;070;Chenonceaux;351;5;356
24;Centre-Val de Loire;37;1;13;071;Chezelles;133;2;135
24;Centre-Val de Loire;37;1;05;072;Chinon;8242;325;8567
24;Centre-Val de Loire;37;3;03;073;Chisseaux;598;15;613
24;Centre-Val de Loire;37;1;08;074;Chouzé-sur-Loire;2081;24;2105
24;Centre-Val de Loire;37;3;03;075;Cigogné;434;5;439
24;Centre-Val de Loire;37;1;05;076;Cinais;423;14;437
24;Centre-Val de Loire;37;1;08;077;Cinq-Mars-la-Pile;3566;48;3614
24;Centre-Val de Loire;37;3;06;078;Ciran;414;8;422
24;Centre-Val de Loire;37;3;03;079;Civray-de-Touraine;1840;45;1885
24;Centre-Val de Loire;37;3;06;080;Civray-sur-Esves;202;3;205
24;Centre-Val de Loire;37;1;08;081;Cléré-les-Pins;1410;21;1431
24;Centre-Val de Loire;37;1;08;082;Continvoir;412;6;418
24;Centre-Val de Loire;37;3;03;083;Cormery;1780;25;1805
24;Centre-Val de Loire;37;1;08;232;Coteaux-sur-Loire;1926;22;1948
24;Centre-Val de Loire;37;1;08;084;Couesmes;501;6;507
24;Centre-Val de Loire;37;1;08;086;Courcelles-de-Touraine;494;7;501
24;Centre-Val de Loire;37;1;13;087;Courcoué;255;9;264
24;Centre-Val de Loire;37;3;03;085;Courçay;807;21;828
24;Centre-Val de Loire;37;1;05;088;Couziers;112;1;113
24;Centre-Val de Loire;37;1;13;089;Cravant-les-Côteaux;672;18;690
24;Centre-Val de Loire;37;1;13;090;Crissay-sur-Manse;99;2;101
24;Centre-Val de Loire;37;3;03;091;La Croix-en-Touraine;2294;60;2354
24;Centre-Val de Loire;37;3;04;092;Crotelles;691;6;697
24;Centre-Val de Loire;37;1;13;093;Crouzilles;531;6;537
24;Centre-Val de Loire;37;3;06;094;Cussay;570;17;587
24;Centre-Val de Loire;37;3;04;095;Dame-Marie-les-Bois;352;7;359
24;Centre-Val de Loire;37;3;06;115;Descartes;3489;65;3554
24;Centre-Val de Loire;37;3;03;096;Dierre;608;10;618
24;Centre-Val de Loire;37;3;09;097;Dolus-le-Sec;671;25;696
24;Centre-Val de Loire;37;3;06;098;Draché;745;19;764
24;Centre-Val de Loire;37;2;02;099;Druye;950;12;962
24;Centre-Val de Loire;37;3;03;100;Épeigné-les-Bois;423;7;430
24;Centre-Val de Loire;37;1;04;101;Épeigné-sur-Dême;159;2;161
24;Centre-Val de Loire;37;3;06;103;Esves-le-Moutier;144;2;146
24;Centre-Val de Loire;37;2;11;104;Esvres;6010;110;6120
24;Centre-Val de Loire;37;1;13;105;Faye-la-Vineuse;253;5;258
24;Centre-Val de Loire;37;3;04;106;La Ferrière;310;6;316
24;Centre-Val de Loire;37;3;06;107;Ferrière-Larçon;247;5;252
24;Centre-Val de Loire;37;3;09;108;Ferrière-sur-Beaulieu;734;18;752
24;Centre-Val de Loire;37;2;12;109;Fondettes;10307;492;10799
24;Centre-Val de Loire;37;3;03;110;Francueil;1377;33;1410
24;Centre-Val de Loire;37;3;09;111;Genillé;1521;17;1538
24;Centre-Val de Loire;37;1;08;112;Gizeux;390;6;396
24;Centre-Val de Loire;37;3;06;113;Le Grand-Pressigny;916;19;935
24;Centre-Val de Loire;37;3;06;114;La Guerche;180;1;181
24;Centre-Val de Loire;37;3;04;116;Les Hermites;562;16;578
24;Centre-Val de Loire;37;1;08;117;Hommes;886;8;894
24;Centre-Val de Loire;37;1;05;118;Huismes;1475;37;1512
24;Centre-Val de Loire;37;1;13;119;L' Île-Bouchard;1553;35;1588
24;Centre-Val de Loire;37;1;13;121;Jaulnay;258;4;262
24;Centre-Val de Loire;37;2;07;122;Joué-lès-Tours;37893;447;38340
24;Centre-Val de Loire;37;1;08;123;Langeais;4666;52;4718
24;Centre-Val de Loire;37;2;10;124;Larçay;2462;40;2502
24;Centre-Val de Loire;37;1;13;125;Lémeré;518;2;520
24;Centre-Val de Loire;37;1;05;126;Lerné;296;10;306
24;Centre-Val de Loire;37;3;09;127;Le Liège;364;9;373
24;Centre-Val de Loire;37;2;05;128;Lignières-de-Touraine;1308;19;1327
24;Centre-Val de Loire;37;1;13;129;Ligré;1065;21;1086
24;Centre-Val de Loire;37;3;06;130;Ligueil;2188;38;2226
24;Centre-Val de Loire;37;3;01;131;Limeray;1308;24;1332
24;Centre-Val de Loire;37;3;09;133;Loché-sur-Indrois;506;9;515
24;Centre-Val de Loire;37;3;09;132;Loches;6277;560;6837
24;Centre-Val de Loire;37;3;06;134;Louans;648;13;661
24;Centre-Val de Loire;37;3;06;136;Le Louroux;531;3;534
24;Centre-Val de Loire;37;1;08;137;Lublé;144;4;148
24;Centre-Val de Loire;37;3;01;138;Lussault-sur-Loire;789;15;804
24;Centre-Val de Loire;37;2;12;139;Luynes;5097;145;5242
24;Centre-Val de Loire;37;1;13;140;Luzé;250;5;255
24;Centre-Val de Loire;37;3;03;141;Luzillé;983;15;998
24;Centre-Val de Loire;37;1;13;142;Maillé;578;5;583
24;Centre-Val de Loire;37;3;06;143;Manthelan;1363;29;1392
24;Centre-Val de Loire;37;3;06;145;Marcé-sur-Esves;242;1;243
24;Centre-Val de Loire;37;1;08;146;Marcilly-sur-Maulne;230;5;235
24;Centre-Val de Loire;37;1;13;147;Marcilly-sur-Vienne;554;10;564
24;Centre-Val de Loire;37;1;13;148;Marigny-Marmande;595;6;601
24;Centre-Val de Loire;37;1;04;149;Marray;471;7;478
24;Centre-Val de Loire;37;1;05;144;Marçay;519;6;525
24;Centre-Val de Loire;37;1;08;150;Mazières-de-Touraine;1331;14;1345
24;Centre-Val de Loire;37;2;12;151;La Membrolle-sur-Choisille;3324;62;3386
24;Centre-Val de Loire;37;2;19;152;Mettray;2068;75;2143
24;Centre-Val de Loire;37;2;19;153;Monnaie;4439;50;4489
24;Centre-Val de Loire;37;2;11;154;Montbazon;4313;86;4399
24;Centre-Val de Loire;37;3;04;155;Monthodon;631;7;638
24;Centre-Val de Loire;37;2;10;156;Montlouis-sur-Loire;10666;151;10817
24;Centre-Val de Loire;37;3;09;157;Montrésor;341;5;346
24;Centre-Val de Loire;37;3;01;158;Montreuil-en-Touraine;832;14;846
24;Centre-Val de Loire;37;2;11;159;Monts;7794;141;7935
24;Centre-Val de Loire;37;3;04;160;Morand;347;6;353
24;Centre-Val de Loire;37;3;01;161;Mosnes;804;12;816
24;Centre-Val de Loire;37;3;06;162;Mouzay;474;17;491
24;Centre-Val de Loire;37;3;01;163;Nazelles-Négron;3532;58;3590
24;Centre-Val de Loire;37;1;13;165;Neuil;440;5;445
24;Centre-Val de Loire;37;3;01;166;Neuillé-le-Lierre;794;7;801
24;Centre-Val de Loire;37;1;04;167;Neuillé-Pont-Pierre;2004;37;2041
24;Centre-Val de Loire;37;3;06;168;Neuilly-le-Brignon;300;9;309
24;Centre-Val de Loire;37;3;04;169;Neuville-sur-Brenne;899;27;926
24;Centre-Val de Loire;37;1;04;170;Neuvy-le-Roi;1078;58;1136
24;Centre-Val de Loire;37;3;01;171;Noizay;1139;19;1158
24;Centre-Val de Loire;37;2;19;172;Notre-Dame-d'Oé;4125;80;4205
24;Centre-Val de Loire;37;3;09;173;Nouans-les-Fontaines;750;9;759
24;Centre-Val de Loire;37;1;13;174;Nouâtre;823;13;836
24;Centre-Val de Loire;37;3;04;175;Nouzilly;1250;30;1280
24;Centre-Val de Loire;37;1;13;176;Noyant-de-Touraine;1215;60;1275
24;Centre-Val de Loire;37;3;09;177;Orbigny;732;15;747
24;Centre-Val de Loire;37;1;13;178;Panzoult;595;4;599
24;Centre-Val de Loire;37;2;19;179;Parçay-Meslay;2369;29;2398
24;Centre-Val de Loire;37;1;13;180;Parçay-sur-Vienne;644;6;650
24;Centre-Val de Loire;37;3;06;181;Paulmy;233;10;243
24;Centre-Val de Loire;37;1;04;182;Pernay;1349;13;1362
24;Centre-Val de Loire;37;3;09;183;Perrusson;1486;28;1514
24;Centre-Val de Loire;37;3;06;184;Le Petit-Pressigny;336;7;343
24;Centre-Val de Loire;37;3;01;185;Pocé-sur-Cisse;1639;73;1712
24;Centre-Val de Loire;37;2;11;186;Pont-de-Ruan;1189;12;1201
24;Centre-Val de Loire;37;1;13;187;Ports;359;7;366
24;Centre-Val de Loire;37;1;13;188;Pouzay;878;7;885
24;Centre-Val de Loire;37;3;06;189;Preuilly-sur-Claise;1003;22;1025
24;Centre-Val de Loire;37;1;13;190;Pussigny;168;4;172
24;Centre-Val de Loire;37;1;13;191;Razines;236;6;242
24;Centre-Val de Loire;37;3;09;192;Reignac-sur-Indre;1238;18;1256
24;Centre-Val de Loire;37;1;08;193;Restigné;1226;26;1252
24;Centre-Val de Loire;37;2;19;194;Reugny;1690;33;1723
24;Centre-Val de Loire;37;2;02;195;La Riche;10448;95;10543
24;Centre-Val de Loire;37;1;13;196;Richelieu;1716;20;1736
24;Centre-Val de Loire;37;2;05;197;Rigny-Ussé;501;13;514
24;Centre-Val de Loire;37;1;08;198;Rillé;306;8;314
24;Centre-Val de Loire;37;1;13;199;Rilly-sur-Vienne;489;9;498
24;Centre-Val de Loire;37;2;05;200;Rivarennes;1004;12;1016
24;Centre-Val de Loire;37;1;05;201;Rivière;696;17;713
24;Centre-Val de Loire;37;1;05;202;La Roche-Clermault;518;11;529
24;Centre-Val de Loire;37;2;19;203;Rochecorbon;3146;91;3237
24;Centre-Val de Loire;37;1;04;204;Rouziers-de-Touraine;1317;22;1339
24;Centre-Val de Loire;37;2;05;205;Saché;1392;19;1411
24;Centre-Val de Loire;37;1;04;206;Saint-Antoine-du-Rocher;1720;37;1757
24;Centre-Val de Loire;37;1;04;207;Saint-Aubin-le-Dépeint;315;2;317
24;Centre-Val de Loire;37;2;14;208;Saint-Avertin;15025;315;15340
24;Centre-Val de Loire;37;1;05;210;Saint-Benoît-la-Forêt;851;17;868
24;Centre-Val de Loire;37;2;11;211;Saint-Branchs;2607;31;2638
24;Centre-Val de Loire;37;1;04;213;Saint-Christophe-sur-le-Nais;1127;16;1143
24;Centre-Val de Loire;37;2;12;214;Saint-Cyr-sur-Loire;15960;356;16316
24;Centre-Val de Loire;37;1;13;216;Saint-Épain;1572;24;1596
24;Centre-Val de Loire;37;2;12;217;Saint-Étienne-de-Chigny;1606;19;1625
24;Centre-Val de Loire;37;3;06;218;Saint-Flovier;566;8;574
24;Centre-Val de Loire;37;2;02;219;Saint-Genouph;1050;17;1067
24;Centre-Val de Loire;37;1;05;220;Saint-Germain-sur-Vienne;375;4;379
24;Centre-Val de Loire;37;3;09;221;Saint-Hippolyte;646;8;654
24;Centre-Val de Loire;37;3;09;222;Saint-Jean-Saint-Germain;762;27;789
24;Centre-Val de Loire;37;1;08;223;Saint-Laurent-de-Lin;322;1;323
24;Centre-Val de Loire;37;3;04;224;Saint-Laurent-en-Gâtines;948;15;963
24;Centre-Val de Loire;37;3;03;225;Saint-Martin-le-Beau;3156;58;3214
24;Centre-Val de Loire;37;1;08;228;Saint-Nicolas-de-Bourgueil;1109;14;1123
24;Centre-Val de Loire;37;3;04;229;Saint-Nicolas-des-Motets;261;7;268
24;Centre-Val de Loire;37;3;01;230;Saint-Ouen-les-Vignes;1016;28;1044
24;Centre-Val de Loire;37;1;04;231;Saint-Paterne-Racan;1665;28;1693
24;Centre-Val de Loire;37;2;14;233;Saint-Pierre-des-Corps;15838;238;16076
24;Centre-Val de Loire;37;3;09;234;Saint-Quentin-sur-Indrois;510;10;520
24;Centre-Val de Loire;37;3;01;236;Saint-Règle;609;11;620
24;Centre-Val de Loire;37;1;04;237;Saint-Roch;1255;18;1273
24;Centre-Val de Loire;37;3;09;238;Saint-Senoch;570;6;576
24;Centre-Val de Loire;37;2;13;212;Sainte-Catherine-de-Fierbois;761;11;772
24;Centre-Val de Loire;37;1;13;226;Sainte-Maure-de-Touraine;4214;50;4264
24;Centre-Val de Loire;37;3;04;240;Saunay;696;14;710
24;Centre-Val de Loire;37;1;08;241;Savigné-sur-Lathan;1349;19;1368
24;Centre-Val de Loire;37;1;05;242;Savigny-en-Véron;1542;30;1572
24;Centre-Val de Loire;37;2;02;243;Savonnières;3152;76;3228
24;Centre-Val de Loire;37;1;13;244;Sazilly;237;10;247
24;Centre-Val de Loire;37;1;04;245;Semblançay;2171;45;2216
24;Centre-Val de Loire;37;3;09;246;Sennevières;209;4;213
24;Centre-Val de Loire;37;3;06;247;Sepmes;630;9;639
24;Centre-Val de Loire;37;1;05;248;Seuilly;359;15;374
24;Centre-Val de Loire;37;1;04;249;Sonzay;1387;19;1406
24;Centre-Val de Loire;37;2;11;250;Sorigny;2643;75;2718
24;Centre-Val de Loire;37;1;08;251;Souvigné;840;10;850
24;Centre-Val de Loire;37;3;01;252;Souvigny-de-Touraine;391;4;395
24;Centre-Val de Loire;37;3;03;253;Sublaines;191;6;197
24;Centre-Val de Loire;37;3;09;254;Tauxigny-Saint-Bauld;1691;29;1720
24;Centre-Val de Loire;37;1;13;255;Tavant;263;1;264
24;Centre-Val de Loire;37;1;13;256;Theneuil;298;5;303
24;Centre-Val de Loire;37;2;05;257;Thilouze;1721;23;1744
24;Centre-Val de Loire;37;1;05;258;Thizay;281;4;285
24;Centre-Val de Loire;37;1;13;260;La Tour-Saint-Gelin;523;8;531
24;Centre-Val de Loire;37;3;06;259;Tournon-Saint-Pierre;459;11;470
24;Centre-Val de Loire;37;2;99;261;Tours;135787;2829;138616
24;Centre-Val de Loire;37;1;13;262;Trogues;310;4;314
24;Centre-Val de Loire;37;2;11;263;Truyes;2433;41;2474
24;Centre-Val de Loire;37;2;05;264;Vallères;1244;16;1260
24;Centre-Val de Loire;37;3;06;265;Varennes;246;4;250
24;Centre-Val de Loire;37;2;11;266;Veigné;6266;131;6397
24;Centre-Val de Loire;37;2;10;267;Véretz;4496;79;4575
24;Centre-Val de Loire;37;1;13;268;Verneuil-le-Château;126;0;126
24;Centre-Val de Loire;37;3;09;269;Verneuil-sur-Indre;480;21;501
24;Centre-Val de Loire;37;2;19;270;Vernou-sur-Brenne;2707;41;2748
24;Centre-Val de Loire;37;2;05;271;Villaines-les-Rochers;1067;11;1078
24;Centre-Val de Loire;37;2;02;272;Villandry;1114;36;1150
24;Centre-Val de Loire;37;2;10;273;La Ville-aux-Dames;5487;75;5562
24;Centre-Val de Loire;37;1;04;274;Villebourg;298;3;301
24;Centre-Val de Loire;37;3;09;275;Villedômain;115;3;118
24;Centre-Val de Loire;37;3;04;276;Villedômer;1359;31;1390
24;Centre-Val de Loire;37;3;09;277;Villeloin-Coulangé;599;4;603
24;Centre-Val de Loire;37;2;11;278;Villeperdue;1030;7;1037
24;Centre-Val de Loire;37;1;08;279;Villiers-au-Bouin;756;6;762
24;Centre-Val de Loire;37;3;06;280;Vou;199;9;208
24;Centre-Val de Loire;37;2;19;281;Vouvray;3238;72;3310
24;Centre-Val de Loire;37;3;06;282;Yzeures-sur-Creuse;1380;26;1406
84;Auvergne-Rhône-Alpes;38;2;03;001;Les Abrets en Dauphiné;6311;104;6415
84;Auvergne-Rhône-Alpes;38;1;13;002;Les Adrets;1006;23;1029
84;Auvergne-Rhône-Alpes;38;3;21;003;Agnin;1106;11;1117
84;Auvergne-Rhône-Alpes;38;1;23;004;L' Albenc;1244;22;1266
84;Auvergne-Rhône-Alpes;38;1;19;005;Allemond;971;18;989
84;Auvergne-Rhône-Alpes;38;1;13;006;Allevard;4102;108;4210
84;Auvergne-Rhône-Alpes;38;1;15;008;Ambel;28;0;28
84;Auvergne-Rhône-Alpes;38;3;21;009;Anjou;1013;23;1036
84;Auvergne-Rhône-Alpes;38;2;04;010;Annoisin-Chatelans;676;18;694
84;Auvergne-Rhône-Alpes;38;2;04;011;Anthon;1061;12;1073
84;Auvergne-Rhône-Alpes;38;2;03;012;Aoste;2878;54;2932
84;Auvergne-Rhône-Alpes;38;2;08;013;Apprieu;3313;88;3401
84;Auvergne-Rhône-Alpes;38;2;17;297;Arandon-Passins;1809;31;1840
84;Auvergne-Rhône-Alpes;38;3;26;015;Artas;1809;38;1847
84;Auvergne-Rhône-Alpes;38;3;28;017;Assieu;1472;21;1493
84;Auvergne-Rhône-Alpes;38;1;23;018;Auberives-en-Royans;376;11;387
84;Auvergne-Rhône-Alpes;38;3;28;019;Auberives-sur-Varèze;1484;29;1513
84;Auvergne-Rhône-Alpes;38;1;19;020;Auris;190;4;194
84;Auvergne-Rhône-Alpes;38;1;07;225;Autrans-Méaudre en Vercors;3000;116;3116
84;Auvergne-Rhône-Alpes;38;2;17;022;Les Avenières Veyrins-Thuellin;7739;157;7896
84;Auvergne-Rhône-Alpes;38;1;15;023;Avignonet;197;5;202
84;Auvergne-Rhône-Alpes;38;2;17;026;La Balme-les-Grottes;1060;12;1072
84;Auvergne-Rhône-Alpes;38;1;13;027;Barraux;1886;54;1940
84;Auvergne-Rhône-Alpes;38;2;24;029;La Bâtie-Montgascon;1919;42;1961
84;Auvergne-Rhône-Alpes;38;1;25;030;Beaucroissant;1682;30;1712
84;Auvergne-Rhône-Alpes;38;1;15;031;Beaufin;20;0;20
84;Auvergne-Rhône-Alpes;38;3;01;032;Beaufort;548;11;559
84;Auvergne-Rhône-Alpes;38;1;23;033;Beaulieu;638;19;657
84;Auvergne-Rhône-Alpes;38;3;21;034;Beaurepaire;4921;82;5003
84;Auvergne-Rhône-Alpes;38;3;01;035;Beauvoir-de-Marc;1121;15;1136
84;Auvergne-Rhône-Alpes;38;1;23;036;Beauvoir-en-Royans;92;2;94
84;Auvergne-Rhône-Alpes;38;3;21;037;Bellegarde-Poussieu;990;14;1004
84;Auvergne-Rhône-Alpes;38;2;08;038;Belmont;598;11;609
84;Auvergne-Rhône-Alpes;38;1;18;039;Bernin;3072;104;3176
84;Auvergne-Rhône-Alpes;38;1;19;040;Besse;126;4;130
84;Auvergne-Rhône-Alpes;38;1;23;041;Bessins;116;3;119
84;Auvergne-Rhône-Alpes;38;2;08;042;Bévenais;1008;20;1028
84;Auvergne-Rhône-Alpes;38;2;08;043;Bilieu;1544;42;1586
84;Auvergne-Rhône-Alpes;38;2;08;044;Biol;1419;40;1459
84;Auvergne-Rhône-Alpes;38;1;16;045;Biviers;2386;111;2497
84;Auvergne-Rhône-Alpes;38;2;08;046;Bizonnes;963;8;971
84;Auvergne-Rhône-Alpes;38;2;08;047;Blandin;145;3;148
84;Auvergne-Rhône-Alpes;38;2;26;048;Bonnefamille;1096;18;1114
84;Auvergne-Rhône-Alpes;38;3;01;049;Bossieu;294;7;301
84;Auvergne-Rhône-Alpes;38;2;17;050;Le Bouchage;623;9;632
84;Auvergne-Rhône-Alpes;38;3;21;051;Bougé-Chambalud;1375;21;1396
84;Auvergne-Rhône-Alpes;38;1;19;052;Le Bourg-d'Oisans;3278;102;3380
84;Auvergne-Rhône-Alpes;38;2;02;053;Bourgoin-Jallieu;28387;637;29024
84;Auvergne-Rhône-Alpes;38;2;17;054;Bouvesse-Quirieu;1512;21;1533
84;Auvergne-Rhône-Alpes;38;2;17;055;Brangues;626;8;634
84;Auvergne-Rhône-Alpes;38;3;01;056;Bressieux;93;2;95
84;Auvergne-Rhône-Alpes;38;1;05;057;Bresson;684;15;699
84;Auvergne-Rhône-Alpes;38;3;01;058;Brézins;2132;30;2162
84;Auvergne-Rhône-Alpes;38;1;20;059;Brié-et-Angonnes;2556;42;2598
84;Auvergne-Rhône-Alpes;38;3;01;060;Brion;144;5;149
84;Auvergne-Rhône-Alpes;38;1;29;061;La Buisse;3142;67;3209
84;Auvergne-Rhône-Alpes;38;1;13;062;La Buissière;669;19;688
84;Auvergne-Rhône-Alpes;38;2;08;063;Burcin;423;14;437
84;Auvergne-Rhône-Alpes;38;2;24;064;Cessieu;2984;75;3059
84;Auvergne-Rhône-Alpes;38;2;08;065;Châbons;2075;53;2128
84;Auvergne-Rhône-Alpes;38;3;21;066;Chalon;180;5;185
84;Auvergne-Rhône-Alpes;38;2;26;067;Chamagnieu;1674;37;1711
84;Auvergne-Rhône-Alpes;38;1;13;070;Le Champ-près-Froges;1197;14;1211
84;Auvergne-Rhône-Alpes;38;1;20;071;Champ-sur-Drac;3007;34;3041
84;Auvergne-Rhône-Alpes;38;1;20;068;Champagnier;1226;30;1256
84;Auvergne-Rhône-Alpes;38;3;01;069;Champier;1400;21;1421
84;Auvergne-Rhône-Alpes;38;1;19;567;Chamrousse;422;5;427
84;Auvergne-Rhône-Alpes;38;3;21;072;Chanas;2589;42;2631
84;Auvergne-Rhône-Alpes;38;1;15;073;Chantepérier;203;3;206
84;Auvergne-Rhône-Alpes;38;1;23;074;Chantesse;337;6;343
84;Auvergne-Rhône-Alpes;38;1;13;075;Chapareillan;3010;66;3076
84;Auvergne-Rhône-Alpes;38;2;24;076;La Chapelle-de-la-Tour;1807;65;1872
84;Auvergne-Rhône-Alpes;38;3;21;077;La Chapelle-de-Surieu;751;16;767
84;Auvergne-Rhône-Alpes;38;1;13;078;La Chapelle-du-Bard;571;7;578
84;Auvergne-Rhône-Alpes;38;2;03;080;Charancieu;774;20;794
84;Auvergne-Rhône-Alpes;38;3;26;081;Charantonnay;1911;42;1953
84;Auvergne-Rhône-Alpes;38;2;08;082;Charavines;1925;45;1970
84;Auvergne-Rhône-Alpes;38;2;17;083;Charette;459;15;474
84;Auvergne-Rhône-Alpes;38;1;25;084;Charnècles;1438;26;1464
84;Auvergne-Rhône-Alpes;38;2;04;085;Charvieu-Chavagneux;9661;79;9740
84;Auvergne-Rhône-Alpes;38;3;27;087;Chasse-sur-Rhône;6048;57;6105
84;Auvergne-Rhône-Alpes;38;1;23;086;Chasselay;406;8;414
84;Auvergne-Rhône-Alpes;38;2;08;089;Chassignieu;232;4;236
84;Auvergne-Rhône-Alpes;38;1;15;090;Château-Bernard;267;5;272
84;Auvergne-Rhône-Alpes;38;2;02;091;Châteauvilain;716;12;728
84;Auvergne-Rhône-Alpes;38;1;15;456;Châtel-en-Trièves;449;12;461
84;Auvergne-Rhône-Alpes;38;1;23;092;Châtelus;88;3;91
84;Auvergne-Rhône-Alpes;38;3;01;093;Châtenay;440;7;447
84;Auvergne-Rhône-Alpes;38;3;01;094;Châtonnay;2072;43;2115
84;Auvergne-Rhône-Alpes;38;1;23;095;Chatte;2512;209;2721
84;Auvergne-Rhône-Alpes;38;2;04;097;Chavanoz;4685;61;4746
84;Auvergne-Rhône-Alpes;38;2;08;098;Chélieu;676;14;690
84;Auvergne-Rhône-Alpes;38;1;23;099;Chevrières;708;23;731
84;Auvergne-Rhône-Alpes;38;1;13;100;Le Cheylas;2566;42;2608
84;Auvergne-Rhône-Alpes;38;3;28;101;Cheyssieu;1024;16;1040
84;Auvergne-Rhône-Alpes;38;2;14;102;Chèzeneuve;596;13;609
84;Auvergne-Rhône-Alpes;38;1;15;103;Chichilianne;305;2;307
84;Auvergne-Rhône-Alpes;38;2;03;104;Chimilin;1452;33;1485
84;Auvergne-Rhône-Alpes;38;1;08;105;Chirens;2337;44;2381
84;Auvergne-Rhône-Alpes;38;1;15;106;Cholonge;329;1;330
84;Auvergne-Rhône-Alpes;38;3;28;107;Chonas-l'Amballan;1668;52;1720
84;Auvergne-Rhône-Alpes;38;1;23;108;Choranche;121;0;121
84;Auvergne-Rhône-Alpes;38;2;04;109;Chozeau;1064;26;1090
84;Auvergne-Rhône-Alpes;38;3;27;110;Chuzelles;2181;46;2227
84;Auvergne-Rhône-Alpes;38;1;06;111;Claix;7932;197;8129
84;Auvergne-Rhône-Alpes;38;1;19;112;Clavans-en-Haut-Oisans;101;1;102
84;Auvergne-Rhône-Alpes;38;1;15;113;Clelles;543;6;549
84;Auvergne-Rhône-Alpes;38;3;28;114;Clonas-sur-Varèze;1458;32;1490
84;Auvergne-Rhône-Alpes;38;1;15;116;Cognet;42;0;42
84;Auvergne-Rhône-Alpes;38;1;23;117;Cognin-les-Gorges;635;11;646
84;Auvergne-Rhône-Alpes;38;2;08;118;Colombe;1574;43;1617
84;Auvergne-Rhône-Alpes;38;1;18;120;La Combe-de-Lancey;701;17;718
84;Auvergne-Rhône-Alpes;38;2;17;124;Corbelin;2235;47;2282
84;Auvergne-Rhône-Alpes;38;1;16;126;Corenc;4013;127;4140
84;Auvergne-Rhône-Alpes;38;1;15;127;Cornillon-en-Trièves;165;5;170
84;Auvergne-Rhône-Alpes;38;1;15;128;Corps;486;5;491
84;Auvergne-Rhône-Alpes;38;1;07;129;Corrençon-en-Vercors;354;18;372
84;Auvergne-Rhône-Alpes;38;3;01;130;La Côte-Saint-André;4811;286;5097
84;Auvergne-Rhône-Alpes;38;3;28;131;Les Côtes-d'Arey;2026;74;2100
84;Auvergne-Rhône-Alpes;38;1;15;132;Les Côtes-de-Corps;70;1;71
84;Auvergne-Rhône-Alpes;38;1;29;133;Coublevie;4836;395;5231
84;Auvergne-Rhône-Alpes;38;3;21;134;Cour-et-Buis;879;19;898
84;Auvergne-Rhône-Alpes;38;2;17;135;Courtenay;1276;21;1297
84;Auvergne-Rhône-Alpes;38;2;14;136;Crachier;508;15;523
84;Auvergne-Rhône-Alpes;38;1;23;137;Cras;438;13;451
84;Auvergne-Rhône-Alpes;38;2;04;138;Crémieu;3282;62;3344
84;Auvergne-Rhône-Alpes;38;1;13;439;Crêts en Belledonne;3339;53;3392
84;Auvergne-Rhône-Alpes;38;2;17;139;Creys-Mépieu;1503;19;1522
84;Auvergne-Rhône-Alpes;38;1;18;140;Crolles;8247;252;8499
84;Auvergne-Rhône-Alpes;38;3;14;141;Culin;745;14;759
84;Auvergne-Rhône-Alpes;38;1;19;253;Les Deux Alpes;1908;36;1944
84;Auvergne-Rhône-Alpes;38;3;26;144;Diémoz;2722;35;2757
84;Auvergne-Rhône-Alpes;38;2;04;146;Dizimieu;837;26;863
84;Auvergne-Rhône-Alpes;38;2;08;147;Doissin;881;25;906
84;Auvergne-Rhône-Alpes;38;2;24;148;Dolomieu;3167;71;3238
84;Auvergne-Rhône-Alpes;38;2;02;149;Domarin;1661;36;1697
84;Auvergne-Rhône-Alpes;38;1;16;150;Domène;6745;70;6815
84;Auvergne-Rhône-Alpes;38;1;05;151;Échirolles;36840;211;37051
84;Auvergne-Rhône-Alpes;38;2;02;152;Eclose-Badinières;1434;28;1462
84;Auvergne-Rhône-Alpes;38;1;07;153;Engins;465;10;475
84;Auvergne-Rhône-Alpes;38;1;15;154;Entraigues;230;2;232
84;Auvergne-Rhône-Alpes;38;1;03;155;Entre-deux-Guiers;1763;29;1792
84;Auvergne-Rhône-Alpes;38;2;02;156;Les Éparres;985;31;1016
84;Auvergne-Rhône-Alpes;38;3;28;157;Estrablin;3365;87;3452
84;Auvergne-Rhône-Alpes;38;1;05;158;Eybens;10185;117;10302
84;Auvergne-Rhône-Alpes;38;2;08;159;Eydoche;533;13;546
84;Auvergne-Rhône-Alpes;38;3;28;160;Eyzin-Pinet;2252;112;2364
84;Auvergne-Rhône-Alpes;38;3;01;161;Faramans;1038;6;1044
84;Auvergne-Rhône-Alpes;38;2;24;162;Faverges-de-la-Tour;1445;40;1485
84;Auvergne-Rhône-Alpes;38;1;13;166;La Flachère;490;14;504
84;Auvergne-Rhône-Alpes;38;2;08;167;Flachères;524;5;529
84;Auvergne-Rhône-Alpes;38;1;97;169;Fontaine;22523;267;22790
84;Auvergne-Rhône-Alpes;38;1;10;170;Fontanil-Cornillon;2710;39;2749
84;Auvergne-Rhône-Alpes;38;3;01;171;La Forteresse;322;4;326
84;Auvergne-Rhône-Alpes;38;2;14;172;Four;1494;30;1524
84;Auvergne-Rhône-Alpes;38;1;19;173;Le Freney-d'Oisans;252;6;258
84;Auvergne-Rhône-Alpes;38;3;01;174;La Frette;1094;23;1117
84;Auvergne-Rhône-Alpes;38;1;13;175;Froges;3331;61;3392
84;Auvergne-Rhône-Alpes;38;2;26;176;Frontonas;2069;53;2122
84;Auvergne-Rhône-Alpes;38;1;19;177;La Garde;98;0;98
84;Auvergne-Rhône-Alpes;38;1;22;179;Gières;6779;82;6861
84;Auvergne-Rhône-Alpes;38;3;01;180;Gillonnay;1012;28;1040
84;Auvergne-Rhône-Alpes;38;1;13;181;Goncelin;2425;36;2461
84;Auvergne-Rhône-Alpes;38;2;08;182;Le Grand-Lemps;3094;58;3152
84;Auvergne-Rhône-Alpes;38;2;03;183;Granieu;501;9;510
84;Auvergne-Rhône-Alpes;38;3;26;184;Grenay;1606;20;1626
84;Auvergne-Rhône-Alpes;38;1;98;185;Grenoble;158454;2171;160625
84;Auvergne-Rhône-Alpes;38;1;15;186;Gresse-en-Vercors;395;3;398
84;Auvergne-Rhône-Alpes;38;1;20;187;Le Gua;1779;25;1804
84;Auvergne-Rhône-Alpes;38;1;13;163;Le Haut-Bréda;398;11;409
84;Auvergne-Rhône-Alpes;38;1;20;188;Herbeys;1361;26;1387
84;Auvergne-Rhône-Alpes;38;3;26;189;Heyrieux;4731;64;4795
84;Auvergne-Rhône-Alpes;38;2;04;190;Hières-sur-Amby;1192;27;1219
84;Auvergne-Rhône-Alpes;38;1;19;191;Huez;1307;34;1341
84;Auvergne-Rhône-Alpes;38;1;13;192;Hurtières;168;6;174
84;Auvergne-Rhône-Alpes;38;2;14;193;L' Isle-d'Abeau;16124;281;16405
84;Auvergne-Rhône-Alpes;38;1;08;194;Izeaux;2147;34;2181
84;Auvergne-Rhône-Alpes;38;1;23;195;Izeron;726;9;735
84;Auvergne-Rhône-Alpes;38;2;04;197;Janneyrias;1829;16;1845
84;Auvergne-Rhône-Alpes;38;3;21;198;Jarcieu;1037;22;1059
84;Auvergne-Rhône-Alpes;38;3;28;199;Jardin;2207;57;2264
84;Auvergne-Rhône-Alpes;38;1;20;200;Jarrie;3746;68;3814
84;Auvergne-Rhône-Alpes;38;1;15;203;Laffrey;455;8;463
84;Auvergne-Rhône-Alpes;38;1;15;204;Lalley;193;6;199
84;Auvergne-Rhône-Alpes;38;1;07;205;Lans-en-Vercors;2651;125;2776
84;Auvergne-Rhône-Alpes;38;1;18;206;Laval;984;37;1021
84;Auvergne-Rhône-Alpes;38;1;15;207;Lavaldens;151;3;154
84;Auvergne-Rhône-Alpes;38;1;15;208;Lavars;148;3;151
84;Auvergne-Rhône-Alpes;38;3;01;209;Lentiol;222;7;229
84;Auvergne-Rhône-Alpes;38;2;04;210;Leyrieu;838;14;852
84;Auvergne-Rhône-Alpes;38;3;01;211;Lieudieu;341;5;346
84;Auvergne-Rhône-Alpes;38;1;19;212;Livet-et-Gavet;1315;10;1325
84;Auvergne-Rhône-Alpes;38;3;08;213;Longechenal;571;12;583
84;Auvergne-Rhône-Alpes;38;1;18;214;Lumbin;2136;72;2208
84;Auvergne-Rhône-Alpes;38;3;27;215;Luzinay;2302;43;2345
84;Auvergne-Rhône-Alpes;38;1;23;216;Malleval-en-Vercors;53;1;54
84;Auvergne-Rhône-Alpes;38;1;15;217;Marcieu;72;2;74
84;Auvergne-Rhône-Alpes;38;3;01;218;Marcilloles;1104;20;1124
84;Auvergne-Rhône-Alpes;38;3;01;219;Marcollin;670;10;680
84;Auvergne-Rhône-Alpes;38;3;01;221;Marnans;147;3;150
84;Auvergne-Rhône-Alpes;38;2;08;222;Massieu;747;17;764
84;Auvergne-Rhône-Alpes;38;2;14;223;Maubec;1745;61;1806
84;Auvergne-Rhône-Alpes;38;1;15;224;Mayres-Savel;97;4;101
84;Auvergne-Rhône-Alpes;38;1;15;226;Mens;1397;76;1473
84;Auvergne-Rhône-Alpes;38;2;03;228;Merlas;487;10;497
84;Auvergne-Rhône-Alpes;38;1;16;229;Meylan;17129;399;17528
84;Auvergne-Rhône-Alpes;38;2;02;230;Meyrié;995;40;1035
84;Auvergne-Rhône-Alpes;38;3;14;231;Meyrieu-les-Étangs;1015;40;1055
84;Auvergne-Rhône-Alpes;38;3;01;232;Meyssiez;637;8;645
84;Auvergne-Rhône-Alpes;38;1;15;235;Miribel-Lanchâtre;433;8;441
84;Auvergne-Rhône-Alpes;38;1;03;236;Miribel-les-Échelles;1721;38;1759
84;Auvergne-Rhône-Alpes;38;1;19;237;Mizoën;191;4;195
84;Auvergne-Rhône-Alpes;38;3;27;238;Moidieu-Détourbe;1889;35;1924
84;Auvergne-Rhône-Alpes;38;1;25;239;Moirans;7852;162;8014
84;Auvergne-Rhône-Alpes;38;3;21;240;Moissieu-sur-Dolon;707;14;721
84;Auvergne-Rhône-Alpes;38;1;15;241;Monestier-d'Ambel;21;0;21
84;Auvergne-Rhône-Alpes;38;1;15;242;Monestier-de-Clermont;1427;31;1458
84;Auvergne-Rhône-Alpes;38;1;15;243;Le Monestier-du-Percy;251;6;257
84;Auvergne-Rhône-Alpes;38;3;21;244;Monsteroux-Milieu;792;19;811
84;Auvergne-Rhône-Alpes;38;1;10;258;Mont-Saint-Martin;79;4;83
84;Auvergne-Rhône-Alpes;38;1;23;245;Montagne;266;6;272
84;Auvergne-Rhône-Alpes;38;2;24;246;Montagnieu;1084;17;1101
84;Auvergne-Rhône-Alpes;38;2;17;247;Montalieu-Vercieu;3368;51;3419
84;Auvergne-Rhône-Alpes;38;1;25;248;Montaud;543;22;565
84;Auvergne-Rhône-Alpes;38;1;16;249;Montbonnot-Saint-Martin;5134;558;5692
84;Auvergne-Rhône-Alpes;38;2;24;250;Montcarra;532;8;540
84;Auvergne-Rhône-Alpes;38;1;19;252;Montchaboud;339;9;348
84;Auvergne-Rhône-Alpes;38;1;15;254;Monteynard;487;12;499
84;Auvergne-Rhône-Alpes;38;3;01;255;Montfalcon;133;0;133
84;Auvergne-Rhône-Alpes;38;2;08;256;Montferrat;1786;23;1809
84;Auvergne-Rhône-Alpes;38;2;08;257;Montrevel;451;12;463
84;Auvergne-Rhône-Alpes;38;3;21;259;Montseveroux;961;16;977
84;Auvergne-Rhône-Alpes;38;2;04;260;Moras;511;18;529
84;Auvergne-Rhône-Alpes;38;2;17;261;Morestel;4469;99;4568
84;Auvergne-Rhône-Alpes;38;1;23;263;Morette;428;7;435
84;Auvergne-Rhône-Alpes;38;1;19;264;La Morte;132;0;132
84;Auvergne-Rhône-Alpes;38;1;15;265;La Motte-d'Aveillans;1712;22;1734
84;Auvergne-Rhône-Alpes;38;1;15;266;La Motte-Saint-Martin;444;9;453
84;Auvergne-Rhône-Alpes;38;3;01;267;Mottier;715;12;727
84;Auvergne-Rhône-Alpes;38;1;13;268;Le Moutaret;261;3;264
84;Auvergne-Rhône-Alpes;38;1;15;269;La Mure;4948;209;5157
84;Auvergne-Rhône-Alpes;38;1;29;270;La Murette;1884;65;1949
84;Auvergne-Rhône-Alpes;38;1;16;271;Murianette;882;11;893
84;Auvergne-Rhône-Alpes;38;1;23;272;Murinais;397;8;405
84;Auvergne-Rhône-Alpes;38;1;15;273;Nantes-en-Ratier;466;19;485
84;Auvergne-Rhône-Alpes;38;2;02;276;Nivolas-Vermelle;2649;53;2702
84;Auvergne-Rhône-Alpes;38;1;20;277;Notre-Dame-de-Commiers;518;6;524
84;Auvergne-Rhône-Alpes;38;1;23;278;Notre-Dame-de-l'Osier;492;9;501
84;Auvergne-Rhône-Alpes;38;1;19;279;Notre-Dame-de-Mésage;1147;12;1159
84;Auvergne-Rhône-Alpes;38;1;15;280;Notre-Dame-de-Vaulx;509;22;531
84;Auvergne-Rhône-Alpes;38;1;07;281;Noyarey;2223;76;2299
84;Auvergne-Rhône-Alpes;38;2;17;282;Optevoz;843;15;858
84;Auvergne-Rhône-Alpes;38;1;15;283;Oris-en-Rattier;114;4;118
84;Auvergne-Rhône-Alpes;38;3;01;284;Ornacieux-Balbins;844;26;870
84;Auvergne-Rhône-Alpes;38;1;19;285;Ornon;152;4;156
84;Auvergne-Rhône-Alpes;38;1;19;286;Oulles;7;0;7
84;Auvergne-Rhône-Alpes;38;2;08;287;Oyeu;1006;19;1025
84;Auvergne-Rhône-Alpes;38;3;26;288;Oytier-Saint-Oblas;1637;26;1663
84;Auvergne-Rhône-Alpes;38;1;19;289;Oz;235;4;239
84;Auvergne-Rhône-Alpes;38;3;21;290;Pact;841;15;856
84;Auvergne-Rhône-Alpes;38;3;01;291;Pajay;1146;18;1164
84;Auvergne-Rhône-Alpes;38;2;04;294;Panossas;666;16;682
84;Auvergne-Rhône-Alpes;38;2;17;295;Parmilieu;709;12;721
84;Auvergne-Rhône-Alpes;38;2;24;296;Le Passage;793;42;835
84;Auvergne-Rhône-Alpes;38;3;21;298;Le Péage-de-Roussillon;6680;76;6756
84;Auvergne-Rhône-Alpes;38;1;15;299;Pellafol;136;2;138
84;Auvergne-Rhône-Alpes;38;3;01;300;Penol;350;9;359
84;Auvergne-Rhône-Alpes;38;1;15;301;Percy;172;4;176
84;Auvergne-Rhône-Alpes;38;1;13;303;La Pierre;574;5;579
84;Auvergne-Rhône-Alpes;38;1;15;304;Pierre-Châtel;1496;36;1532
84;Auvergne-Rhône-Alpes;38;3;21;307;Pisieu;531;9;540
84;Auvergne-Rhône-Alpes;38;3;01;308;Plan;261;2;263
84;Auvergne-Rhône-Alpes;38;1;18;395;Plateau-des-Petites-Roches;2434;74;2508
84;Auvergne-Rhône-Alpes;38;1;22;309;Poisat;2168;28;2196
84;Auvergne-Rhône-Alpes;38;1;25;310;Poliénas;1188;16;1204
84;Auvergne-Rhône-Alpes;38;3;21;311;Pommier-de-Beaurepaire;704;15;719
84;Auvergne-Rhône-Alpes;38;1;15;313;Ponsonnas;291;15;306
84;Auvergne-Rhône-Alpes;38;2;03;315;Le Pont-de-Beauvoisin;3630;141;3771
84;Auvergne-Rhône-Alpes;38;2;04;316;Pont-de-Chéruy;5772;42;5814
84;Auvergne-Rhône-Alpes;38;1;20;317;Le Pont-de-Claix;10435;63;10498
84;Auvergne-Rhône-Alpes;38;1;23;319;Pont-en-Royans;774;33;807
84;Auvergne-Rhône-Alpes;38;3;27;318;Pont-Évêque;5210;49;5259
84;Auvergne-Rhône-Alpes;38;1;13;314;Pontcharra;7344;170;7514
84;Auvergne-Rhône-Alpes;38;2;17;320;Porcieu-Amblagnieu;1766;40;1806
84;Auvergne-Rhône-Alpes;38;3;01;479;Porte-des-Bonnevaux;2015;52;2067
84;Auvergne-Rhône-Alpes;38;1;15;321;Prébois;164;8;172
84;Auvergne-Rhône-Alpes;38;1;23;322;Presles;87;2;89
84;Auvergne-Rhône-Alpes;38;2;03;323;Pressins;1156;22;1178
84;Auvergne-Rhône-Alpes;38;3;21;324;Primarette;720;18;738
84;Auvergne-Rhône-Alpes;38;1;10;325;Proveysieux;507;9;516
84;Auvergne-Rhône-Alpes;38;1;15;326;Prunières;355;5;360
84;Auvergne-Rhône-Alpes;38;1;10;328;Quaix-en-Chartreuse;893;32;925
84;Auvergne-Rhône-Alpes;38;1;15;329;Quet-en-Beaumont;67;0;67
84;Auvergne-Rhône-Alpes;38;1;23;330;Quincieu;103;0;103
84;Auvergne-Rhône-Alpes;38;1;25;331;Réaumont;1021;32;1053
84;Auvergne-Rhône-Alpes;38;1;25;332;Renage;3507;54;3561
84;Auvergne-Rhône-Alpes;38;1;23;333;Rencurel;322;6;328
84;Auvergne-Rhône-Alpes;38;1;18;334;Revel;1314;40;1354
84;Auvergne-Rhône-Alpes;38;3;21;335;Revel-Tourdan;1053;39;1092
84;Auvergne-Rhône-Alpes;38;3;28;336;Reventin-Vaugris;1909;39;1948
84;Auvergne-Rhône-Alpes;38;1;25;337;Rives;6476;80;6556
84;Auvergne-Rhône-Alpes;38;1;23;338;La Rivière;747;9;756
84;Auvergne-Rhône-Alpes;38;2;26;339;Roche;2083;53;2136
84;Auvergne-Rhône-Alpes;38;3;28;340;Les Roches-de-Condrieu;1925;36;1961
84;Auvergne-Rhône-Alpes;38;2;24;341;Rochetoirin;1116;40;1156
84;Auvergne-Rhône-Alpes;38;1;15;342;Roissard;306;7;313
84;Auvergne-Rhône-Alpes;38;2;03;343;Romagnieu;1580;31;1611
84;Auvergne-Rhône-Alpes;38;3;21;344;Roussillon;8455;131;8586
84;Auvergne-Rhône-Alpes;38;1;23;345;Rovon;609;11;620
84;Auvergne-Rhône-Alpes;38;3;01;346;Royas;396;8;404
84;Auvergne-Rhône-Alpes;38;3;01;347;Roybon;1157;28;1185
84;Auvergne-Rhône-Alpes;38;2;02;348;Ruy-Montceau;4529;102;4631
84;Auvergne-Rhône-Alpes;38;3;21;349;Sablons;2309;22;2331
84;Auvergne-Rhône-Alpes;38;3;14;351;Saint-Agnin-sur-Bion;1043;21;1064
84;Auvergne-Rhône-Alpes;38;2;14;352;Saint-Alban-de-Roche;1982;56;2038
84;Auvergne-Rhône-Alpes;38;3;28;353;Saint-Alban-du-Rhône;842;18;860
84;Auvergne-Rhône-Alpes;38;2;03;354;Saint-Albin-de-Vaulserre;405;5;410
84;Auvergne-Rhône-Alpes;38;1;15;355;Saint-Andéol;122;6;128
84;Auvergne-Rhône-Alpes;38;1;23;356;Saint-André-en-Royans;315;18;333
84;Auvergne-Rhône-Alpes;38;2;24;357;Saint-André-le-Gaz;2793;152;2945
84;Auvergne-Rhône-Alpes;38;1;23;359;Saint Antoine l'Abbaye;1155;30;1185
84;Auvergne-Rhône-Alpes;38;1;23;360;Saint-Appolinard;409;8;417
84;Auvergne-Rhône-Alpes;38;1;15;361;Saint-Arey;84;5;89
84;Auvergne-Rhône-Alpes;38;1;29;362;Saint-Aupre;1137;52;1189
84;Auvergne-Rhône-Alpes;38;3;21;363;Saint-Barthélemy;941;38;979
84;Auvergne-Rhône-Alpes;38;1;19;364;Saint-Barthélemy-de-Séchilienne;433;4;437
84;Auvergne-Rhône-Alpes;38;2;04;365;Saint-Baudille-de-la-Tour;814;20;834
84;Auvergne-Rhône-Alpes;38;1;15;366;Saint-Baudille-et-Pipet;257;8;265
84;Auvergne-Rhône-Alpes;38;1;25;368;Saint-Blaise-du-Buis;1062;25;1087
84;Auvergne-Rhône-Alpes;38;1;23;370;Saint-Bonnet-de-Chavagne;634;18;652
84;Auvergne-Rhône-Alpes;38;2;03;372;Saint-Bueil;723;11;734
84;Auvergne-Rhône-Alpes;38;1;29;373;Saint-Cassien;1162;43;1205
84;Auvergne-Rhône-Alpes;38;2;02;374;Saint-Chef;3585;119;3704
84;Auvergne-Rhône-Alpes;38;1;19;375;Saint-Christophe-en-Oisans;107;0;107
84;Auvergne-Rhône-Alpes;38;1;03;376;Saint-Christophe-sur-Guiers;838;9;847
84;Auvergne-Rhône-Alpes;38;2;24;377;Saint-Clair-de-la-Tour;3424;59;3483
84;Auvergne-Rhône-Alpes;38;3;28;378;Saint-Clair-du-Rhône;3817;87;3904
84;Auvergne-Rhône-Alpes;38;3;01;379;Saint-Clair-sur-Galaure;282;4;286
84;Auvergne-Rhône-Alpes;38;2;08;380;Saint-Didier-de-Bizonnes;302;4;306
84;Auvergne-Rhône-Alpes;38;2;24;381;Saint-Didier-de-la-Tour;2045;51;2096
84;Auvergne-Rhône-Alpes;38;1;10;382;Saint-Égrève;15838;256;16094
84;Auvergne-Rhône-Alpes;38;1;29;383;Saint-Étienne-de-Crossey;2542;105;2647
84;Auvergne-Rhône-Alpes;38;3;01;384;Saint-Étienne-de-Saint-Geoirs;3225;44;3269
84;Auvergne-Rhône-Alpes;38;2;03;386;Saint-Geoire-en-Valdaine;2399;42;2441
84;Auvergne-Rhône-Alpes;38;3;01;387;Saint-Geoirs;516;13;529
84;Auvergne-Rhône-Alpes;38;3;26;389;Saint-Georges-d'Espéranche;3354;66;3420
84;Auvergne-Rhône-Alpes;38;1;20;388;Saint-Georges-de-Commiers;2276;30;2306
84;Auvergne-Rhône-Alpes;38;1;23;390;Saint-Gervais;549;9;558
84;Auvergne-Rhône-Alpes;38;1;15;391;Saint-Guillaume;258;5;263
84;Auvergne-Rhône-Alpes;38;2;04;392;Saint-Hilaire-de-Brens;636;17;653
84;Auvergne-Rhône-Alpes;38;3;01;393;Saint-Hilaire-de-la-Côte;1504;32;1536
84;Auvergne-Rhône-Alpes;38;1;23;394;Saint-Hilaire-du-Rosier;1886;30;1916
84;Auvergne-Rhône-Alpes;38;1;15;396;Saint-Honoré;814;27;841
84;Auvergne-Rhône-Alpes;38;1;18;397;Saint-Ismier;6966;322;7288
84;Auvergne-Rhône-Alpes;38;2;03;398;Saint-Jean-d'Avelanne;966;13;979
84;Auvergne-Rhône-Alpes;38;1;15;403;Saint-Jean-d'Hérans;288;7;295
84;Auvergne-Rhône-Alpes;38;3;14;399;Saint-Jean-de-Bournay;4594;105;4699
84;Auvergne-Rhône-Alpes;38;1;25;400;Saint-Jean-de-Moirans;3536;80;3616
84;Auvergne-Rhône-Alpes;38;2;24;401;Saint-Jean-de-Soudain;1585;30;1615
84;Auvergne-Rhône-Alpes;38;1;15;402;Saint-Jean-de-Vaulx;532;19;551
84;Auvergne-Rhône-Alpes;38;1;18;404;Saint-Jean-le-Vieux;292;4;296
84;Auvergne-Rhône-Alpes;38;1;03;405;Saint-Joseph-de-Rivière;1219;28;1247
84;Auvergne-Rhône-Alpes;38;3;21;406;Saint-Julien-de-l'Herms;149;5;154
84;Auvergne-Rhône-Alpes;38;3;26;408;Saint-Just-Chaleyssin;2568;58;2626
84;Auvergne-Rhône-Alpes;38;1;23;409;Saint-Just-de-Claix;1212;24;1236
84;Auvergne-Rhône-Alpes;38;1;23;410;Saint-Lattier;1338;23;1361
84;Auvergne-Rhône-Alpes;38;1;03;412;Saint-Laurent-du-Pont;4531;93;4624
84;Auvergne-Rhône-Alpes;38;1;15;413;Saint-Laurent-en-Beaumont;454;9;463
84;Auvergne-Rhône-Alpes;38;2;02;415;Saint-Marcel-Bel-Accueil;1393;38;1431
84;Auvergne-Rhône-Alpes;38;1;23;416;Saint-Marcellin;7903;199;8102
84;Auvergne-Rhône-Alpes;38;1;22;421;Saint-Martin-d'Hères;38487;268;38755
84;Auvergne-Rhône-Alpes;38;1;19;422;Saint-Martin-d'Uriage;5451;174;5625
84;Auvergne-Rhône-Alpes;38;1;15;419;Saint-Martin-de-Clelles;186;2;188
84;Auvergne-Rhône-Alpes;38;1;15;115;Saint-Martin-de-la-Cluze;717;17;734
84;Auvergne-Rhône-Alpes;38;2;03;420;Saint-Martin-de-Vaulserre;260;5;265
84;Auvergne-Rhône-Alpes;38;1;10;423;Saint-Martin-le-Vinoux;5778;61;5839
84;Auvergne-Rhône-Alpes;38;1;15;424;Saint-Maurice-en-Trièves;155;4;159
84;Auvergne-Rhône-Alpes;38;3;28;425;Saint-Maurice-l'Exil;6141;91;6232
84;Auvergne-Rhône-Alpes;38;1;13;426;Saint-Maximin;654;15;669
84;Auvergne-Rhône-Alpes;38;3;01;427;Saint-Michel-de-Saint-Geoirs;304;4;308
84;Auvergne-Rhône-Alpes;38;1;15;428;Saint-Michel-en-Beaumont;31;0;31
84;Auvergne-Rhône-Alpes;38;1;15;429;Saint-Michel-les-Portes;269;8;277
84;Auvergne-Rhône-Alpes;38;1;18;430;Saint-Mury-Monteymond;320;7;327
84;Auvergne-Rhône-Alpes;38;1;18;431;Saint-Nazaire-les-Eymes;2955;89;3044
84;Auvergne-Rhône-Alpes;38;1;29;432;Saint-Nicolas-de-Macherin;938;24;962
84;Auvergne-Rhône-Alpes;38;1;07;433;Saint-Nizier-du-Moucherotte;1098;31;1129
84;Auvergne-Rhône-Alpes;38;2;08;434;Saint-Ondras;640;6;646
84;Auvergne-Rhône-Alpes;38;3;01;437;Saint-Paul-d'Izeaux;295;6;301
84;Auvergne-Rhône-Alpes;38;1;20;436;Saint-Paul-de-Varces;2173;38;2211
84;Auvergne-Rhône-Alpes;38;1;15;438;Saint-Paul-lès-Monestier;267;1;268
84;Auvergne-Rhône-Alpes;38;1;03;446;Saint-Pierre-d'Entremont;571;14;585
84;Auvergne-Rhône-Alpes;38;3;01;440;Saint-Pierre-de-Bressieux;761;16;777
84;Auvergne-Rhône-Alpes;38;1;03;442;Saint-Pierre-de-Chartreuse;1015;28;1043
84;Auvergne-Rhône-Alpes;38;1;23;443;Saint-Pierre-de-Chérennes;464;12;476
84;Auvergne-Rhône-Alpes;38;1;15;444;Saint-Pierre-de-Méaroz;126;7;133
84;Auvergne-Rhône-Alpes;38;1;19;445;Saint-Pierre-de-Mésage;764;6;770
84;Auvergne-Rhône-Alpes;38;3;28;448;Saint-Prim;1372;30;1402
84;Auvergne-Rhône-Alpes;38;2;26;449;Saint-Quentin-Fallavier;6103;66;6169
84;Auvergne-Rhône-Alpes;38;1;25;450;Saint-Quentin-sur-Isère;1451;19;1470
84;Auvergne-Rhône-Alpes;38;2;04;451;Saint-Romain-de-Jalionas;3288;41;3329
84;Auvergne-Rhône-Alpes;38;3;21;452;Saint-Romain-de-Surieu;353;9;362
84;Auvergne-Rhône-Alpes;38;1;23;453;Saint-Romans;1778;41;1819
84;Auvergne-Rhône-Alpes;38;1;23;454;Saint-Sauveur;2098;48;2146
84;Auvergne-Rhône-Alpes;38;2;02;455;Saint-Savin;4076;80;4156
84;Auvergne-Rhône-Alpes;38;3;01;457;Saint-Siméon-de-Bressieux;2887;64;2951
84;Auvergne-Rhône-Alpes;38;2;17;458;Saint-Sorlin-de-Morestel;627;16;643
84;Auvergne-Rhône-Alpes;38;3;28;459;Saint-Sorlin-de-Vienne;878;7;885
84;Auvergne-Rhône-Alpes;38;2;08;460;Saint-Sulpice-des-Rivoires;430;8;438
84;Auvergne-Rhône-Alpes;38;1;15;462;Saint-Théoffrey;521;15;536
84;Auvergne-Rhône-Alpes;38;1;23;463;Saint-Vérand;1721;40;1761
84;Auvergne-Rhône-Alpes;38;2;24;464;Saint-Victor-de-Cessieu;2240;49;2289
84;Auvergne-Rhône-Alpes;38;2;17;465;Saint-Victor-de-Morestel;1092;22;1114
84;Auvergne-Rhône-Alpes;38;1;13;466;Saint-Vincent-de-Mercuze;1519;49;1568
84;Auvergne-Rhône-Alpes;38;1;18;350;Sainte-Agnès;563;18;581
84;Auvergne-Rhône-Alpes;38;3;01;358;Sainte-Anne-sur-Gervonde;692;10;702
84;Auvergne-Rhône-Alpes;38;2;24;369;Sainte-Blandine;977;36;1013
84;Auvergne-Rhône-Alpes;38;1;15;414;Sainte-Luce;43;0;43
84;Auvergne-Rhône-Alpes;38;1;13;417;Sainte-Marie-d'Alloix;478;17;495
84;Auvergne-Rhône-Alpes;38;1;13;418;Sainte-Marie-du-Mont;237;2;239
84;Auvergne-Rhône-Alpes;38;2;02;467;Salagnon;1420;38;1458
84;Auvergne-Rhône-Alpes;38;3;21;468;Salaise-sur-Sanne;4513;72;4585
84;Auvergne-Rhône-Alpes;38;1;15;469;La Salette-Fallavaux;65;1;66
84;Auvergne-Rhône-Alpes;38;1;15;470;La Salle-en-Beaumont;318;5;323
84;Auvergne-Rhône-Alpes;38;1;16;471;Le Sappey-en-Chartreuse;1121;30;1151
84;Auvergne-Rhône-Alpes;38;1;10;472;Sarcenas;189;8;197
84;Auvergne-Rhône-Alpes;38;3;01;473;Sardieu;1124;21;1145
84;Auvergne-Rhône-Alpes;38;1;07;474;Sassenage;11376;201;11577
84;Auvergne-Rhône-Alpes;38;2;26;475;Satolas-et-Bonce;2419;27;2446
84;Auvergne-Rhône-Alpes;38;3;01;476;Savas-Mépin;895;10;905
84;Auvergne-Rhône-Alpes;38;1;19;478;Séchilienne;1052;13;1065
84;Auvergne-Rhône-Alpes;38;3;27;480;Septème;2063;42;2105
84;Auvergne-Rhône-Alpes;38;2;02;481;Sérézin-de-la-Tour;1057;31;1088
84;Auvergne-Rhône-Alpes;38;2;17;483;Sermérieu;1668;39;1707
84;Auvergne-Rhône-Alpes;38;3;27;484;Serpaize;1939;25;1964
84;Auvergne-Rhône-Alpes;38;1;23;275;Serre-Nerpol;296;34;330
84;Auvergne-Rhône-Alpes;38;1;06;485;Seyssinet-Pariset;12013;158;12171
84;Auvergne-Rhône-Alpes;38;1;06;486;Seyssins;7685;106;7791
84;Auvergne-Rhône-Alpes;38;3;27;487;Seyssuel;2003;52;2055
84;Auvergne-Rhône-Alpes;38;2;04;488;Siccieu-Saint-Julien-et-Carisieu;583;16;599
84;Auvergne-Rhône-Alpes;38;1;15;489;Siévoz;136;2;138
84;Auvergne-Rhône-Alpes;38;3;01;490;Sillans;1909;46;1955
84;Auvergne-Rhône-Alpes;38;1;15;492;Sinard;692;23;715
84;Auvergne-Rhône-Alpes;38;2;17;494;Soleymieu;777;20;797
84;Auvergne-Rhône-Alpes;38;1;23;495;La Sône;584;4;588
84;Auvergne-Rhône-Alpes;38;3;21;496;Sonnay;1241;25;1266
84;Auvergne-Rhône-Alpes;38;1;15;497;Sousville;140;0;140
84;Auvergne-Rhône-Alpes;38;2;02;498;Succieu;735;21;756
84;Auvergne-Rhône-Alpes;38;1;29;407;La Sure en Chartreuse;984;37;1021
84;Auvergne-Rhône-Alpes;38;1;15;499;Susville;1272;32;1304
84;Auvergne-Rhône-Alpes;38;1;23;500;Têche;574;6;580
84;Auvergne-Rhône-Alpes;38;1;13;501;Tencin;2095;24;2119
84;Auvergne-Rhône-Alpes;38;1;18;503;La Terrasse;2539;122;2661
84;Auvergne-Rhône-Alpes;38;1;13;504;Theys;1961;74;2035
84;Auvergne-Rhône-Alpes;38;3;01;505;Thodure;743;14;757
84;Auvergne-Rhône-Alpes;38;2;04;507;Tignieu-Jameyzieu;7249;93;7342
84;Auvergne-Rhône-Alpes;38;2;24;508;Torchefelon;739;13;752
84;Auvergne-Rhône-Alpes;38;2;24;509;La Tour-du-Pin;8080;206;8286
84;Auvergne-Rhône-Alpes;38;1;13;511;Le Touvet;3229;102;3331
84;Auvergne-Rhône-Alpes;38;3;14;512;Tramolé;754;24;778
84;Auvergne-Rhône-Alpes;38;1;15;513;Treffort;292;7;299
84;Auvergne-Rhône-Alpes;38;1;15;514;Tréminis;178;1;179
84;Auvergne-Rhône-Alpes;38;2;04;515;Trept;2170;55;2225
84;Auvergne-Rhône-Alpes;38;1;16;516;La Tronche;6596;141;6737
84;Auvergne-Rhône-Alpes;38;1;25;517;Tullins;7680;121;7801
84;Auvergne-Rhône-Alpes;38;2;08;560;Val-de-Virieu;1539;19;1558
84;Auvergne-Rhône-Alpes;38;1;15;518;Valbonnais;495;8;503
84;Auvergne-Rhône-Alpes;38;3;26;519;Valencin;2799;48;2847
84;Auvergne-Rhône-Alpes;38;2;08;520;Valencogne;689;20;709
84;Auvergne-Rhône-Alpes;38;1;15;521;La Valette;71;3;74
84;Auvergne-Rhône-Alpes;38;1;15;522;Valjouffrey;135;2;137
84;Auvergne-Rhône-Alpes;38;1;23;523;Varacieux;854;21;875
84;Auvergne-Rhône-Alpes;38;1;20;524;Varces-Allières-et-Risset;8250;167;8417
84;Auvergne-Rhône-Alpes;38;2;17;525;Vasselin;474;5;479
84;Auvergne-Rhône-Alpes;38;1;23;526;Vatilieu;365;11;376
84;Auvergne-Rhône-Alpes;38;1;19;527;Vaujany;337;4;341
84;Auvergne-Rhône-Alpes;38;1;19;528;Vaulnaveys-le-Bas;1282;29;1311
84;Auvergne-Rhône-Alpes;38;1;19;529;Vaulnaveys-le-Haut;3867;60;3927
84;Auvergne-Rhône-Alpes;38;2;14;530;Vaulx-Milieu;2553;29;2582
84;Auvergne-Rhône-Alpes;38;2;03;531;Velanne;537;6;543
84;Auvergne-Rhône-Alpes;38;2;04;532;Vénérieu;846;9;855
84;Auvergne-Rhône-Alpes;38;1;22;533;Venon;729;16;745
84;Auvergne-Rhône-Alpes;38;2;04;535;Vernas;266;6;272
84;Auvergne-Rhône-Alpes;38;3;28;536;Vernioz;1294;26;1320
84;Auvergne-Rhône-Alpes;38;2;26;537;La Verpillière;7226;87;7313
84;Auvergne-Rhône-Alpes;38;1;18;538;Le Versoud;4818;56;4874
84;Auvergne-Rhône-Alpes;38;2;17;539;Vertrieu;639;19;658
84;Auvergne-Rhône-Alpes;38;1;07;540;Veurey-Voroize;1438;26;1464
84;Auvergne-Rhône-Alpes;38;2;04;542;Veyssilieu;336;8;344
84;Auvergne-Rhône-Alpes;38;2;17;543;Vézeronce-Curtin;2129;35;2164
84;Auvergne-Rhône-Alpes;38;3;99;544;Vienne;29306;377;29683
84;Auvergne-Rhône-Alpes;38;1;20;545;Vif;8532;124;8656
84;Auvergne-Rhône-Alpes;38;2;17;546;Vignieu;1015;95;1110
84;Auvergne-Rhône-Alpes;38;2;08;292;Villages du Lac de Paladru;2485;59;2544
84;Auvergne-Rhône-Alpes;38;1;18;547;Villard-Bonnot;7107;63;7170
84;Auvergne-Rhône-Alpes;38;1;07;548;Villard-de-Lans;4210;224;4434
84;Auvergne-Rhône-Alpes;38;1;19;549;Villard-Notre-Dame;27;3;30
84;Auvergne-Rhône-Alpes;38;1;19;550;Villard-Reculas;56;0;56
84;Auvergne-Rhône-Alpes;38;1;19;551;Villard-Reymond;43;1;44
84;Auvergne-Rhône-Alpes;38;1;15;552;Villard-Saint-Christophe;406;12;418
84;Auvergne-Rhône-Alpes;38;3;21;556;Ville-sous-Anjou;1173;25;1198
84;Auvergne-Rhône-Alpes;38;2;14;553;Villefontaine;18763;236;18999
84;Auvergne-Rhône-Alpes;38;2;04;554;Villemoirieu;1852;69;1921
84;Auvergne-Rhône-Alpes;38;3;01;555;Villeneuve-de-Marc;1147;18;1165
84;Auvergne-Rhône-Alpes;38;2;04;557;Villette-d'Anthon;4936;85;5021
84;Auvergne-Rhône-Alpes;38;3;27;558;Villette-de-Vienne;1872;30;1902
84;Auvergne-Rhône-Alpes;38;1;23;559;Vinay;4251;73;4324
84;Auvergne-Rhône-Alpes;38;3;01;561;Viriville;1630;22;1652
84;Auvergne-Rhône-Alpes;38;1;19;562;Vizille;7361;173;7534
84;Auvergne-Rhône-Alpes;38;1;29;563;Voiron;20108;495;20603
84;Auvergne-Rhône-Alpes;38;2;03;564;Voissant;226;10;236
84;Auvergne-Rhône-Alpes;38;1;29;565;Voreppe;9293;362;9655
84;Auvergne-Rhône-Alpes;38;1;25;566;Vourey;1705;39;1744
27;Bourgogne-Franche-Comté;39;1;17;001;Abergement-la-Ronce;849;25;874
27;Bourgogne-Franche-Comté;39;1;01;002;Abergement-le-Grand;58;1;59
27;Bourgogne-Franche-Comté;39;1;03;003;Abergement-le-Petit;42;0;42
27;Bourgogne-Franche-Comté;39;1;01;004;Abergement-lès-Thésy;60;3;63
27;Bourgogne-Franche-Comté;39;1;01;006;Aiglepierre;436;16;452
27;Bourgogne-Franche-Comté;39;2;09;007;Alièze;153;5;158
27;Bourgogne-Franche-Comté;39;1;02;008;Amange;433;59;492
27;Bourgogne-Franche-Comté;39;2;04;009;Andelot-en-Montagne;526;12;538
27;Bourgogne-Franche-Comté;39;2;13;010;Andelot-Morval;95;2;97
27;Bourgogne-Franche-Comté;39;1;17;011;Annoire;377;7;384
27;Bourgogne-Franche-Comté;39;1;01;013;Arbois;3336;208;3544
27;Bourgogne-Franche-Comté;39;1;02;014;Archelange;218;6;224
27;Bourgogne-Franche-Comté;39;2;04;015;Ardon;115;2;117
27;Bourgogne-Franche-Comté;39;1;01;586;Aresches;32;0;32
27;Bourgogne-Franche-Comté;39;2;09;016;Arinthod;1114;32;1146
27;Bourgogne-Franche-Comté;39;2;89;017;Arlay;1227;22;1249
27;Bourgogne-Franche-Comté;39;2;87;018;Aromas;652;18;670
27;Bourgogne-Franche-Comté;39;2;15;020;Arsure-Arsurette;101;2;103
27;Bourgogne-Franche-Comté;39;1;01;019;Les Arsures;230;10;240
27;Bourgogne-Franche-Comté;39;1;17;022;Asnans-Beauvoisin;731;11;742
27;Bourgogne-Franche-Comté;39;1;02;024;Audelange;270;7;277
27;Bourgogne-Franche-Comté;39;2;13;025;Augea;277;7;284
27;Bourgogne-Franche-Comté;39;1;10;026;Augerans;178;1;179
27;Bourgogne-Franche-Comté;39;2;13;027;Augisey;201;5;206
27;Bourgogne-Franche-Comté;39;1;03;028;Aumont;468;8;476
27;Bourgogne-Franche-Comté;39;1;17;029;Aumur;366;8;374
27;Bourgogne-Franche-Comté;39;1;02;030;Authume;821;21;842
27;Bourgogne-Franche-Comté;39;1;02;031;Auxange;201;4;205
27;Bourgogne-Franche-Comté;39;3;14;032;Avignon-lès-Saint-Claude;383;18;401
27;Bourgogne-Franche-Comté;39;1;17;034;Balaiseaux;309;8;317
27;Bourgogne-Franche-Comté;39;2;13;035;Balanod;349;6;355
27;Bourgogne-Franche-Comté;39;1;10;037;Bans;191;4;195
27;Bourgogne-Franche-Comté;39;2;15;038;Barésia-sur-l'Ain;150;2;152
27;Bourgogne-Franche-Comté;39;1;10;039;La Barre;232;6;238
27;Bourgogne-Franche-Comté;39;1;03;040;Barretaine;178;2;180
27;Bourgogne-Franche-Comté;39;2;12;041;Baume-les-Messieurs;162;6;168
27;Bourgogne-Franche-Comté;39;1;02;042;Baverans;500;22;522
27;Bourgogne-Franche-Comté;39;2;13;043;Beaufort-Orbagna;1351;16;1367
27;Bourgogne-Franche-Comté;39;2;09;045;Beffia;77;3;80
27;Bourgogne-Franche-Comté;39;3;16;046;Bellecombe;63;4;67
27;Bourgogne-Franche-Comté;39;3;11;047;Bellefontaine;537;16;553
27;Bourgogne-Franche-Comté;39;1;10;048;Belmont;262;8;270
27;Bourgogne-Franche-Comté;39;1;03;049;Bersaillin;405;14;419
27;Bourgogne-Franche-Comté;39;1;12;050;Besain;161;11;172
27;Bourgogne-Franche-Comté;39;1;02;051;Biarne;407;5;412
27;Bourgogne-Franche-Comté;39;2;15;052;Bief-des-Maisons;72;0;72
27;Bourgogne-Franche-Comté;39;2;15;053;Bief-du-Fourg;203;5;208
27;Bourgogne-Franche-Comté;39;1;03;054;Biefmorin;98;1;99
27;Bourgogne-Franche-Comté;39;2;15;055;Billecul;47;1;48
27;Bourgogne-Franche-Comté;39;2;03;056;Bletterans;1446;19;1465
27;Bourgogne-Franche-Comté;39;2;12;057;Blois-sur-Seille;105;1;106
27;Bourgogne-Franche-Comté;39;2;12;058;Blye;162;5;167
27;Bourgogne-Franche-Comté;39;3;11;059;Bois-d'Amont;1655;42;1697
27;Bourgogne-Franche-Comté;39;2;03;060;Bois-de-Gand;57;1;58
27;Bourgogne-Franche-Comté;39;2;15;061;Boissia;118;5;123
27;Bourgogne-Franche-Comté;39;2;09;062;La Boissière;68;0;68
27;Bourgogne-Franche-Comté;39;2;15;063;Bonlieu;261;4;265
27;Bourgogne-Franche-Comté;39;2;12;065;Bonnefontaine;104;0;104
27;Bourgogne-Franche-Comté;39;2;08;066;Bornay;176;6;182
27;Bourgogne-Franche-Comté;39;3;16;068;Les Bouchoux;317;9;326
27;Bourgogne-Franche-Comté;39;2;04;070;Bourg-de-Sirod;94;2;96
27;Bourgogne-Franche-Comté;39;1;01;072;Bracon;273;7;280
27;Bourgogne-Franche-Comté;39;1;03;073;Brainans;171;6;177
27;Bourgogne-Franche-Comté;39;1;02;074;Brans;216;8;224
27;Bourgogne-Franche-Comté;39;1;10;076;La Bretenière;220;1;221
27;Bourgogne-Franche-Comté;39;1;17;077;Bretenières;40;1;41
27;Bourgogne-Franche-Comté;39;1;02;078;Brevans;669;14;683
27;Bourgogne-Franche-Comté;39;2;12;079;Briod;204;9;213
27;Bourgogne-Franche-Comté;39;2;13;080;Broissia;65;0;65
27;Bourgogne-Franche-Comté;39;1;12;081;Buvilly;385;7;392
27;Bourgogne-Franche-Comté;39;2;15;083;Censeau;301;6;307
27;Bourgogne-Franche-Comté;39;1;01;084;Cernans;140;4;144
27;Bourgogne-Franche-Comté;39;2;15;085;Cerniébaud;88;1;89
27;Bourgogne-Franche-Comté;39;2;09;086;Cernon;251;3;254
27;Bourgogne-Franche-Comté;39;2;13;088;Cesancey;392;11;403
27;Bourgogne-Franche-Comté;39;2;88;021;La Chailleuse;602;13;615
27;Bourgogne-Franche-Comté;39;1;17;090;Chaînée-des-Coupis;181;4;185
27;Bourgogne-Franche-Comté;39;2;15;091;Les Chalesmes;96;1;97
27;Bourgogne-Franche-Comté;39;2;09;092;Chambéria;175;1;176
27;Bourgogne-Franche-Comté;39;1;10;093;Chamblay;424;10;434
27;Bourgogne-Franche-Comté;39;1;12;094;Chamole;166;3;169
27;Bourgogne-Franche-Comté;39;1;10;095;Champagne-sur-Loue;125;5;130
27;Bourgogne-Franche-Comté;39;1;02;096;Champagney;480;8;488
27;Bourgogne-Franche-Comté;39;2;04;097;Champagnole;7958;388;8346
27;Bourgogne-Franche-Comté;39;1;17;099;Champdivers;429;17;446
27;Bourgogne-Franche-Comté;39;2;03;100;Champrougier;101;3;104
27;Bourgogne-Franche-Comté;39;1;05;101;Champvans;1414;43;1457
27;Bourgogne-Franche-Comté;39;3;09;102;Chancia;226;4;230
27;Bourgogne-Franche-Comté;39;1;01;103;La Chapelle-sur-Furieuse;315;1;316
27;Bourgogne-Franche-Comté;39;2;03;104;Chapelle-Voland;602;7;609
27;Bourgogne-Franche-Comté;39;2;04;105;Chapois;224;2;226
27;Bourgogne-Franche-Comté;39;3;09;106;Charchilla;280;4;284
27;Bourgogne-Franche-Comté;39;2;15;107;Charcier;129;3;132
27;Bourgogne-Franche-Comté;39;2;15;108;Charency;55;1;56
27;Bourgogne-Franche-Comté;39;2;15;109;Charézier;175;2;177
27;Bourgogne-Franche-Comté;39;2;03;110;La Charme;68;0;68
27;Bourgogne-Franche-Comté;39;2;09;111;Charnod;40;0;40
27;Bourgogne-Franche-Comté;39;2;03;112;La Chassagne;119;2;121
27;Bourgogne-Franche-Comté;39;3;16;339;Chassal-Molinges;1131;28;1159
27;Bourgogne-Franche-Comté;39;2;12;114;Château-Chalon;146;6;152
27;Bourgogne-Franche-Comté;39;3;09;118;Châtel-de-Joux;51;0;51
27;Bourgogne-Franche-Comté;39;1;01;116;La Châtelaine;139;2;141
27;Bourgogne-Franche-Comté;39;1;10;117;Chatelay;106;6;112
27;Bourgogne-Franche-Comté;39;1;03;119;Le Chateley;87;3;90
27;Bourgogne-Franche-Comté;39;2;04;120;Châtelneuf;138;6;144
27;Bourgogne-Franche-Comté;39;1;02;121;Châtenois;389;7;396
27;Bourgogne-Franche-Comté;39;2;12;122;Châtillon;112;7;119
27;Bourgogne-Franche-Comté;39;2;03;124;Chaumergy;482;16;498
27;Bourgogne-Franche-Comté;39;3;15;126;La Chaumusse;402;11;413
27;Bourgogne-Franche-Comté;39;1;12;127;Chaussenans;100;1;101
27;Bourgogne-Franche-Comté;39;1;17;128;Chaussin;1630;24;1654
27;Bourgogne-Franche-Comté;39;1;01;133;Chaux-Champagny;71;2;73
27;Bourgogne-Franche-Comté;39;2;15;129;Chaux-des-Crotenay;404;14;418
27;Bourgogne-Franche-Comté;39;3;15;131;La Chaux-du-Dombief;544;13;557
27;Bourgogne-Franche-Comté;39;2;03;132;La Chaux-en-Bresse;39;1;40
27;Bourgogne-Franche-Comté;39;2;09;134;Chavéria;226;8;234
27;Bourgogne-Franche-Comté;39;2;03;136;Chemenot;37;1;38
27;Bourgogne-Franche-Comté;39;1;17;138;Chemin;343;10;353
27;Bourgogne-Franche-Comté;39;1;17;139;Chêne-Bernard;64;0;64
27;Bourgogne-Franche-Comté;39;2;03;140;Chêne-Sec;36;0;36
27;Bourgogne-Franche-Comté;39;1;02;141;Chevigny;280;6;286
27;Bourgogne-Franche-Comté;39;2;13;142;Chevreaux;122;1;123
27;Bourgogne-Franche-Comté;39;2;15;143;Chevrotaine;32;0;32
27;Bourgogne-Franche-Comté;39;2;07;145;Chille;293;19;312
27;Bourgogne-Franche-Comté;39;2;08;146;Chilly-le-Vignoble;667;20;687
27;Bourgogne-Franche-Comté;39;1;01;147;Chilly-sur-Salins;114;3;117
27;Bourgogne-Franche-Comté;39;1;10;149;Chissey-sur-Loue;320;9;329
27;Bourgogne-Franche-Comté;39;1;06;150;Choisey;1050;31;1081
27;Bourgogne-Franche-Comté;39;3;16;151;Choux;119;4;123
27;Bourgogne-Franche-Comté;39;2;04;153;Cize;788;28;816
27;Bourgogne-Franche-Comté;39;2;15;154;Clairvaux-les-Lacs;1451;49;1500
27;Bourgogne-Franche-Comté;39;1;01;155;Clucy;78;0;78
27;Bourgogne-Franche-Comté;39;2;15;156;Cogna;252;15;267
27;Bourgogne-Franche-Comté;39;3;16;157;Coiserette;52;3;55
27;Bourgogne-Franche-Comté;39;1;03;159;Colonne;264;2;266
27;Bourgogne-Franche-Comté;39;2;03;160;Commenailles;890;15;905
27;Bourgogne-Franche-Comté;39;2;07;162;Condamine;272;6;278
27;Bourgogne-Franche-Comté;39;2;09;163;Condes;109;7;116
27;Bourgogne-Franche-Comté;39;2;12;164;Conliège;668;27;695
27;Bourgogne-Franche-Comté;39;2;15;165;Conte;56;0;56
27;Bourgogne-Franche-Comté;39;2;09;166;Cornod;218;7;225
27;Bourgogne-Franche-Comté;39;2;03;167;Cosges;364;6;370
27;Bourgogne-Franche-Comté;39;3;86;491;Coteaux du Lizon;2397;71;2468
27;Bourgogne-Franche-Comté;39;2;09;168;Courbette;51;0;51
27;Bourgogne-Franche-Comté;39;2;08;169;Courbouzon;590;14;604
27;Bourgogne-Franche-Comté;39;2;07;170;Courlans;926;29;955
27;Bourgogne-Franche-Comté;39;2;07;171;Courlaoux;1106;32;1138
27;Bourgogne-Franche-Comté;39;1;10;172;Courtefontaine;249;16;265
27;Bourgogne-Franche-Comté;39;2;13;173;Cousance;1308;23;1331
27;Bourgogne-Franche-Comté;39;3;16;174;Coyrière;65;1;66
27;Bourgogne-Franche-Comté;39;3;09;175;Coyron;73;7;80
27;Bourgogne-Franche-Comté;39;1;10;176;Cramans;524;8;532
27;Bourgogne-Franche-Comté;39;2;15;178;Crans;74;1;75
27;Bourgogne-Franche-Comté;39;3;09;179;Crenans;239;5;244
27;Bourgogne-Franche-Comté;39;2;13;180;Cressia;258;119;377
27;Bourgogne-Franche-Comté;39;1;06;182;Crissey;653;25;678
27;Bourgogne-Franche-Comté;39;2;04;183;Crotenay;640;89;729
27;Bourgogne-Franche-Comté;39;3;09;184;Les Crozets;199;3;202
27;Bourgogne-Franche-Comté;39;2;13;185;Cuisia;392;12;404
27;Bourgogne-Franche-Comté;39;2;15;187;Cuvier;262;2;264
27;Bourgogne-Franche-Comté;39;1;02;188;Dammartin-Marpain;342;6;348
27;Bourgogne-Franche-Comté;39;1;06;189;Damparis;2694;80;2774
27;Bourgogne-Franche-Comté;39;1;84;190;Dampierre;1278;27;1305
27;Bourgogne-Franche-Comté;39;1;03;191;Darbonnay;92;2;94
27;Bourgogne-Franche-Comté;39;2;15;192;Denezières;72;1;73
27;Bourgogne-Franche-Comté;39;1;17;193;Le Deschaux;1021;8;1029
27;Bourgogne-Franche-Comté;39;2;03;194;Desnes;481;6;487
27;Bourgogne-Franche-Comté;39;2;03;196;Les Deux-Fays;106;1;107
27;Bourgogne-Franche-Comté;39;2;13;197;Digna;350;12;362
27;Bourgogne-Franche-Comté;39;1;98;198;Dole;23708;898;24606
27;Bourgogne-Franche-Comté;39;2;83;199;Domblans;1232;32;1264
27;Bourgogne-Franche-Comté;39;2;09;200;Dompierre-sur-Mont;230;7;237
27;Bourgogne-Franche-Comté;39;2;15;201;Doucier;298;30;328
27;Bourgogne-Franche-Comté;39;1;01;202;Dournon;140;1;141
27;Bourgogne-Franche-Comté;39;2;15;203;Doye;101;2;103
27;Bourgogne-Franche-Comté;39;2;09;204;Dramelay;29;3;32
27;Bourgogne-Franche-Comté;39;1;02;205;Éclans-Nenon;387;5;392
27;Bourgogne-Franche-Comté;39;1;10;206;Écleux;224;10;234
27;Bourgogne-Franche-Comté;39;2;09;207;Écrille;83;3;86
27;Bourgogne-Franche-Comté;39;2;15;208;Entre-deux-Monts;142;9;151
27;Bourgogne-Franche-Comté;39;2;04;210;Équevillon;582;14;596
27;Bourgogne-Franche-Comté;39;1;17;211;Les Essards-Taignevaux;260;4;264
27;Bourgogne-Franche-Comté;39;2;15;214;Esserval-Tartre;119;4;123
27;Bourgogne-Franche-Comté;39;3;09;216;Étival;308;10;318
27;Bourgogne-Franche-Comté;39;2;07;217;L' Étoile;563;14;577
27;Bourgogne-Franche-Comté;39;1;10;218;Étrepigney;430;6;436
27;Bourgogne-Franche-Comté;39;1;10;219;Évans;644;12;656
27;Bourgogne-Franche-Comté;39;1;02;220;Falletans;393;9;402
27;Bourgogne-Franche-Comté;39;2;15;221;La Favière;28;1;29
27;Bourgogne-Franche-Comté;39;1;12;222;Fay-en-Montagne;85;7;92
27;Bourgogne-Franche-Comté;39;1;01;223;La Ferté;198;2;200
27;Bourgogne-Franche-Comté;39;1;12;225;Le Fied;204;7;211
27;Bourgogne-Franche-Comté;39;2;15;227;Foncine-le-Bas;192;7;199
27;Bourgogne-Franche-Comté;39;2;15;228;Foncine-le-Haut;1063;27;1090
27;Bourgogne-Franche-Comté;39;2;03;229;Fontainebrux;202;10;212
27;Bourgogne-Franche-Comté;39;2;15;230;Fontenu;75;2;77
27;Bourgogne-Franche-Comté;39;3;15;232;Fort-du-Plasne;443;10;453
27;Bourgogne-Franche-Comté;39;1;05;233;Foucherans;2193;38;2231
27;Bourgogne-Franche-Comté;39;2;03;234;Foulenay;84;0;84
27;Bourgogne-Franche-Comté;39;1;10;235;Fraisans;1215;14;1229
27;Bourgogne-Franche-Comté;39;2;03;236;Francheville;55;1;56
27;Bourgogne-Franche-Comté;39;2;15;237;Fraroz;49;3;52
27;Bourgogne-Franche-Comté;39;1;02;238;Frasne-les-Meulières;119;8;127
27;Bourgogne-Franche-Comté;39;2;15;239;La Frasnée;39;2;41
27;Bourgogne-Franche-Comté;39;2;15;240;Le Frasnois;160;4;164
27;Bourgogne-Franche-Comté;39;2;08;241;Frébuans;373;8;381
27;Bourgogne-Franche-Comté;39;2;12;244;Frontenay;172;5;177
27;Bourgogne-Franche-Comté;39;1;17;245;Gatey;371;9;380
27;Bourgogne-Franche-Comté;39;1;02;246;Gendrey;428;13;441
27;Bourgogne-Franche-Comté;39;2;09;247;Genod;68;2;70
27;Bourgogne-Franche-Comté;39;1;01;248;Geraise;42;0;42
27;Bourgogne-Franche-Comté;39;1;10;249;Germigney;78;4;82
27;Bourgogne-Franche-Comté;39;2;08;250;Geruge;169;7;176
27;Bourgogne-Franche-Comté;39;2;08;251;Gevingey;451;96;547
27;Bourgogne-Franche-Comté;39;1;06;252;Gevry;692;10;702
27;Bourgogne-Franche-Comté;39;2;13;253;Gigny;281;7;288
27;Bourgogne-Franche-Comté;39;2;15;254;Gillois;136;6;142
27;Bourgogne-Franche-Comté;39;2;13;255;Gizia;236;3;239
27;Bourgogne-Franche-Comté;39;3;15;258;Grande-Rivière Château;628;19;647
27;Bourgogne-Franche-Comté;39;1;10;259;Grange-de-Vaivre;35;1;36
27;Bourgogne-Franche-Comté;39;2;13;261;Graye-et-Charnay;139;2;141
27;Bourgogne-Franche-Comté;39;1;02;262;Gredisans;136;1;137
27;Bourgogne-Franche-Comté;39;1;03;263;Grozon;420;13;433
27;Bourgogne-Franche-Comté;39;2;15;265;Hautecour;191;5;196
27;Bourgogne-Franche-Comté;39;2;12;177;Hauteroche;951;25;976
27;Bourgogne-Franche-Comté;39;3;11;368;Hauts de Bienne;5350;273;5623
27;Bourgogne-Franche-Comté;39;1;17;266;Les Hays;331;2;333
27;Bourgogne-Franche-Comté;39;1;01;267;Ivory;96;1;97
27;Bourgogne-Franche-Comté;39;1;01;268;Ivrey;61;1;62
27;Bourgogne-Franche-Comté;39;3;09;269;Jeurre;270;1;271
27;Bourgogne-Franche-Comté;39;1;02;270;Jouhe;563;64;627
27;Bourgogne-Franche-Comté;39;3;15;271;Lac-des-Rouges-Truites;394;17;411
27;Bourgogne-Franche-Comté;39;2;12;272;Ladoye-sur-Seille;52;3;55
27;Bourgogne-Franche-Comté;39;3;16;274;Lajoux;262;12;274
27;Bourgogne-Franche-Comté;39;3;16;275;Lamoura;642;19;661
27;Bourgogne-Franche-Comté;39;2;04;277;Le Larderet;74;3;77
27;Bourgogne-Franche-Comté;39;2;15;278;Largillay-Marsonnay;153;2;155
27;Bourgogne-Franche-Comté;39;2;03;279;Larnaud;603;13;616
27;Bourgogne-Franche-Comté;39;3;16;280;Larrivoire;103;2;105
27;Bourgogne-Franche-Comté;39;2;04;281;Le Latet;81;4;85
27;Bourgogne-Franche-Comté;39;2;15;282;La Latette;73;2;75
27;Bourgogne-Franche-Comté;39;3;16;283;Lavancia-Epercy;646;18;664
27;Bourgogne-Franche-Comté;39;1;02;284;Lavangeot;138;2;140
27;Bourgogne-Franche-Comté;39;1;02;285;Lavans-lès-Dole;324;8;332
27;Bourgogne-Franche-Comté;39;3;82;286;Lavans-lès-Saint-Claude;2437;107;2544
27;Bourgogne-Franche-Comté;39;2;12;288;Lavigny;378;4;382
27;Bourgogne-Franche-Comté;39;3;09;289;Lect;354;6;360
27;Bourgogne-Franche-Comté;39;1;01;291;Lemuy;238;5;243
27;Bourgogne-Franche-Comté;39;2;04;292;Lent;150;4;154
27;Bourgogne-Franche-Comté;39;3;14;293;Leschères;209;4;213
27;Bourgogne-Franche-Comté;39;2;13;295;Loisia;166;1;167
27;Bourgogne-Franche-Comté;39;2;03;296;Lombard;211;5;216
27;Bourgogne-Franche-Comté;39;3;11;297;Longchaumois;1167;32;1199
27;Bourgogne-Franche-Comté;39;2;15;298;Longcochon;63;1;64
27;Bourgogne-Franche-Comté;39;1;17;299;Longwy-sur-le-Doubs;505;10;515
27;Bourgogne-Franche-Comté;39;2;99;300;Lons-le-Saunier;17291;732;18023
27;Bourgogne-Franche-Comté;39;2;04;301;Loulle;172;4;176
27;Bourgogne-Franche-Comté;39;1;02;302;Louvatange;97;7;104
27;Bourgogne-Franche-Comté;39;2;12;304;Le Louverot;211;12;223
27;Bourgogne-Franche-Comté;39;1;10;305;La Loye;551;9;560
27;Bourgogne-Franche-Comté;39;2;08;306;Macornay;974;35;1009
27;Bourgogne-Franche-Comté;39;3;09;307;Maisod;329;12;341
27;Bourgogne-Franche-Comté;39;1;02;308;Malange;321;6;327
27;Bourgogne-Franche-Comté;39;2;03;310;Mantry;454;12;466
27;Bourgogne-Franche-Comté;39;2;09;312;Marigna-sur-Valouse;116;4;120
27;Bourgogne-Franche-Comté;39;2;15;313;Marigny;207;1;208
27;Bourgogne-Franche-Comté;39;2;09;314;Marnézia;90;3;93
27;Bourgogne-Franche-Comté;39;1;01;315;Marnoz;404;22;426
27;Bourgogne-Franche-Comté;39;2;12;317;La Marre;338;14;352
27;Bourgogne-Franche-Comté;39;3;09;318;Martigna;194;12;206
27;Bourgogne-Franche-Comté;39;1;01;319;Mathenay;143;2;145
27;Bourgogne-Franche-Comté;39;2;13;320;Maynal;338;2;340
27;Bourgogne-Franche-Comté;39;2;12;321;Menétru-le-Vignoble;159;2;161
27;Bourgogne-Franche-Comté;39;2;15;322;Menétrux-en-Joux;56;2;58
27;Bourgogne-Franche-Comté;39;1;02;323;Menotey;306;15;321
27;Bourgogne-Franche-Comté;39;2;09;324;Mérona;8;0;8
27;Bourgogne-Franche-Comté;39;1;01;325;Mesnay;583;15;598
27;Bourgogne-Franche-Comté;39;2;15;326;Mesnois;187;4;191
27;Bourgogne-Franche-Comté;39;2;08;327;Messia-sur-Sorne;842;14;856
27;Bourgogne-Franche-Comté;39;3;09;328;Meussia;420;6;426
27;Bourgogne-Franche-Comté;39;2;15;329;Mièges;166;3;169
27;Bourgogne-Franche-Comté;39;1;03;330;Miéry;152;5;157
27;Bourgogne-Franche-Comté;39;2;15;331;Mignovillard;819;24;843
27;Bourgogne-Franche-Comté;39;3;09;333;Moirans-en-Montagne;2099;107;2206
27;Bourgogne-Franche-Comté;39;2;08;334;Moiron;130;5;135
27;Bourgogne-Franche-Comté;39;1;02;335;Moissey;563;13;576
27;Bourgogne-Franche-Comté;39;1;12;336;Molain;105;3;108
27;Bourgogne-Franche-Comté;39;1;01;337;Molamboz;90;3;93
27;Bourgogne-Franche-Comté;39;1;17;338;Molay;501;5;506
27;Bourgogne-Franche-Comté;39;1;03;342;Monay;124;3;127
27;Bourgogne-Franche-Comté;39;2;04;344;Monnet-la-Ville;343;13;356
27;Bourgogne-Franche-Comté;39;2;13;343;Monnetay;14;1;15
27;Bourgogne-Franche-Comté;39;1;05;345;Monnières;422;17;439
27;Bourgogne-Franche-Comté;39;1;10;365;Mont-sous-Vaudrey;1265;22;1287
27;Bourgogne-Franche-Comté;39;2;04;366;Mont-sur-Monnet;248;6;254
27;Bourgogne-Franche-Comté;39;2;13;346;Montagna-le-Reconduit;119;0;119
27;Bourgogne-Franche-Comté;39;2;12;348;Montaigu;437;52;489
27;Bourgogne-Franche-Comté;39;2;12;349;Montain;509;24;533
27;Bourgogne-Franche-Comté;39;1;10;350;Montbarrey;317;6;323
27;Bourgogne-Franche-Comté;39;3;09;351;Montcusel;156;7;163
27;Bourgogne-Franche-Comté;39;1;10;352;Monteplain;132;2;134
27;Bourgogne-Franche-Comté;39;2;13;353;Montfleur;182;8;190
27;Bourgogne-Franche-Comté;39;1;03;354;Montholier;359;3;362
27;Bourgogne-Franche-Comté;39;1;01;355;Montigny-lès-Arsures;254;8;262
27;Bourgogne-Franche-Comté;39;2;04;356;Montigny-sur-l'Ain;199;8;207
27;Bourgogne-Franche-Comté;39;2;13;273;Montlainsia;246;7;253
27;Bourgogne-Franche-Comté;39;1;01;359;Montmarlon;31;1;32
27;Bourgogne-Franche-Comté;39;1;02;360;Montmirey-la-Ville;176;2;178
27;Bourgogne-Franche-Comté;39;1;02;361;Montmirey-le-Château;197;5;202
27;Bourgogne-Franche-Comté;39;2;07;362;Montmorot;3036;328;3364
27;Bourgogne-Franche-Comté;39;2;13;363;Montrevel;90;1;91
27;Bourgogne-Franche-Comté;39;2;04;364;Montrond;492;15;507
27;Bourgogne-Franche-Comté;39;3;11;367;Morbier;2292;107;2399
27;Bourgogne-Franche-Comté;39;1;10;370;Mouchard;1101;317;1418
27;Bourgogne-Franche-Comté;39;2;15;372;Mournans-Charbonny;89;8;97
27;Bourgogne-Franche-Comté;39;3;16;373;Les Moussières;167;4;171
27;Bourgogne-Franche-Comté;39;2;09;375;Moutonne;132;0;132
27;Bourgogne-Franche-Comté;39;2;04;376;Moutoux;72;2;74
27;Bourgogne-Franche-Comté;39;1;02;377;Mutigney;171;3;174
27;Bourgogne-Franche-Comté;39;2;03;379;Nance;519;11;530
27;Bourgogne-Franche-Comté;39;3;81;130;Nanchez;806;22;828
27;Bourgogne-Franche-Comté;39;2;09;380;Nancuise;46;2;48
27;Bourgogne-Franche-Comté;39;2;04;381;Les Nans;91;3;94
27;Bourgogne-Franche-Comté;39;1;17;385;Neublans-Abergement;545;5;550
27;Bourgogne-Franche-Comté;39;1;03;386;Neuvilley;87;0;87
27;Bourgogne-Franche-Comté;39;1;10;387;Nevy-lès-Dole;281;6;287
27;Bourgogne-Franche-Comté;39;2;12;388;Nevy-sur-Seille;205;10;215
27;Bourgogne-Franche-Comté;39;2;04;389;Ney;574;13;587
27;Bourgogne-Franche-Comté;39;2;12;390;Nogna;295;12;307
27;Bourgogne-Franche-Comté;39;2;15;391;Nozeroy;437;13;450
27;Bourgogne-Franche-Comté;39;1;02;392;Offlanges;198;3;201
27;Bourgogne-Franche-Comté;39;2;15;393;Onglières;65;2;67
27;Bourgogne-Franche-Comté;39;2;09;394;Onoz;72;5;77
27;Bourgogne-Franche-Comté;39;1;10;396;Orchamps;1121;18;1139
27;Bourgogne-Franche-Comté;39;2;09;397;Orgelet;1596;44;1640
27;Bourgogne-Franche-Comté;39;1;02;398;Ougney;375;3;378
27;Bourgogne-Franche-Comté;39;1;10;399;Ounans;369;6;375
27;Bourgogne-Franche-Comté;39;1;10;400;Our;140;2;142
27;Bourgogne-Franche-Comté;39;1;03;401;Oussières;233;5;238
27;Bourgogne-Franche-Comté;39;1;02;402;Pagney;324;7;331
27;Bourgogne-Franche-Comté;39;1;10;403;Pagnoz;230;5;235
27;Bourgogne-Franche-Comté;39;2;12;404;Pannessières;483;12;495
27;Bourgogne-Franche-Comté;39;1;06;405;Parcey;974;20;994
27;Bourgogne-Franche-Comté;39;2;04;406;Le Pasquier;251;8;259
27;Bourgogne-Franche-Comté;39;2;03;407;Passenans;345;6;351
27;Bourgogne-Franche-Comté;39;2;15;408;Patornay;140;6;146
27;Bourgogne-Franche-Comté;39;1;02;409;Peintre;127;3;130
27;Bourgogne-Franche-Comté;39;2;12;411;Perrigny;1523;48;1571
27;Bourgogne-Franche-Comté;39;1;17;412;Peseux;320;2;322
27;Bourgogne-Franche-Comté;39;3;16;413;La Pesse;343;7;350
27;Bourgogne-Franche-Comté;39;1;17;415;Petit-Noir;1093;9;1102
27;Bourgogne-Franche-Comté;39;1;12;418;Picarreau;101;3;104
27;Bourgogne-Franche-Comté;39;2;04;419;Pillemoine;58;2;60
27;Bourgogne-Franche-Comté;39;2;09;420;Pimorin;198;3;201
27;Bourgogne-Franche-Comté;39;2;12;421;Le Pin;241;15;256
27;Bourgogne-Franche-Comté;39;2;12;422;Plainoiseau;528;12;540
27;Bourgogne-Franche-Comté;39;2;09;423;Plaisia;107;9;116
27;Bourgogne-Franche-Comté;39;2;15;424;Les Planches-en-Montagne;164;2;166
27;Bourgogne-Franche-Comté;39;1;01;425;Les Planches-près-Arbois;96;1;97
27;Bourgogne-Franche-Comté;39;1;03;426;Plasne;218;11;229
27;Bourgogne-Franche-Comté;39;2;15;427;Plénise;62;0;62
27;Bourgogne-Franche-Comté;39;2;15;428;Plénisette;25;2;27
27;Bourgogne-Franche-Comté;39;1;17;429;Pleure;429;3;432
27;Bourgogne-Franche-Comté;39;1;10;430;Plumont;103;2;105
27;Bourgogne-Franche-Comté;39;2;12;431;Poids-de-Fiole;333;4;337
27;Bourgogne-Franche-Comté;39;1;02;432;Pointre;126;1;127
27;Bourgogne-Franche-Comté;39;1;12;434;Poligny;4047;407;4454
27;Bourgogne-Franche-Comté;39;1;01;436;Pont-d'Héry;234;8;242
27;Bourgogne-Franche-Comté;39;2;15;435;Pont-de-Poitte;647;20;667
27;Bourgogne-Franche-Comté;39;2;04;437;Pont-du-Navoy;275;5;280
27;Bourgogne-Franche-Comté;39;1;10;439;Port-Lesney;526;13;539
27;Bourgogne-Franche-Comté;39;3;11;441;Prémanon;1188;31;1219
27;Bourgogne-Franche-Comté;39;2;09;443;Présilly;132;0;132
27;Bourgogne-Franche-Comté;39;1;01;444;Pretin;61;1;62
27;Bourgogne-Franche-Comté;39;2;12;445;Publy;285;9;294
27;Bourgogne-Franche-Comté;39;1;01;446;Pupillin;237;8;245
27;Bourgogne-Franche-Comté;39;2;03;447;Quintigny;248;6;254
27;Bourgogne-Franche-Comté;39;1;17;448;Rahon;508;11;519
27;Bourgogne-Franche-Comté;39;1;02;449;Rainans;269;4;273
27;Bourgogne-Franche-Comté;39;1;10;451;Ranchot;495;4;499
27;Bourgogne-Franche-Comté;39;1;10;452;Rans;535;7;542
27;Bourgogne-Franche-Comté;39;3;14;453;Ravilloles;476;13;489
27;Bourgogne-Franche-Comté;39;2;03;454;Recanoz;90;2;92
27;Bourgogne-Franche-Comté;39;2;09;455;Reithouse;59;1;60
27;Bourgogne-Franche-Comté;39;2;03;456;Relans;341;4;345
27;Bourgogne-Franche-Comté;39;2;03;457;Les Repôts;52;0;52
27;Bourgogne-Franche-Comté;39;2;12;458;Revigny;248;15;263
27;Bourgogne-Franche-Comté;39;2;15;461;Rix;78;2;80
27;Bourgogne-Franche-Comté;39;3;14;460;La Rixouse;193;9;202
27;Bourgogne-Franche-Comté;39;1;02;462;Rochefort-sur-Nenon;679;5;684
27;Bourgogne-Franche-Comté;39;3;16;463;Rogna;227;6;233
27;Bourgogne-Franche-Comté;39;1;02;464;Romain;204;8;212
27;Bourgogne-Franche-Comté;39;1;02;465;Romange;199;2;201
27;Bourgogne-Franche-Comté;39;2;13;466;Rosay;125;0;125
27;Bourgogne-Franche-Comté;39;2;13;467;Rotalier;161;6;167
27;Bourgogne-Franche-Comté;39;2;09;468;Rothonay;135;4;139
27;Bourgogne-Franche-Comté;39;1;02;469;Rouffange;104;2;106
27;Bourgogne-Franche-Comté;39;3;11;470;Les Rousses;3630;97;3727
27;Bourgogne-Franche-Comté;39;2;03;471;Ruffey-sur-Seille;734;15;749
27;Bourgogne-Franche-Comté;39;2;03;472;Rye;218;5;223
27;Bourgogne-Franche-Comté;39;2;15;473;Saffloz;102;2;104
27;Bourgogne-Franche-Comté;39;2;13;475;Saint-Amour;2378;107;2485
27;Bourgogne-Franche-Comté;39;1;17;476;Saint-Aubin;1800;43;1843
27;Bourgogne-Franche-Comté;39;1;17;477;Saint-Baraing;261;5;266
27;Bourgogne-Franche-Comté;39;3;14;478;Saint-Claude;9279;298;9577
27;Bourgogne-Franche-Comté;39;1;01;479;Saint-Cyr-Montmalin;242;6;248
27;Bourgogne-Franche-Comté;39;2;07;480;Saint-Didier;269;14;283
27;Bourgogne-Franche-Comté;39;2;04;481;Saint-Germain-en-Montagne;407;10;417
27;Bourgogne-Franche-Comté;39;2;09;137;Saint-Hymetière-sur-Valouse;437;17;454
27;Bourgogne-Franche-Comté;39;2;03;486;Saint-Lamain;115;4;119
27;Bourgogne-Franche-Comté;39;3;15;487;Saint-Laurent-en-Grandvaux;1807;37;1844
27;Bourgogne-Franche-Comté;39;1;03;489;Saint-Lothain;471;9;480
27;Bourgogne-Franche-Comté;39;1;17;490;Saint-Loup;272;7;279
27;Bourgogne-Franche-Comté;39;2;12;492;Saint-Maur;233;3;236
27;Bourgogne-Franche-Comté;39;2;15;493;Saint-Maurice-Crillat;242;2;244
27;Bourgogne-Franche-Comté;39;3;15;494;Saint-Pierre;342;20;362
27;Bourgogne-Franche-Comté;39;1;01;495;Saint-Thiébaud;58;0;58
27;Bourgogne-Franche-Comté;39;2;13;474;Sainte-Agnès;355;10;365
27;Bourgogne-Franche-Comté;39;1;01;497;Saizenay;95;2;97
27;Bourgogne-Franche-Comté;39;1;10;498;Salans;591;12;603
27;Bourgogne-Franche-Comté;39;1;02;499;Saligney;185;5;190
27;Bourgogne-Franche-Comté;39;1;01;500;Salins-les-Bains;2586;150;2736
27;Bourgogne-Franche-Comté;39;1;05;501;Sampans;1165;12;1177
27;Bourgogne-Franche-Comté;39;1;10;502;Santans;297;7;304
27;Bourgogne-Franche-Comté;39;2;04;503;Sapois;374;14;388
27;Bourgogne-Franche-Comté;39;2;09;504;Sarrogna;230;10;240
27;Bourgogne-Franche-Comté;39;2;15;505;Saugeot;66;1;67
27;Bourgogne-Franche-Comté;39;1;17;507;Séligney;77;1;78
27;Bourgogne-Franche-Comté;39;2;03;508;Sellières;744;9;753
27;Bourgogne-Franche-Comté;39;3;16;510;Septmoncel les Molunes;829;24;853
27;Bourgogne-Franche-Comté;39;2;03;511;Sergenaux;65;3;68
27;Bourgogne-Franche-Comté;39;2;03;512;Sergenon;52;1;53
27;Bourgogne-Franche-Comté;39;1;02;513;Sermange;249;2;251
27;Bourgogne-Franche-Comté;39;1;02;514;Serre-les-Moulières;188;11;199
27;Bourgogne-Franche-Comté;39;2;04;517;Sirod;524;20;544
27;Bourgogne-Franche-Comté;39;2;15;518;Songeson;69;1;70
27;Bourgogne-Franche-Comté;39;2;15;519;Soucia;187;5;192
27;Bourgogne-Franche-Comté;39;1;10;520;Souvans;483;5;488
27;Bourgogne-Franche-Comté;39;2;04;522;Supt;102;2;104
27;Bourgogne-Franche-Comté;39;2;04;523;Syam;189;9;198
27;Bourgogne-Franche-Comté;39;1;17;525;Tassenières;394;9;403
27;Bourgogne-Franche-Comté;39;1;17;526;Tavaux;3918;94;4012
27;Bourgogne-Franche-Comté;39;1;02;527;Taxenne;109;1;110
27;Bourgogne-Franche-Comté;39;1;02;528;Thervay;385;10;395
27;Bourgogne-Franche-Comté;39;1;01;529;Thésy;66;0;66
27;Bourgogne-Franche-Comté;39;2;09;530;Thoirette-Coisia;868;25;893
27;Bourgogne-Franche-Comté;39;2;15;531;Thoiria;192;4;196
27;Bourgogne-Franche-Comté;39;2;13;532;Thoissia;36;1;37
27;Bourgogne-Franche-Comté;39;2;03;533;Toulouse-le-Château;221;3;224
27;Bourgogne-Franche-Comté;39;2;09;534;La Tour-du-Meix;231;4;235
27;Bourgogne-Franche-Comté;39;1;03;535;Tourmont;473;19;492
27;Bourgogne-Franche-Comté;39;2;85;537;Trenal;459;11;470
27;Bourgogne-Franche-Comté;39;2;13;378;Les Trois Châteaux;774;19;793
27;Bourgogne-Franche-Comté;39;2;15;538;Uxelles;55;1;56
27;Bourgogne-Franche-Comté;39;1;01;539;Vadans;278;7;285
27;Bourgogne-Franche-Comté;39;2;13;209;Val-d'Épy;343;7;350
27;Bourgogne-Franche-Comté;39;2;13;576;Val-Sonnette;912;29;941
27;Bourgogne-Franche-Comté;39;2;13;485;Val Suran;787;17;804
27;Bourgogne-Franche-Comté;39;2;04;540;Valempoulières;193;11;204
27;Bourgogne-Franche-Comté;39;2;09;290;Valzin en Petite Montagne;497;17;514
27;Bourgogne-Franche-Comté;39;2;04;543;Vannoz;207;7;214
27;Bourgogne-Franche-Comté;39;2;04;545;Le Vaudioux;175;6;181
27;Bourgogne-Franche-Comté;39;1;10;546;Vaudrey;373;14;387
27;Bourgogne-Franche-Comté;39;3;16;547;Vaux-lès-Saint-Claude;693;18;711
27;Bourgogne-Franche-Comté;39;1;12;548;Vaux-sur-Poligny;77;4;81
27;Bourgogne-Franche-Comté;39;2;12;550;Verges;191;5;196
27;Bourgogne-Franche-Comté;39;2;13;551;Véria;117;4;121
27;Bourgogne-Franche-Comté;39;2;08;552;Vernantois;328;11;339
27;Bourgogne-Franche-Comté;39;2;12;553;Le Vernois;308;10;318
27;Bourgogne-Franche-Comté;39;2;04;554;Vers-en-Montagne;234;5;239
27;Bourgogne-Franche-Comté;39;2;03;555;Vers-sous-Sellières;238;2;240
27;Bourgogne-Franche-Comté;39;2;15;556;Vertamboz;94;5;99
27;Bourgogne-Franche-Comté;39;2;09;557;Vescles;193;3;196
27;Bourgogne-Franche-Comté;39;2;12;558;Vevy;274;12;286
27;Bourgogne-Franche-Comté;39;1;10;559;La Vieille-Loye;404;4;408
27;Bourgogne-Franche-Comté;39;3;16;560;Villard-Saint-Sauveur;618;20;638
27;Bourgogne-Franche-Comté;39;3;09;561;Villards-d'Héria;409;6;415
27;Bourgogne-Franche-Comté;39;1;10;565;Villeneuve-d'Aval;87;1;88
27;Bourgogne-Franche-Comté;39;2;07;567;Villeneuve-sous-Pymont;291;9;300
27;Bourgogne-Franche-Comté;39;1;10;569;Villers-Farlay;666;11;677
27;Bourgogne-Franche-Comté;39;1;03;570;Villers-les-Bois;212;1;213
27;Bourgogne-Franche-Comté;39;1;17;571;Villers-Robert;231;2;233
27;Bourgogne-Franche-Comté;39;1;03;568;Villerserine;51;1;52
27;Bourgogne-Franche-Comté;39;1;01;572;Villette-lès-Arbois;386;7;393
27;Bourgogne-Franche-Comté;39;1;06;573;Villette-lès-Dole;771;14;785
27;Bourgogne-Franche-Comté;39;2;03;574;Villevieux;712;20;732
27;Bourgogne-Franche-Comté;39;2;03;575;Le Villey;89;0;89
27;Bourgogne-Franche-Comté;39;2;03;577;Vincent-Froideville;394;3;397
27;Bourgogne-Franche-Comté;39;3;16;579;Viry;927;43;970
27;Bourgogne-Franche-Comté;39;1;02;581;Vitreux;286;4;290
27;Bourgogne-Franche-Comté;39;2;12;582;Voiteur;746;31;777
27;Bourgogne-Franche-Comté;39;2;09;583;Vosbles-Valfin;185;12;197
27;Bourgogne-Franche-Comté;39;1;02;584;Vriange;156;3;159
27;Bourgogne-Franche-Comté;39;3;16;585;Vulvoz;20;0;20
75;Nouvelle-Aquitaine;40;2;01;001;Aire-sur-l'Adour;6129;552;6681
75;Nouvelle-Aquitaine;40;1;04;002;Amou;1540;22;1562
75;Nouvelle-Aquitaine;40;1;05;003;Angoumé;281;7;288
75;Nouvelle-Aquitaine;40;1;09;004;Angresse;2003;45;2048
75;Nouvelle-Aquitaine;40;2;02;005;Arboucave;201;4;205
75;Nouvelle-Aquitaine;40;2;13;006;Arengosse;683;9;692
75;Nouvelle-Aquitaine;40;1;04;007;Argelos;165;2;167
75;Nouvelle-Aquitaine;40;2;08;008;Argelouse;93;2;95
75;Nouvelle-Aquitaine;40;1;04;011;Arsague;340;3;343
75;Nouvelle-Aquitaine;40;2;01;012;Artassenx;250;1;251
75;Nouvelle-Aquitaine;40;2;01;013;Arthez-d'Armagnac;110;1;111
75;Nouvelle-Aquitaine;40;2;08;014;Arue;348;4;352
75;Nouvelle-Aquitaine;40;2;08;015;Arx;58;1;59
75;Nouvelle-Aquitaine;40;2;02;016;Aubagnan;250;3;253
75;Nouvelle-Aquitaine;40;2;02;017;Audignon;395;1;396
75;Nouvelle-Aquitaine;40;1;13;018;Audon;373;7;380
75;Nouvelle-Aquitaine;40;2;03;019;Aureilhan;1064;28;1092
75;Nouvelle-Aquitaine;40;2;02;020;Aurice;609;20;629
75;Nouvelle-Aquitaine;40;1;09;021;Azur;842;10;852
75;Nouvelle-Aquitaine;40;2;01;022;Bahus-Soubiran;409;15;424
75;Nouvelle-Aquitaine;40;1;04;023;Baigts;364;9;373
75;Nouvelle-Aquitaine;40;2;02;024;Banos;277;4;281
75;Nouvelle-Aquitaine;40;2;02;026;Bas-Mauco;360;10;370
75;Nouvelle-Aquitaine;40;2;01;025;Bascons;845;32;877
75;Nouvelle-Aquitaine;40;1;04;027;Bassercles;155;2;157
75;Nouvelle-Aquitaine;40;1;04;028;Bastennes;255;9;264
75;Nouvelle-Aquitaine;40;2;02;029;Bats;304;3;307
75;Nouvelle-Aquitaine;40;2;08;030;Baudignan;54;0;54
75;Nouvelle-Aquitaine;40;1;13;031;Bégaar;1167;16;1183
75;Nouvelle-Aquitaine;40;2;07;032;Belhade;198;6;204
75;Nouvelle-Aquitaine;40;2;08;033;Bélis;165;5;170
75;Nouvelle-Aquitaine;40;1;12;034;Bélus;602;10;612
75;Nouvelle-Aquitaine;40;1;06;035;Bénesse-lès-Dax;529;10;539
75;Nouvelle-Aquitaine;40;1;14;036;Bénesse-Maremne;3234;64;3298
75;Nouvelle-Aquitaine;40;2;11;037;Benquet;1732;45;1777
75;Nouvelle-Aquitaine;40;1;04;038;Bergouey;98;2;100
75;Nouvelle-Aquitaine;40;2;08;039;Betbezer-d'Armagnac;149;0;149
75;Nouvelle-Aquitaine;40;1;13;040;Beylongue;365;2;367
75;Nouvelle-Aquitaine;40;1;04;041;Beyries;128;2;130
75;Nouvelle-Aquitaine;40;1;15;042;Biarrotte;289;6;295
75;Nouvelle-Aquitaine;40;2;03;043;Bias;739;13;752
75;Nouvelle-Aquitaine;40;1;15;044;Biaudos;908;31;939
75;Nouvelle-Aquitaine;40;2;07;046;Biscarrosse;14182;379;14561
75;Nouvelle-Aquitaine;40;1;04;047;Bonnegarde;274;5;279
75;Nouvelle-Aquitaine;40;2;01;049;Bordères-et-Lamensans;369;6;375
75;Nouvelle-Aquitaine;40;2;10;050;Bostens;201;2;203
75;Nouvelle-Aquitaine;40;2;11;051;Bougue;774;23;797
75;Nouvelle-Aquitaine;40;2;01;052;Bourdalat;252;4;256
75;Nouvelle-Aquitaine;40;2;08;053;Bourriot-Bergonce;310;5;315
75;Nouvelle-Aquitaine;40;1;04;054;Brassempouy;267;6;273
75;Nouvelle-Aquitaine;40;2;11;055;Bretagne-de-Marsan;1544;28;1572
75;Nouvelle-Aquitaine;40;2;08;056;Brocas;789;22;811
75;Nouvelle-Aquitaine;40;2;01;057;Buanes;259;4;263
75;Nouvelle-Aquitaine;40;2;08;058;Cachen;226;3;229
75;Nouvelle-Aquitaine;40;1;12;059;Cagnotte;760;18;778
75;Nouvelle-Aquitaine;40;2;08;060;Callen;144;4;148
75;Nouvelle-Aquitaine;40;2;11;061;Campagne;998;28;1026
75;Nouvelle-Aquitaine;40;2;10;062;Campet-et-Lamolère;441;5;446
75;Nouvelle-Aquitaine;40;1;06;063;Candresse;807;27;834
75;Nouvelle-Aquitaine;40;2;08;064;Canenx-et-Réaut;158;3;161
75;Nouvelle-Aquitaine;40;1;14;065;Capbreton;8769;289;9058
75;Nouvelle-Aquitaine;40;1;13;066;Carcarès-Sainte-Croix;519;4;523
75;Nouvelle-Aquitaine;40;1;13;067;Carcen-Ponson;634;5;639
75;Nouvelle-Aquitaine;40;1;04;068;Cassen;578;16;594
75;Nouvelle-Aquitaine;40;1;04;069;Castaignos-Souslens;394;4;398
75;Nouvelle-Aquitaine;40;2;01;070;Castandet;398;17;415
75;Nouvelle-Aquitaine;40;1;04;074;Castel-Sarrazin;543;20;563
75;Nouvelle-Aquitaine;40;1;04;071;Castelnau-Chalosse;601;43;644
75;Nouvelle-Aquitaine;40;2;02;072;Castelnau-Tursan;193;2;195
75;Nouvelle-Aquitaine;40;2;02;073;Castelner;107;2;109
75;Nouvelle-Aquitaine;40;1;03;075;Castets;2388;26;2414
75;Nouvelle-Aquitaine;40;2;02;076;Cauna;444;7;451
75;Nouvelle-Aquitaine;40;1;12;077;Cauneille;799;14;813
75;Nouvelle-Aquitaine;40;1;04;078;Caupenne;404;8;412
75;Nouvelle-Aquitaine;40;2;02;079;Cazalis;134;4;138
75;Nouvelle-Aquitaine;40;2;01;080;Cazères-sur-l'Adour;1070;31;1101
75;Nouvelle-Aquitaine;40;2;08;081;Cère;411;6;417
75;Nouvelle-Aquitaine;40;2;01;082;Classun;271;6;277
75;Nouvelle-Aquitaine;40;2;02;083;Clèdes;128;7;135
75;Nouvelle-Aquitaine;40;1;04;084;Clermont;773;33;806
75;Nouvelle-Aquitaine;40;2;08;085;Commensacq;432;12;444
75;Nouvelle-Aquitaine;40;2;02;086;Coudures;451;9;460
75;Nouvelle-Aquitaine;40;2;08;087;Créon-d'Armagnac;362;7;369
75;Nouvelle-Aquitaine;40;1;98;088;Dax;20681;831;21512
75;Nouvelle-Aquitaine;40;1;04;089;Doazit;858;26;884
75;Nouvelle-Aquitaine;40;1;04;090;Donzacq;481;10;491
75;Nouvelle-Aquitaine;40;2;01;091;Duhort-Bachen;664;19;683
75;Nouvelle-Aquitaine;40;2;02;092;Dumes;236;6;242
75;Nouvelle-Aquitaine;40;2;08;093;Escalans;259;3;262
75;Nouvelle-Aquitaine;40;2;08;094;Escource;721;11;732
75;Nouvelle-Aquitaine;40;1;12;095;Estibeaux;699;15;714
75;Nouvelle-Aquitaine;40;2;08;096;Estigarde;121;2;123
75;Nouvelle-Aquitaine;40;2;01;097;Eugénie-les-Bains;446;10;456
75;Nouvelle-Aquitaine;40;2;02;098;Eyres-Moncube;365;13;378
75;Nouvelle-Aquitaine;40;2;02;099;Fargues;330;3;333
75;Nouvelle-Aquitaine;40;2;01;100;Le Frêche;400;2;402
75;Nouvelle-Aquitaine;40;1;12;101;Gaas;496;18;514
75;Nouvelle-Aquitaine;40;2;08;102;Gabarret;1295;246;1541
75;Nouvelle-Aquitaine;40;2;10;103;Gaillères;613;16;629
75;Nouvelle-Aquitaine;40;1;04;104;Gamarde-les-Bains;1319;31;1350
75;Nouvelle-Aquitaine;40;2;08;105;Garein;436;11;447
75;Nouvelle-Aquitaine;40;1;04;106;Garrey;205;6;211
75;Nouvelle-Aquitaine;40;2;07;108;Gastes;816;12;828
75;Nouvelle-Aquitaine;40;1;04;109;Gaujacq;435;10;445
75;Nouvelle-Aquitaine;40;2;02;110;Geaune;668;14;682
75;Nouvelle-Aquitaine;40;2;10;111;Geloux;704;16;720
75;Nouvelle-Aquitaine;40;1;04;112;Gibret;102;1;103
75;Nouvelle-Aquitaine;40;1;04;113;Goos;519;9;528
75;Nouvelle-Aquitaine;40;1;05;114;Gourbera;372;6;378
75;Nouvelle-Aquitaine;40;1;04;115;Gousse;312;11;323
75;Nouvelle-Aquitaine;40;1;13;116;Gouts;276;4;280
75;Nouvelle-Aquitaine;40;2;01;117;Grenade-sur-l'Adour;2487;84;2571
75;Nouvelle-Aquitaine;40;1;12;118;Habas;1503;26;1529
75;Nouvelle-Aquitaine;40;2;02;119;Hagetmau;4690;139;4829
75;Nouvelle-Aquitaine;40;1;12;120;Hastingues;579;16;595
75;Nouvelle-Aquitaine;40;1;04;121;Hauriet;278;5;283
75;Nouvelle-Aquitaine;40;2;02;122;Haut-Mauco;948;27;975
75;Nouvelle-Aquitaine;40;1;05;123;Herm;1129;43;1172
75;Nouvelle-Aquitaine;40;2;08;124;Herré;142;1;143
75;Nouvelle-Aquitaine;40;1;06;125;Heugas;1343;37;1380
75;Nouvelle-Aquitaine;40;1;04;126;Hinx;1883;41;1924
75;Nouvelle-Aquitaine;40;2;01;127;Hontanx;603;5;608
75;Nouvelle-Aquitaine;40;2;02;128;Horsarrieu;687;19;706
75;Nouvelle-Aquitaine;40;1;14;129;Josse;850;26;876
75;Nouvelle-Aquitaine;40;2;02;130;Labastide-Chalosse;150;4;154
75;Nouvelle-Aquitaine;40;2;08;131;Labastide-d'Armagnac;687;5;692
75;Nouvelle-Aquitaine;40;1;12;132;Labatut;1427;26;1453
75;Nouvelle-Aquitaine;40;1;14;133;Labenne;6616;112;6728
75;Nouvelle-Aquitaine;40;2;08;134;Labouheyre;2731;45;2776
75;Nouvelle-Aquitaine;40;2;08;135;Labrit;864;10;874
75;Nouvelle-Aquitaine;40;2;02;136;Lacajunte;153;4;157
75;Nouvelle-Aquitaine;40;2;01;137;Lacquy;280;5;285
75;Nouvelle-Aquitaine;40;2;02;138;Lacrabe;267;6;273
75;Nouvelle-Aquitaine;40;2;11;139;Laglorieuse;550;15;565
75;Nouvelle-Aquitaine;40;2;08;140;Lagrange;192;3;195
75;Nouvelle-Aquitaine;40;1;04;141;Lahosse;317;4;321
75;Nouvelle-Aquitaine;40;1;13;142;Laluque;1019;20;1039
75;Nouvelle-Aquitaine;40;1;13;143;Lamothe;312;4;316
75;Nouvelle-Aquitaine;40;1;04;144;Larbey;242;4;246
75;Nouvelle-Aquitaine;40;2;01;145;Larrivière-Saint-Savin;657;19;676
75;Nouvelle-Aquitaine;40;2;01;146;Latrille;156;3;159
75;Nouvelle-Aquitaine;40;1;04;147;Laurède;387;4;391
75;Nouvelle-Aquitaine;40;2;02;148;Lauret;85;3;88
75;Nouvelle-Aquitaine;40;2;08;149;Lencouacq;380;5;385
75;Nouvelle-Aquitaine;40;1;03;150;Léon;1940;51;1991
75;Nouvelle-Aquitaine;40;1;13;151;Lesgor;439;12;451
75;Nouvelle-Aquitaine;40;2;13;152;Lesperon;1043;27;1070
75;Nouvelle-Aquitaine;40;1;13;153;Le Leuy;251;2;253
75;Nouvelle-Aquitaine;40;1;03;154;Lévignacq;316;5;321
75;Nouvelle-Aquitaine;40;1;03;155;Linxe;1479;35;1514
75;Nouvelle-Aquitaine;40;2;07;156;Liposthey;534;5;539
75;Nouvelle-Aquitaine;40;1;03;157;Lit-et-Mixe;1606;31;1637
75;Nouvelle-Aquitaine;40;2;08;158;Losse;275;3;278
75;Nouvelle-Aquitaine;40;1;04;159;Louer;301;7;308
75;Nouvelle-Aquitaine;40;1;04;160;Lourquen;178;6;184
75;Nouvelle-Aquitaine;40;2;08;161;Lubbon;104;1;105
75;Nouvelle-Aquitaine;40;2;10;162;Lucbardez-et-Bargues;573;14;587
75;Nouvelle-Aquitaine;40;2;07;163;Lüe;562;10;572
75;Nouvelle-Aquitaine;40;2;08;165;Luglon;399;2;401
75;Nouvelle-Aquitaine;40;2;01;166;Lussagnet;73;1;74
75;Nouvelle-Aquitaine;40;2;08;167;Luxey;664;13;677
75;Nouvelle-Aquitaine;40;1;09;168;Magescq;2175;33;2208
75;Nouvelle-Aquitaine;40;2;08;169;Maillas;133;3;136
75;Nouvelle-Aquitaine;40;2;08;170;Maillères;243;4;247
75;Nouvelle-Aquitaine;40;2;07;171;Mano;125;3;128
75;Nouvelle-Aquitaine;40;2;02;172;Mant;271;4;275
75;Nouvelle-Aquitaine;40;1;04;173;Marpaps;139;5;144
75;Nouvelle-Aquitaine;40;2;02;174;Mauries;90;1;91
75;Nouvelle-Aquitaine;40;2;01;175;Maurrin;442;6;448
75;Nouvelle-Aquitaine;40;2;08;176;Mauvezin-d'Armagnac;93;1;94
75;Nouvelle-Aquitaine;40;1;04;177;Maylis;315;17;332
75;Nouvelle-Aquitaine;40;2;11;178;Mazerolles;633;27;660
75;Nouvelle-Aquitaine;40;1;05;179;Mées;1805;46;1851
75;Nouvelle-Aquitaine;40;1;13;180;Meilhan;1140;30;1170
75;Nouvelle-Aquitaine;40;1;09;181;Messanges;968;32;1000
75;Nouvelle-Aquitaine;40;2;03;182;Mézos;824;11;835
75;Nouvelle-Aquitaine;40;1;12;183;Mimbaste;1000;33;1033
75;Nouvelle-Aquitaine;40;2;03;184;Mimizan;7018;164;7182
75;Nouvelle-Aquitaine;40;2;02;185;Miramont-Sensacq;359;8;367
75;Nouvelle-Aquitaine;40;1;12;186;Misson;781;16;797
75;Nouvelle-Aquitaine;40;1;09;187;Moliets-et-Maa;1170;16;1186
75;Nouvelle-Aquitaine;40;2;02;188;Momuy;462;14;476
75;Nouvelle-Aquitaine;40;2;02;189;Monget;91;3;94
75;Nouvelle-Aquitaine;40;2;02;190;Monségur;391;11;402
75;Nouvelle-Aquitaine;40;2;99;192;Mont-de-Marsan;29554;1440;30994
75;Nouvelle-Aquitaine;40;2;02;191;Montaut;626;13;639
75;Nouvelle-Aquitaine;40;2;01;193;Montégut;71;2;73
75;Nouvelle-Aquitaine;40;1;04;194;Montfort-en-Chalosse;1177;28;1205
75;Nouvelle-Aquitaine;40;2;02;195;Montgaillard;631;13;644
75;Nouvelle-Aquitaine;40;2;02;196;Montsoué;570;11;581
75;Nouvelle-Aquitaine;40;2;13;197;Morcenx-la-Nouvelle;5052;178;5230
75;Nouvelle-Aquitaine;40;2;02;198;Morganx;173;9;182
75;Nouvelle-Aquitaine;40;1;12;199;Mouscardès;268;3;271
75;Nouvelle-Aquitaine;40;2;07;200;Moustey;695;10;705
75;Nouvelle-Aquitaine;40;1;04;201;Mugron;1382;109;1491
75;Nouvelle-Aquitaine;40;1;06;202;Narrosse;3210;73;3283
75;Nouvelle-Aquitaine;40;1;04;203;Nassiet;344;14;358
75;Nouvelle-Aquitaine;40;1;04;204;Nerbis;273;4;277
75;Nouvelle-Aquitaine;40;1;04;205;Nousse;244;8;252
75;Nouvelle-Aquitaine;40;1;12;206;Oeyregave;344;14;358
75;Nouvelle-Aquitaine;40;1;06;207;Oeyreluy;1508;230;1738
75;Nouvelle-Aquitaine;40;1;04;208;Onard;372;6;378
75;Nouvelle-Aquitaine;40;1;15;209;Ondres;5358;120;5478
75;Nouvelle-Aquitaine;40;2;13;210;Onesse-Laharie;1009;19;1028
75;Nouvelle-Aquitaine;40;1;12;211;Orist;722;18;740
75;Nouvelle-Aquitaine;40;1;12;212;Orthevielle;936;14;950
75;Nouvelle-Aquitaine;40;1;14;213;Orx;624;10;634
75;Nouvelle-Aquitaine;40;1;12;214;Ossages;504;19;523
75;Nouvelle-Aquitaine;40;2;13;215;Ousse-Suzan;277;8;285
75;Nouvelle-Aquitaine;40;1;04;216;Ozourt;203;2;205
75;Nouvelle-Aquitaine;40;2;07;217;Parentis-en-Born;6236;206;6442
75;Nouvelle-Aquitaine;40;2;08;218;Parleboscq;506;4;510
75;Nouvelle-Aquitaine;40;2;02;219;Payros-Cazautets;106;3;109
75;Nouvelle-Aquitaine;40;2;02;220;Pécorade;140;8;148
75;Nouvelle-Aquitaine;40;2;01;221;Perquie;350;14;364
75;Nouvelle-Aquitaine;40;1;12;222;Pey;676;22;698
75;Nouvelle-Aquitaine;40;2;02;223;Peyre;242;8;250
75;Nouvelle-Aquitaine;40;1;12;224;Peyrehorade;3695;175;3870
75;Nouvelle-Aquitaine;40;2;02;225;Philondenx;202;6;208
75;Nouvelle-Aquitaine;40;2;02;226;Pimbo;210;3;213
75;Nouvelle-Aquitaine;40;2;07;227;Pissos;1441;27;1468
75;Nouvelle-Aquitaine;40;1;04;228;Pomarez;1550;27;1577
75;Nouvelle-Aquitaine;40;2;03;229;Pontenx-les-Forges;1596;31;1627
75;Nouvelle-Aquitaine;40;1;13;230;Pontonx-sur-l'Adour;2810;115;2925
75;Nouvelle-Aquitaine;40;1;12;231;Port-de-Lanne;1076;21;1097
75;Nouvelle-Aquitaine;40;2;02;232;Poudenx;225;6;231
75;Nouvelle-Aquitaine;40;1;12;233;Pouillon;3072;81;3153
75;Nouvelle-Aquitaine;40;2;10;234;Pouydesseaux;916;27;943
75;Nouvelle-Aquitaine;40;1;04;235;Poyanne;688;10;698
75;Nouvelle-Aquitaine;40;1;04;236;Poyartin;833;21;854
75;Nouvelle-Aquitaine;40;1;04;237;Préchacq-les-Bains;733;6;739
75;Nouvelle-Aquitaine;40;2;01;238;Pujo-le-Plan;628;19;647
75;Nouvelle-Aquitaine;40;2;02;239;Puyol-Cazalet;108;3;111
75;Nouvelle-Aquitaine;40;2;01;240;Renung;537;11;548
75;Nouvelle-Aquitaine;40;2;08;164;Retjons;350;1;351
75;Nouvelle-Aquitaine;40;2;08;242;Rimbez-et-Baudiets;105;1;106
75;Nouvelle-Aquitaine;40;1;13;243;Rion-des-Landes;2986;43;3029
75;Nouvelle-Aquitaine;40;1;05;244;Rivière-Saas-et-Gourby;1217;28;1245
75;Nouvelle-Aquitaine;40;2;08;245;Roquefort;1892;49;1941
75;Nouvelle-Aquitaine;40;2;08;246;Sabres;1174;154;1328
75;Nouvelle-Aquitaine;40;2;01;247;Saint-Agnet;188;6;194
75;Nouvelle-Aquitaine;40;1;15;248;Saint-André-de-Seignanx;1766;26;1792
75;Nouvelle-Aquitaine;40;1;04;249;Saint-Aubin;503;13;516
75;Nouvelle-Aquitaine;40;2;10;250;Saint-Avit;672;21;693
75;Nouvelle-Aquitaine;40;1;15;251;Saint-Barthélemy;422;13;435
75;Nouvelle-Aquitaine;40;2;02;253;Saint-Cricq-Chalosse;641;11;652
75;Nouvelle-Aquitaine;40;1;12;254;Saint-Cricq-du-Gave;422;7;429
75;Nouvelle-Aquitaine;40;2;01;255;Saint-Cricq-Villeneuve;482;11;493
75;Nouvelle-Aquitaine;40;1;12;256;Saint-Étienne-d'Orthe;704;17;721
75;Nouvelle-Aquitaine;40;2;01;259;Saint-Gein;433;13;446
75;Nouvelle-Aquitaine;40;1;04;260;Saint-Geours-d'Auribat;413;8;421
75;Nouvelle-Aquitaine;40;1;09;261;Saint-Geours-de-Maremne;2673;48;2721
75;Nouvelle-Aquitaine;40;2;08;262;Saint-Gor;302;11;313
75;Nouvelle-Aquitaine;40;1;04;263;Saint-Jean-de-Lier;414;8;422
75;Nouvelle-Aquitaine;40;1;14;264;Saint-Jean-de-Marsacq;1614;23;1637
75;Nouvelle-Aquitaine;40;2;08;265;Saint-Julien-d'Armagnac;108;0;108
75;Nouvelle-Aquitaine;40;1;03;266;Saint-Julien-en-Born;1643;31;1674
75;Nouvelle-Aquitaine;40;2;08;267;Saint-Justin;974;13;987
75;Nouvelle-Aquitaine;40;1;15;268;Saint-Laurent-de-Gosse;657;21;678
75;Nouvelle-Aquitaine;40;1;12;269;Saint-Lon-les-Mines;1208;37;1245
75;Nouvelle-Aquitaine;40;2;01;270;Saint-Loubouer;443;8;451
75;Nouvelle-Aquitaine;40;2;10;274;Saint-Martin-d'Oney;1396;41;1437
75;Nouvelle-Aquitaine;40;1;14;272;Saint-Martin-de-Hinx;1480;36;1516
75;Nouvelle-Aquitaine;40;1;15;273;Saint-Martin-de-Seignanx;5488;125;5613
75;Nouvelle-Aquitaine;40;2;01;275;Saint-Maurice-sur-Adour;584;15;599
75;Nouvelle-Aquitaine;40;1;03;276;Saint-Michel-Escalus;305;8;313
75;Nouvelle-Aquitaine;40;1;06;277;Saint-Pandelon;715;53;768
75;Nouvelle-Aquitaine;40;2;03;278;Saint-Paul-en-Born;956;16;972
75;Nouvelle-Aquitaine;40;1;05;279;Saint-Paul-lès-Dax;13413;482;13895
75;Nouvelle-Aquitaine;40;2;11;280;Saint-Perdon;1726;32;1758
75;Nouvelle-Aquitaine;40;2;11;281;Saint-Pierre-du-Mont;9561;363;9924
75;Nouvelle-Aquitaine;40;2;02;282;Saint-Sever;4955;98;5053
75;Nouvelle-Aquitaine;40;1;05;283;Saint-Vincent-de-Paul;3126;221;3347
75;Nouvelle-Aquitaine;40;1;14;284;Saint-Vincent-de-Tyrosse;7593;233;7826
75;Nouvelle-Aquitaine;40;1;13;285;Saint-Yaguen;629;15;644
75;Nouvelle-Aquitaine;40;2;02;252;Sainte-Colombe;666;18;684
75;Nouvelle-Aquitaine;40;2;07;257;Sainte-Eulalie-en-Born;1265;20;1285
75;Nouvelle-Aquitaine;40;2;01;258;Sainte-Foy;253;3;256
75;Nouvelle-Aquitaine;40;1;14;271;Sainte-Marie-de-Gosse;1184;25;1209
75;Nouvelle-Aquitaine;40;2;02;286;Samadet;1152;22;1174
75;Nouvelle-Aquitaine;40;2;07;287;Sanguinet;4185;64;4249
75;Nouvelle-Aquitaine;40;2;08;288;Sarbazan;1176;23;1199
75;Nouvelle-Aquitaine;40;2;02;289;Sarraziet;240;1;241
75;Nouvelle-Aquitaine;40;2;01;290;Sarron;110;4;114
75;Nouvelle-Aquitaine;40;1;14;291;Saubion;1499;26;1525
75;Nouvelle-Aquitaine;40;1;14;292;Saubrigues;1415;79;1494
75;Nouvelle-Aquitaine;40;1;09;293;Saubusse;1120;22;1142
75;Nouvelle-Aquitaine;40;1;06;294;Saugnac-et-Cambran;1542;45;1587
75;Nouvelle-Aquitaine;40;2;07;295;Saugnacq-et-Muret;1035;18;1053
75;Nouvelle-Aquitaine;40;1;09;296;Seignosse;3872;96;3968
75;Nouvelle-Aquitaine;40;2;08;297;Le Sen;227;3;230
75;Nouvelle-Aquitaine;40;2;02;298;Serres-Gaston;394;12;406
75;Nouvelle-Aquitaine;40;2;02;299;Serreslous-et-Arribans;194;11;205
75;Nouvelle-Aquitaine;40;1;06;300;Seyresse;922;36;958
75;Nouvelle-Aquitaine;40;1;05;301;Siest;138;2;140
75;Nouvelle-Aquitaine;40;2;08;303;Solférino;324;2;326
75;Nouvelle-Aquitaine;40;1;09;304;Soorts-Hossegor;3580;90;3670
75;Nouvelle-Aquitaine;40;2;02;305;Sorbets;197;9;206
75;Nouvelle-Aquitaine;40;1;12;306;Sorde-l'Abbaye;631;13;644
75;Nouvelle-Aquitaine;40;2;08;307;Sore;1122;21;1143
75;Nouvelle-Aquitaine;40;1;04;308;Sort-en-Chalosse;945;31;976
75;Nouvelle-Aquitaine;40;1;13;309;Souprosse;1122;22;1144
75;Nouvelle-Aquitaine;40;1;09;310;Soustons;7877;191;8068
75;Nouvelle-Aquitaine;40;1;03;311;Taller;606;13;619
75;Nouvelle-Aquitaine;40;1;15;312;Tarnos;12264;316;12580
75;Nouvelle-Aquitaine;40;1;13;313;Tartas;3260;44;3304
75;Nouvelle-Aquitaine;40;1;05;314;Tercis-les-Bains;1203;38;1241
75;Nouvelle-Aquitaine;40;1;05;315;Téthieu;759;12;771
75;Nouvelle-Aquitaine;40;1;12;316;Tilh;813;19;832
75;Nouvelle-Aquitaine;40;1;09;317;Tosse;2927;74;3001
75;Nouvelle-Aquitaine;40;1;04;318;Toulouzette;322;6;328
75;Nouvelle-Aquitaine;40;2;08;319;Trensacq;245;4;249
75;Nouvelle-Aquitaine;40;2;10;320;Uchacq-et-Parentis;589;20;609
75;Nouvelle-Aquitaine;40;2;02;321;Urgons;252;8;260
75;Nouvelle-Aquitaine;40;1;03;322;Uza;195;1;196
75;Nouvelle-Aquitaine;40;2;08;323;Vert;270;4;274
75;Nouvelle-Aquitaine;40;1;04;324;Vicq-d'Auribat;262;10;272
75;Nouvelle-Aquitaine;40;1;03;326;Vielle-Saint-Girons;1305;31;1336
75;Nouvelle-Aquitaine;40;2;08;327;Vielle-Soubiran;229;5;234
75;Nouvelle-Aquitaine;40;2;01;325;Vielle-Tursan;257;8;265
75;Nouvelle-Aquitaine;40;1;09;328;Vieux-Boucau-les-Bains;1618;22;1640
75;Nouvelle-Aquitaine;40;2;01;329;Le Vignau;490;6;496
75;Nouvelle-Aquitaine;40;1;13;330;Villenave;326;4;330
75;Nouvelle-Aquitaine;40;2;01;331;Villeneuve-de-Marsan;2413;47;2460
75;Nouvelle-Aquitaine;40;2;07;332;Ychoux;2281;41;2322
75;Nouvelle-Aquitaine;40;2;13;333;Ygos-Saint-Saturnin;1322;14;1336
75;Nouvelle-Aquitaine;40;1;06;334;Yzosse;367;13;380
24;Centre-Val de Loire;41;2;06;001;Ambloy;185;5;190
24;Centre-Val de Loire;41;3;11;002;Angé;882;22;904
24;Centre-Val de Loire;41;2;14;003;Areines;616;232;848
24;Centre-Val de Loire;41;2;06;004;Artins;264;5;269
24;Centre-Val de Loire;41;1;01;006;Autainville;444;8;452
24;Centre-Val de Loire;41;2;06;007;Authon;721;13;734
24;Centre-Val de Loire;41;1;01;008;Avaray;737;16;753
24;Centre-Val de Loire;41;1;08;009;Averdon;697;14;711
24;Centre-Val de Loire;41;2;14;010;Azé;1033;30;1063
24;Centre-Val de Loire;41;2;09;012;Baillou;226;13;239
24;Centre-Val de Loire;41;1;05;013;Bauzy;278;4;282
24;Centre-Val de Loire;41;1;01;173;Beauce la Romaine;3484;67;3551
24;Centre-Val de Loire;41;2;09;014;Beauchêne;173;2;175
24;Centre-Val de Loire;41;3;12;016;Billy;1020;9;1029
24;Centre-Val de Loire;41;1;01;017;Binas;686;17;703
24;Centre-Val de Loire;41;1;99;018;Blois;46086;1629;47715
24;Centre-Val de Loire;41;1;01;019;Boisseau;99;2;101
24;Centre-Val de Loire;41;2;09;020;Bonneveau;467;7;474
24;Centre-Val de Loire;41;2;09;022;Bouffry;134;1;135
24;Centre-Val de Loire;41;2;09;024;Boursay;166;6;172
24;Centre-Val de Loire;41;1;05;025;Bracieux;1305;19;1324
24;Centre-Val de Loire;41;2;09;026;Brévainville;170;4;174
24;Centre-Val de Loire;41;1;01;027;Briou;147;2;149
24;Centre-Val de Loire;41;2;09;028;Busloup;439;6;445
24;Centre-Val de Loire;41;1;04;029;Candé-sur-Beuvron;1497;27;1524
24;Centre-Val de Loire;41;2;09;030;Cellé;225;3;228
24;Centre-Val de Loire;41;1;15;031;Cellettes;2633;65;2698
24;Centre-Val de Loire;41;1;04;032;Chailles;2680;81;2761
24;Centre-Val de Loire;41;1;05;034;Chambord;93;0;93
24;Centre-Val de Loire;41;1;08;035;Champigny-en-Beauce;604;17;621
24;Centre-Val de Loire;41;3;13;036;Chaon;459;7;466
24;Centre-Val de Loire;41;2;09;037;La Chapelle-Enchérie;211;4;215
24;Centre-Val de Loire;41;3;12;038;La Chapelle-Montmartin;435;8;443
24;Centre-Val de Loire;41;1;01;039;La Chapelle-Saint-Martin-en-Plaine;730;15;745
24;Centre-Val de Loire;41;1;08;040;La Chapelle-Vendômoise;783;25;808
24;Centre-Val de Loire;41;2;09;041;La Chapelle-Vicomtesse;169;3;172
24;Centre-Val de Loire;41;3;11;042;Châteauvieux;538;4;542
24;Centre-Val de Loire;41;3;11;043;Châtillon-sur-Cher;1722;32;1754
24;Centre-Val de Loire;41;3;12;044;Châtres-sur-Cher;1097;10;1107
24;Centre-Val de Loire;41;1;04;045;Chaumont-sur-Loire;1086;9;1095
24;Centre-Val de Loire;41;3;13;046;Chaumont-sur-Tharonne;1074;14;1088
24;Centre-Val de Loire;41;1;03;047;La Chaussée-Saint-Victor;4503;131;4634
24;Centre-Val de Loire;41;2;09;048;Chauvigny-du-Perche;220;1;221
24;Centre-Val de Loire;41;3;11;049;Chémery;971;12;983
24;Centre-Val de Loire;41;1;15;050;Cheverny;956;40;996
24;Centre-Val de Loire;41;3;07;051;Chissay-en-Touraine;1127;26;1153
24;Centre-Val de Loire;41;1;15;052;Chitenay;1068;35;1103
24;Centre-Val de Loire;41;2;09;053;Choue;529;5;534
24;Centre-Val de Loire;41;3;07;054;Choussy;338;5;343
24;Centre-Val de Loire;41;1;01;057;Conan;175;0;175
24;Centre-Val de Loire;41;1;01;058;Concriers;176;5;181
24;Centre-Val de Loire;41;3;89;059;Le Controis-en-Sologne;6866;148;7014
24;Centre-Val de Loire;41;2;09;060;Cormenon;690;12;702
24;Centre-Val de Loire;41;1;15;061;Cormeray;1560;26;1586
24;Centre-Val de Loire;41;3;07;062;Couddes;546;7;553
24;Centre-Val de Loire;41;2;09;248;Couëtron-au-Perche;1065;15;1080
24;Centre-Val de Loire;41;3;11;063;Couffy;497;9;506
24;Centre-Val de Loire;41;2;06;065;Coulommiers-la-Tour;557;16;573
24;Centre-Val de Loire;41;1;15;067;Cour-Cheverny;2845;62;2907
24;Centre-Val de Loire;41;1;01;069;Cour-sur-Loire;266;6;272
24;Centre-Val de Loire;41;1;01;066;Courbouzon;435;10;445
24;Centre-Val de Loire;41;3;05;068;Courmemin;509;8;517
24;Centre-Val de Loire;41;1;05;071;Crouy-sur-Cosson;537;11;548
24;Centre-Val de Loire;41;2;06;072;Crucheray;381;14;395
24;Centre-Val de Loire;41;2;09;073;Danzé;694;17;711
24;Centre-Val de Loire;41;3;05;074;Dhuizon;1233;16;1249
24;Centre-Val de Loire;41;2;09;075;Droué;992;8;1000
24;Centre-Val de Loire;41;1;01;077;Épiais;136;4;140
24;Centre-Val de Loire;41;2;09;078;Épuisay;831;17;848
24;Centre-Val de Loire;41;2;06;079;Les Essarts;108;0;108
24;Centre-Val de Loire;41;3;07;080;Faverolles-sur-Cher;1386;29;1415
24;Centre-Val de Loire;41;2;06;081;Faye;243;5;248
24;Centre-Val de Loire;41;3;05;083;La Ferté-Beauharnais;525;4;529
24;Centre-Val de Loire;41;3;13;084;La Ferté-Imbault;975;27;1002
24;Centre-Val de Loire;41;1;05;085;La Ferté-Saint-Cyr;1056;12;1068
24;Centre-Val de Loire;41;2;09;087;Fontaine-les-Coteaux;337;5;342
24;Centre-Val de Loire;41;2;09;088;Fontaine-Raoul;225;6;231
24;Centre-Val de Loire;41;1;05;086;Fontaines-en-Sologne;633;10;643
24;Centre-Val de Loire;41;2;09;089;La Fontenelle;195;4;199
24;Centre-Val de Loire;41;2;09;090;Fortan;269;7;276
24;Centre-Val de Loire;41;1;08;091;Fossé;1308;18;1326
24;Centre-Val de Loire;41;1;08;093;Françay;273;9;282
24;Centre-Val de Loire;41;3;07;094;Fresnes;1145;37;1182
24;Centre-Val de Loire;41;2;09;095;Fréteval;1083;22;1105
24;Centre-Val de Loire;41;2;09;096;Le Gault-du-Perche;341;3;344
24;Centre-Val de Loire;41;3;12;097;Gièvres;2396;31;2427
24;Centre-Val de Loire;41;2;06;098;Gombergean;188;4;192
24;Centre-Val de Loire;41;3;12;099;Gy-en-Sologne;499;13;512
24;Centre-Val de Loire;41;2;06;100;Les Hayes;176;8;184
24;Centre-Val de Loire;41;1;08;101;Herbault;1249;32;1281
24;Centre-Val de Loire;41;2;06;102;Houssay;387;3;390
24;Centre-Val de Loire;41;2;06;103;Huisseau-en-Beauce;423;8;431
24;Centre-Val de Loire;41;1;05;104;Huisseau-sur-Cosson;2281;57;2338
24;Centre-Val de Loire;41;1;01;105;Josnes;887;18;905
24;Centre-Val de Loire;41;3;13;106;Lamotte-Beuvron;4724;64;4788
24;Centre-Val de Loire;41;2;06;107;Lancé;473;7;480
24;Centre-Val de Loire;41;1;08;108;Lancôme;122;3;125
24;Centre-Val de Loire;41;1;08;109;Landes-le-Gaulois;750;21;771
24;Centre-Val de Loire;41;3;12;110;Langon-sur-Cher;812;12;824
24;Centre-Val de Loire;41;3;12;112;Lassay-sur-Croisne;249;9;258
24;Centre-Val de Loire;41;2;06;113;Lavardin;183;7;190
24;Centre-Val de Loire;41;1;01;114;Lestiou;290;7;297
24;Centre-Val de Loire;41;2;09;115;Lignières;380;5;385
24;Centre-Val de Loire;41;2;09;116;Lisle;195;3;198
24;Centre-Val de Loire;41;3;10;118;Loreux;209;4;213
24;Centre-Val de Loire;41;1;01;119;Lorges;352;6;358
24;Centre-Val de Loire;41;2;06;120;Lunay;1267;33;1300
24;Centre-Val de Loire;41;1;01;121;La Madeleine-Villefrouin;30;0;30
24;Centre-Val de Loire;41;3;12;122;Maray;233;2;235
24;Centre-Val de Loire;41;1;01;123;Marchenoir;659;10;669
24;Centre-Val de Loire;41;2;06;124;Marcilly-en-Beauce;348;8;356
24;Centre-Val de Loire;41;3;13;125;Marcilly-en-Gault;735;16;751
24;Centre-Val de Loire;41;3;11;126;Mareuil-sur-Cher;1142;23;1165
24;Centre-Val de Loire;41;3;05;127;La Marolle-en-Sologne;344;6;350
24;Centre-Val de Loire;41;1;08;128;Marolles;725;18;743
24;Centre-Val de Loire;41;1;05;129;Maslives;702;13;715
24;Centre-Val de Loire;41;1;01;130;Maves;661;16;677
24;Centre-Val de Loire;41;2;14;131;Mazangé;855;29;884
24;Centre-Val de Loire;41;3;11;132;Méhers;338;7;345
24;Centre-Val de Loire;41;1;03;134;Menars;626;22;648
24;Centre-Val de Loire;41;3;12;135;Mennetou-sur-Cher;885;10;895
24;Centre-Val de Loire;41;1;01;136;Mer;6238;108;6346
24;Centre-Val de Loire;41;1;08;137;Mesland;565;23;588
24;Centre-Val de Loire;41;2;14;138;Meslay;312;9;321
24;Centre-Val de Loire;41;3;11;139;Meusnes;1097;13;1110
24;Centre-Val de Loire;41;3;10;140;Millançay;780;20;800
24;Centre-Val de Loire;41;2;09;141;Moisy;365;2;367
24;Centre-Val de Loire;41;2;09;143;Mondoubleau;1335;54;1389
24;Centre-Val de Loire;41;1;05;150;Mont-près-Chambord;3297;95;3392
24;Centre-Val de Loire;41;1;08;144;Monteaux;768;24;792
24;Centre-Val de Loire;41;1;04;145;Monthou-sur-Bièvre;811;21;832
24;Centre-Val de Loire;41;3;07;146;Monthou-sur-Cher;964;14;978
24;Centre-Val de Loire;41;1;04;147;Les Montils;1943;46;1989
24;Centre-Val de Loire;41;1;05;148;Montlivault;1377;18;1395
24;Centre-Val de Loire;41;2;06;149;Montoire-sur-le-Loir;3782;196;3978
24;Centre-Val de Loire;41;3;07;151;Montrichard Val de Cher;3810;51;3861
24;Centre-Val de Loire;41;3;05;152;Montrieux-en-Sologne;651;14;665
24;Centre-Val de Loire;41;2;06;153;Montrouveau;154;3;157
24;Centre-Val de Loire;41;2;09;154;Morée;1071;20;1091
24;Centre-Val de Loire;41;1;01;155;Muides-sur-Loire;1259;36;1295
24;Centre-Val de Loire;41;1;01;156;Mulsans;502;13;515
24;Centre-Val de Loire;41;3;12;157;Mur-de-Sologne;1519;17;1536
24;Centre-Val de Loire;41;2;06;158;Naveil;2361;68;2429
24;Centre-Val de Loire;41;3;05;159;Neung-sur-Beuvron;1226;18;1244
24;Centre-Val de Loire;41;1;05;160;Neuvy;319;4;323
24;Centre-Val de Loire;41;3;13;161;Nouan-le-Fuzelier;2326;41;2367
24;Centre-Val de Loire;41;2;06;163;Nourray;109;0;109
24;Centre-Val de Loire;41;3;11;164;Noyers-sur-Cher;2728;37;2765
24;Centre-Val de Loire;41;3;07;166;Oisly;377;5;382
24;Centre-Val de Loire;41;3;12;168;Orçay;235;3;238
24;Centre-Val de Loire;41;1;01;171;Oucques La Nouvelle;1724;27;1751
24;Centre-Val de Loire;41;2;09;172;Ouzouer-le-Doyen;243;1;244
24;Centre-Val de Loire;41;2;06;174;Périgny;177;7;184
24;Centre-Val de Loire;41;2;09;175;Pezou;1119;19;1138
24;Centre-Val de Loire;41;3;13;176;Pierrefitte-sur-Sauldre;789;14;803
24;Centre-Val de Loire;41;2;09;177;Le Plessis-Dorin;167;0;167
24;Centre-Val de Loire;41;1;01;178;Le Plessis-l'Échelle;70;2;72
24;Centre-Val de Loire;41;2;09;179;Le Poislay;181;4;185
24;Centre-Val de Loire;41;3;07;180;Pontlevoy;1524;167;1691
24;Centre-Val de Loire;41;3;11;181;Pouillé;796;20;816
24;Centre-Val de Loire;41;2;06;182;Pray;292;9;301
24;Centre-Val de Loire;41;2;06;184;Prunay-Cassereau;612;7;619
24;Centre-Val de Loire;41;3;12;185;Pruniers-en-Sologne;2388;59;2447
24;Centre-Val de Loire;41;2;09;186;Rahart;325;6;331
24;Centre-Val de Loire;41;2;09;187;Renay;171;4;175
24;Centre-Val de Loire;41;1;01;188;Rhodon;123;3;126
24;Centre-Val de Loire;41;1;04;189;Rilly-sur-Loire;474;6;480
24;Centre-Val de Loire;41;2;06;190;Rocé;218;7;225
24;Centre-Val de Loire;41;1;01;191;Roches;69;3;72
24;Centre-Val de Loire;41;2;06;192;Les Roches-l'Évêque;279;3;282
24;Centre-Val de Loire;41;2;09;193;Romilly;140;3;143
24;Centre-Val de Loire;41;3;10;194;Romorantin-Lanthenay;17754;492;18246
24;Centre-Val de Loire;41;3;11;195;Rougeou;159;0;159
24;Centre-Val de Loire;41;2;09;196;Ruan-sur-Egvonne;94;0;94
24;Centre-Val de Loire;41;3;11;198;Saint-Aignan;2849;75;2924
24;Centre-Val de Loire;41;2;06;199;Saint-Amand-Longpré;1224;27;1251
24;Centre-Val de Loire;41;2;06;201;Saint-Arnoult;321;3;324
24;Centre-Val de Loire;41;1;08;203;Saint-Bohaire;497;21;518
24;Centre-Val de Loire;41;1;05;204;Saint-Claude-de-Diray;1783;40;1823
24;Centre-Val de Loire;41;1;08;205;Saint-Cyr-du-Gault;174;2;176
24;Centre-Val de Loire;41;1;03;206;Saint-Denis-sur-Loire;837;28;865
24;Centre-Val de Loire;41;1;05;207;Saint-Dyé-sur-Loire;1140;19;1159
24;Centre-Val de Loire;41;1;08;208;Saint-Étienne-des-Guérets;111;3;114
24;Centre-Val de Loire;41;2;09;209;Saint-Firmin-des-Prés;824;41;865
24;Centre-Val de Loire;41;3;07;211;Saint-Georges-sur-Cher;2691;39;2730
24;Centre-Val de Loire;41;1;15;212;Saint-Gervais-la-Forêt;3201;99;3300
24;Centre-Val de Loire;41;2;06;213;Saint-Gourgon;113;4;117
24;Centre-Val de Loire;41;2;09;214;Saint-Hilaire-la-Gravelle;717;4;721
24;Centre-Val de Loire;41;2;06;215;Saint-Jacques-des-Guérets;91;2;93
24;Centre-Val de Loire;41;2;09;216;Saint-Jean-Froidmentel;548;8;556
24;Centre-Val de Loire;41;3;07;217;Saint-Julien-de-Chédon;756;17;773
24;Centre-Val de Loire;41;3;12;218;Saint-Julien-sur-Cher;768;11;779
24;Centre-Val de Loire;41;1;01;219;Saint-Laurent-des-Bois;287;12;299
24;Centre-Val de Loire;41;1;05;220;Saint-Laurent-Nouan;4357;86;4443
24;Centre-Val de Loire;41;1;01;221;Saint-Léonard-en-Beauce;644;17;661
24;Centre-Val de Loire;41;3;12;222;Saint-Loup;375;9;384
24;Centre-Val de Loire;41;1;08;223;Saint-Lubin-en-Vergonnois;718;10;728
24;Centre-Val de Loire;41;2;09;224;Saint-Marc-du-Cor;183;4;187
24;Centre-Val de Loire;41;2;06;225;Saint-Martin-des-Bois;579;11;590
24;Centre-Val de Loire;41;2;14;226;Saint-Ouen;3189;94;3283
24;Centre-Val de Loire;41;2;06;228;Saint-Rimay;291;3;294
24;Centre-Val de Loire;41;3;11;229;Saint-Romain-sur-Cher;1478;34;1512
24;Centre-Val de Loire;41;1;08;230;Saint-Sulpice-de-Pommeray;1855;56;1911
24;Centre-Val de Loire;41;3;13;231;Saint-Viâtre;1196;29;1225
24;Centre-Val de Loire;41;2;14;200;Sainte-Anne;459;14;473
24;Centre-Val de Loire;41;3;13;232;Salbris;5166;102;5268
24;Centre-Val de Loire;41;1;04;233;Sambin;940;14;954
24;Centre-Val de Loire;41;1;08;234;Santenay;290;8;298
24;Centre-Val de Loire;41;2;09;235;Sargé-sur-Braye;1041;22;1063
24;Centre-Val de Loire;41;2;06;236;Sasnières;112;0;112
24;Centre-Val de Loire;41;3;07;237;Sassay;1023;20;1043
24;Centre-Val de Loire;41;2;09;238;Savigny-sur-Braye;2017;28;2045
24;Centre-Val de Loire;41;3;11;239;Seigy;1055;24;1079
24;Centre-Val de Loire;41;3;13;241;Selles-Saint-Denis;1337;29;1366
24;Centre-Val de Loire;41;3;12;242;Selles-sur-Cher;4567;64;4631
24;Centre-Val de Loire;41;2;06;243;Selommes;813;13;826
24;Centre-Val de Loire;41;1;01;245;Séris;376;4;380
24;Centre-Val de Loire;41;1;04;246;Seur;477;19;496
24;Centre-Val de Loire;41;3;11;247;Soings-en-Sologne;1614;19;1633
24;Centre-Val de Loire;41;3;13;249;Souesmes;1059;12;1071
24;Centre-Val de Loire;41;2;09;250;Sougé;479;7;486
24;Centre-Val de Loire;41;3;13;251;Souvigny-en-Sologne;524;9;533
24;Centre-Val de Loire;41;1;01;252;Suèvres;1693;29;1722
24;Centre-Val de Loire;41;1;01;253;Talcy;243;11;254
24;Centre-Val de Loire;41;2;09;254;Le Temple;187;7;194
24;Centre-Val de Loire;41;2;06;255;Ternay;336;7;343
24;Centre-Val de Loire;41;3;12;256;Theillay;1260;19;1279
24;Centre-Val de Loire;41;3;11;258;Thésée;1132;22;1154
24;Centre-Val de Loire;41;2;06;259;Thoré-la-Rochette;885;17;902
24;Centre-Val de Loire;41;1;05;260;Thoury;420;7;427
24;Centre-Val de Loire;41;1;05;262;Tour-en-Sologne;1117;16;1133
24;Centre-Val de Loire;41;2;06;261;Tourailles;134;3;137
24;Centre-Val de Loire;41;2;06;265;Troo;297;9;306
24;Centre-Val de Loire;41;1;04;266;Valaire;86;2;88
24;Centre-Val de Loire;41;1;08;142;Valencisse;2398;93;2491
24;Centre-Val de Loire;41;2;06;070;Vallée-de-Ronsard;523;8;531
24;Centre-Val de Loire;41;3;07;267;Vallières-les-Grandes;937;19;956
24;Centre-Val de Loire;41;1;08;055;Valloire-sur-Cisse;2438;58;2496
24;Centre-Val de Loire;41;3;10;268;Veilleins;161;4;165
24;Centre-Val de Loire;41;2;14;269;Vendôme;16569;643;17212
24;Centre-Val de Loire;41;3;10;271;Vernou-en-Sologne;624;6;630
24;Centre-Val de Loire;41;1;08;167;Veuzain-sur-Loire;3503;108;3611
24;Centre-Val de Loire;41;1;01;273;Vievy-le-Rayé;453;7;460
24;Centre-Val de Loire;41;2;06;274;Villavard;128;0;128
24;Centre-Val de Loire;41;2;09;275;La Ville-aux-Clercs;1273;23;1296
24;Centre-Val de Loire;41;1;03;276;Villebarou;2460;81;2541
24;Centre-Val de Loire;41;2;09;277;Villebout;140;8;148
24;Centre-Val de Loire;41;2;06;278;Villechauve;276;8;284
24;Centre-Val de Loire;41;2;06;279;Villedieu-le-Château;414;4;418
24;Centre-Val de Loire;41;3;12;280;Villefranche-sur-Cher;2667;68;2735
24;Centre-Val de Loire;41;1;08;281;Villefrancœur;424;8;432
24;Centre-Val de Loire;41;3;10;282;Villeherviers;471;7;478
24;Centre-Val de Loire;41;2;06;283;Villemardy;277;4;281
24;Centre-Val de Loire;41;1;01;284;Villeneuve-Frouville;61;2;63
24;Centre-Val de Loire;41;3;05;285;Villeny;493;4;497
24;Centre-Val de Loire;41;2;06;286;Villeporcher;153;5;158
24;Centre-Val de Loire;41;2;06;287;Villerable;520;13;533
24;Centre-Val de Loire;41;1;03;288;Villerbon;799;16;815
24;Centre-Val de Loire;41;1;01;289;Villermain;398;12;410
24;Centre-Val de Loire;41;2;06;290;Villeromain;240;0;240
24;Centre-Val de Loire;41;2;06;291;Villetrun;322;4;326
24;Centre-Val de Loire;41;1;01;292;Villexanton;201;1;202
24;Centre-Val de Loire;41;2;14;294;Villiers-sur-Loir;1131;59;1190
24;Centre-Val de Loire;41;2;06;293;Villiersfaux;255;5;260
24;Centre-Val de Loire;41;1;15;295;Vineuil;7815;206;8021
24;Centre-Val de Loire;41;3;13;296;Vouzon;1483;35;1518
24;Centre-Val de Loire;41;3;13;297;Yvoy-le-Marron;728;8;736
84;Auvergne-Rhône-Alpes;42;1;20;001;Aboën;439;7;446
84;Auvergne-Rhône-Alpes;42;1;02;002;Ailleux;164;2;166
84;Auvergne-Rhône-Alpes;42;2;09;003;Ambierle;1915;56;1971
84;Auvergne-Rhône-Alpes;42;3;01;005;Andrézieux-Bouthéon;9790;163;9953
84;Auvergne-Rhône-Alpes;42;1;20;006;Apinac;416;8;424
84;Auvergne-Rhône-Alpes;42;2;03;007;Arcinges;212;12;224
84;Auvergne-Rhône-Alpes;42;2;09;008;Arcon;108;1;109
84;Auvergne-Rhône-Alpes;42;1;02;009;Arthun;542;5;547
84;Auvergne-Rhône-Alpes;42;1;01;010;Aveizieux;1647;21;1668
84;Auvergne-Rhône-Alpes;42;2;04;011;Balbigny;2965;57;3022
84;Auvergne-Rhône-Alpes;42;1;07;012;Bard;664;23;687
84;Auvergne-Rhône-Alpes;42;1;01;013;Bellegarde-en-Forez;2004;36;2040
84;Auvergne-Rhône-Alpes;42;2;03;014;Belleroche;312;9;321
84;Auvergne-Rhône-Alpes;42;2;03;015;Belmont-de-la-Loire;1491;27;1518
84;Auvergne-Rhône-Alpes;42;2;03;016;La Bénisson-Dieu;418;10;428
84;Auvergne-Rhône-Alpes;42;3;08;017;Le Bessat;446;8;454
84;Auvergne-Rhône-Alpes;42;3;08;018;Bessey;457;10;467
84;Auvergne-Rhône-Alpes;42;1;02;019;Boën-sur-Lignon;3309;43;3352
84;Auvergne-Rhône-Alpes;42;1;01;020;Boisset-lès-Montrond;1167;20;1187
84;Auvergne-Rhône-Alpes;42;1;07;021;Boisset-Saint-Priest;1223;10;1233
84;Auvergne-Rhône-Alpes;42;1;20;022;Bonson;3889;52;3941
84;Auvergne-Rhône-Alpes;42;3;08;023;Bourg-Argental;2922;57;2979
84;Auvergne-Rhône-Alpes;42;2;03;025;Boyer;199;7;206
84;Auvergne-Rhône-Alpes;42;2;03;026;Briennon;1692;38;1730
84;Auvergne-Rhône-Alpes;42;2;02;027;Bully;408;7;415
84;Auvergne-Rhône-Alpes;42;3;08;028;Burdignes;368;9;377
84;Auvergne-Rhône-Alpes;42;2;04;029;Bussières;1545;45;1590
84;Auvergne-Rhône-Alpes;42;1;02;030;Bussy-Albieux;537;16;553
84;Auvergne-Rhône-Alpes;42;3;06;031;Caloire;316;7;323
84;Auvergne-Rhône-Alpes;42;3;21;032;Cellieu;1697;23;1720
84;Auvergne-Rhône-Alpes;42;2;03;033;Le Cergne;642;25;667
84;Auvergne-Rhône-Alpes;42;1;02;034;Cervières;120;8;128
84;Auvergne-Rhône-Alpes;42;1;02;035;Cezay;219;7;226
84;Auvergne-Rhône-Alpes;42;3;21;036;Chagnon;490;16;506
84;Auvergne-Rhône-Alpes;42;1;07;037;Chalain-d'Uzore;557;21;578
84;Auvergne-Rhône-Alpes;42;1;07;038;Chalain-le-Comtal;705;14;719
84;Auvergne-Rhône-Alpes;42;1;02;039;Chalmazel-Jeansagnière;451;4;455
84;Auvergne-Rhône-Alpes;42;1;02;040;La Chamba;50;2;52
84;Auvergne-Rhône-Alpes;42;1;05;041;Chambéon;562;5;567
84;Auvergne-Rhône-Alpes;42;1;20;042;Chambles;1000;31;1031
84;Auvergne-Rhône-Alpes;42;3;15;044;Le Chambon-Feugerolles;12317;91;12408
84;Auvergne-Rhône-Alpes;42;1;02;045;La Chambonie;42;2;44
84;Auvergne-Rhône-Alpes;42;1;01;043;Chambœuf;1711;35;1746
84;Auvergne-Rhône-Alpes;42;1;02;046;Champdieu;1919;44;1963
84;Auvergne-Rhône-Alpes;42;2;09;047;Champoly;329;2;331
84;Auvergne-Rhône-Alpes;42;2;03;048;Chandon;1484;30;1514
84;Auvergne-Rhône-Alpes;42;2;09;049;Changy;637;10;647
84;Auvergne-Rhône-Alpes;42;1;07;050;La Chapelle-en-Lafaye;113;1;114
84;Auvergne-Rhône-Alpes;42;3;08;051;La Chapelle-Villars;530;14;544
84;Auvergne-Rhône-Alpes;42;2;03;052;Charlieu;3667;105;3772
84;Auvergne-Rhône-Alpes;42;3;10;053;Châteauneuf;1599;21;1620
84;Auvergne-Rhône-Alpes;42;1;02;054;Châtelneuf;335;8;343
84;Auvergne-Rhône-Alpes;42;1;05;055;Châtelus;137;8;145
84;Auvergne-Rhône-Alpes;42;2;09;339;Chausseterre;224;5;229
84;Auvergne-Rhône-Alpes;42;3;08;056;Chavanay;2885;50;2935
84;Auvergne-Rhône-Alpes;42;1;07;058;Chazelles-sur-Lavieu;272;6;278
84;Auvergne-Rhône-Alpes;42;1;05;059;Chazelles-sur-Lyon;5357;97;5454
84;Auvergne-Rhône-Alpes;42;1;07;060;Chenereilles;523;6;529
84;Auvergne-Rhône-Alpes;42;2;09;061;Cherier;559;16;575
84;Auvergne-Rhône-Alpes;42;1;05;062;Chevrières;1128;25;1153
84;Auvergne-Rhône-Alpes;42;2;04;063;Chirassimont;400;5;405
84;Auvergne-Rhône-Alpes;42;3;08;064;Chuyer;775;10;785
84;Auvergne-Rhône-Alpes;42;1;05;065;Civens;1359;51;1410
84;Auvergne-Rhône-Alpes;42;1;05;066;Cleppé;529;13;542
84;Auvergne-Rhône-Alpes;42;3;08;067;Colombier;305;2;307
84;Auvergne-Rhône-Alpes;42;2;03;068;Combre;439;5;444
84;Auvergne-Rhône-Alpes;42;2;04;069;Commelle-Vernay;2955;91;3046
84;Auvergne-Rhône-Alpes;42;2;04;070;Cordelle;916;21;937
84;Auvergne-Rhône-Alpes;42;1;02;072;La Côte-en-Couzan;68;0;68
84;Auvergne-Rhône-Alpes;42;2;04;071;Le Coteau;6872;181;7053
84;Auvergne-Rhône-Alpes;42;1;05;073;Cottance;719;9;728
84;Auvergne-Rhône-Alpes;42;2;03;074;Coutouvre;1101;27;1128
84;Auvergne-Rhône-Alpes;42;1;01;075;Craintilleux;1328;14;1342
84;Auvergne-Rhône-Alpes;42;2;09;076;Cremeaux;904;22;926
84;Auvergne-Rhône-Alpes;42;2;04;077;Croizet-sur-Gand;314;6;320
84;Auvergne-Rhône-Alpes;42;2;09;078;Le Crozet;272;12;284
84;Auvergne-Rhône-Alpes;42;2;03;079;Cuinzier;728;13;741
84;Auvergne-Rhône-Alpes;42;1;01;081;Cuzieu;1525;20;1545
84;Auvergne-Rhône-Alpes;42;3;10;083;Dargoire;521;4;525
84;Auvergne-Rhône-Alpes;42;1;02;084;Débats-Rivière-d'Orpra;156;2;158
84;Auvergne-Rhône-Alpes;42;3;08;085;Doizieux;831;16;847
84;Auvergne-Rhône-Alpes;42;2;03;086;Écoche;537;13;550
84;Auvergne-Rhône-Alpes;42;1;07;087;Écotay-l'Olme;1212;50;1262
84;Auvergne-Rhône-Alpes;42;1;05;088;Épercieux-Saint-Paul;738;18;756
84;Auvergne-Rhône-Alpes;42;1;02;089;Essertines-en-Châtelneuf;696;17;713
84;Auvergne-Rhône-Alpes;42;1;05;090;Essertines-en-Donzy;490;12;502
84;Auvergne-Rhône-Alpes;42;1;20;091;Estivareilles;686;12;698
84;Auvergne-Rhône-Alpes;42;3;21;092;L' Étrat;2531;84;2615
84;Auvergne-Rhône-Alpes;42;3;10;093;Farnay;1408;29;1437
84;Auvergne-Rhône-Alpes;42;1;05;094;Feurs;8173;191;8364
84;Auvergne-Rhône-Alpes;42;3;06;095;Firminy;17135;254;17389
84;Auvergne-Rhône-Alpes;42;3;21;096;Fontanès;678;13;691
84;Auvergne-Rhône-Alpes;42;3;21;097;La Fouillouse;4501;63;4564
84;Auvergne-Rhône-Alpes;42;2;04;098;Fourneaux;588;17;605
84;Auvergne-Rhône-Alpes;42;3;06;099;Fraisses;3723;52;3775
84;Auvergne-Rhône-Alpes;42;3;10;225;Genilac;3896;75;3971
84;Auvergne-Rhône-Alpes;42;1;05;100;La Gimond;277;6;283
84;Auvergne-Rhône-Alpes;42;3;08;101;Graix;146;1;147
84;Auvergne-Rhône-Alpes;42;1;05;102;Grammond;906;21;927
84;Auvergne-Rhône-Alpes;42;3;10;103;La Grand-Croix;5136;40;5176
84;Auvergne-Rhône-Alpes;42;2;03;104;La Gresle;842;20;862
84;Auvergne-Rhône-Alpes;42;1;07;105;Grézieux-le-Fromental;233;2;235
84;Auvergne-Rhône-Alpes;42;2;02;106;Grézolles;267;8;275
84;Auvergne-Rhône-Alpes;42;1;07;107;Gumières;322;10;332
84;Auvergne-Rhône-Alpes;42;1;07;108;L' Hôpital-le-Grand;1054;24;1078
84;Auvergne-Rhône-Alpes;42;1;02;109;L' Hôpital-sous-Rochefort;110;1;111
84;Auvergne-Rhône-Alpes;42;3;13;110;L' Horme;4790;42;4832
84;Auvergne-Rhône-Alpes;42;2;03;112;Jarnosse;435;8;443
84;Auvergne-Rhône-Alpes;42;1;05;113;Jas;222;13;235
84;Auvergne-Rhône-Alpes;42;3;08;115;Jonzieux;1170;15;1185
84;Auvergne-Rhône-Alpes;42;2;09;116;Juré;242;7;249
84;Auvergne-Rhône-Alpes;42;1;07;117;Lavieu;116;8;124
84;Auvergne-Rhône-Alpes;42;2;04;118;Lay;745;20;765
84;Auvergne-Rhône-Alpes;42;1;02;119;Leigneux;377;8;385
84;Auvergne-Rhône-Alpes;42;2;09;120;Lentigny;1736;51;1787
84;Auvergne-Rhône-Alpes;42;1;07;121;Lérigneux;143;2;145
84;Auvergne-Rhône-Alpes;42;1;07;122;Lézigneux;1695;61;1756
84;Auvergne-Rhône-Alpes;42;3;10;123;Lorette;4700;32;4732
84;Auvergne-Rhône-Alpes;42;3;08;124;Lupé;307;7;314
84;Auvergne-Rhône-Alpes;42;2;02;125;Luré;142;2;144
84;Auvergne-Rhône-Alpes;42;1;07;126;Luriecq;1311;17;1328
84;Auvergne-Rhône-Alpes;42;2;11;127;Mably;7605;119;7724
84;Auvergne-Rhône-Alpes;42;2;04;128;Machézal;382;5;387
84;Auvergne-Rhône-Alpes;42;3;08;129;Maclas;1804;52;1856
84;Auvergne-Rhône-Alpes;42;1;07;130;Magneux-Haute-Rive;578;8;586
84;Auvergne-Rhône-Alpes;42;2;03;131;Maizilly;337;3;340
84;Auvergne-Rhône-Alpes;42;3;08;132;Malleval;578;16;594
84;Auvergne-Rhône-Alpes;42;3;21;133;Marcenod;710;19;729
84;Auvergne-Rhône-Alpes;42;1;02;134;Marcilly-le-Châtel;1390;45;1435
84;Auvergne-Rhône-Alpes;42;1;05;135;Marclopt;503;17;520
84;Auvergne-Rhône-Alpes;42;1;02;136;Marcoux;735;23;758
84;Auvergne-Rhône-Alpes;42;1;07;137;Margerie-Chantagret;805;15;820
84;Auvergne-Rhône-Alpes;42;1;05;138;Maringes;666;12;678
84;Auvergne-Rhône-Alpes;42;3;08;139;Marlhes;1292;76;1368
84;Auvergne-Rhône-Alpes;42;1;07;140;Marols;416;4;420
84;Auvergne-Rhône-Alpes;42;2;03;141;Mars;560;12;572
84;Auvergne-Rhône-Alpes;42;1;20;142;Merle-Leignec;320;4;324
84;Auvergne-Rhône-Alpes;42;1;05;143;Mizérieux;453;4;457
84;Auvergne-Rhône-Alpes;42;2;03;145;Montagny;1049;22;1071
84;Auvergne-Rhône-Alpes;42;1;07;146;Montarcher;67;3;70
84;Auvergne-Rhône-Alpes;42;1;07;147;Montbrison;15641;602;16243
84;Auvergne-Rhône-Alpes;42;1;05;148;Montchal;492;10;502
84;Auvergne-Rhône-Alpes;42;1;01;149;Montrond-les-Bains;5302;80;5382
84;Auvergne-Rhône-Alpes;42;1;02;150;Montverdun;1381;28;1409
84;Auvergne-Rhône-Alpes;42;1;07;151;Mornand-en-Forez;407;79;486
84;Auvergne-Rhône-Alpes;42;2;03;152;Nandax;521;297;818
84;Auvergne-Rhône-Alpes;42;2;04;153;Neaux;480;12;492
84;Auvergne-Rhône-Alpes;42;2;04;154;Néronde;457;51;508
84;Auvergne-Rhône-Alpes;42;1;05;155;Nervieux;993;15;1008
84;Auvergne-Rhône-Alpes;42;2;04;156;Neulise;1366;17;1383
84;Auvergne-Rhône-Alpes;42;2;09;157;Noailly;802;14;816
84;Auvergne-Rhône-Alpes;42;2;09;158;Les Noës;208;4;212
84;Auvergne-Rhône-Alpes;42;1;02;159;Noirétable;1588;105;1693
84;Auvergne-Rhône-Alpes;42;2;02;160;Nollieux;197;6;203
84;Auvergne-Rhône-Alpes;42;2;04;161;Notre-Dame-de-Boisset;566;15;581
84;Auvergne-Rhône-Alpes;42;2;09;162;Ouches;1158;20;1178
84;Auvergne-Rhône-Alpes;42;2;09;163;La Pacaudière;1057;20;1077
84;Auvergne-Rhône-Alpes;42;1;02;164;Palogneux;78;1;79
84;Auvergne-Rhône-Alpes;42;1;05;165;Panissières;2929;87;3016
84;Auvergne-Rhône-Alpes;42;2;04;166;Parigny;609;16;625
84;Auvergne-Rhône-Alpes;42;3;08;167;Pavezin;354;3;357
84;Auvergne-Rhône-Alpes;42;3;08;168;Pélussin;3765;103;3868
84;Auvergne-Rhône-Alpes;42;1;20;169;Périgneux;1512;26;1538
84;Auvergne-Rhône-Alpes;42;2;04;170;Perreux;2114;179;2293
84;Auvergne-Rhône-Alpes;42;2;04;171;Pinay;284;7;291
84;Auvergne-Rhône-Alpes;42;3;08;172;Planfoy;1039;24;1063
84;Auvergne-Rhône-Alpes;42;2;02;173;Pommiers;359;11;370
84;Auvergne-Rhône-Alpes;42;1;05;174;Poncins;1097;25;1122
84;Auvergne-Rhône-Alpes;42;1;05;175;Pouilly-lès-Feurs;1239;35;1274
84;Auvergne-Rhône-Alpes;42;2;09;176;Pouilly-les-Nonains;2123;45;2168
84;Auvergne-Rhône-Alpes;42;2;03;177;Pouilly-sous-Charlieu;2471;45;2516
84;Auvergne-Rhône-Alpes;42;2;03;178;Pradines;803;10;813
84;Auvergne-Rhône-Alpes;42;1;02;179;Pralong;847;21;868
84;Auvergne-Rhône-Alpes;42;1;07;180;Précieux;1031;105;1136
84;Auvergne-Rhône-Alpes;42;2;03;181;Régny;1525;30;1555
84;Auvergne-Rhône-Alpes;42;2;09;182;Renaison;3143;106;3249
84;Auvergne-Rhône-Alpes;42;3;15;183;La Ricamarie;7906;49;7955
84;Auvergne-Rhône-Alpes;42;2;12;184;Riorges;10774;296;11070
84;Auvergne-Rhône-Alpes;42;1;01;185;Rivas;663;6;669
84;Auvergne-Rhône-Alpes;42;3;10;186;Rive-de-Gier;15184;115;15299
84;Auvergne-Rhône-Alpes;42;2;98;187;Roanne;34366;693;35059
84;Auvergne-Rhône-Alpes;42;1;07;188;Roche;254;4;258
84;Auvergne-Rhône-Alpes;42;3;16;189;Roche-la-Molière;9697;98;9795
84;Auvergne-Rhône-Alpes;42;3;08;191;Roisey;936;31;967
84;Auvergne-Rhône-Alpes;42;1;20;192;Rozier-Côtes-d'Aurec;447;7;454
84;Auvergne-Rhône-Alpes;42;1;05;193;Rozier-en-Donzy;1444;38;1482
84;Auvergne-Rhône-Alpes;42;2;09;194;Sail-les-Bains;200;6;206
84;Auvergne-Rhône-Alpes;42;1;02;195;Sail-sous-Couzan;941;7;948
84;Auvergne-Rhône-Alpes;42;2;09;198;Saint-Alban-les-Eaux;969;29;998
84;Auvergne-Rhône-Alpes;42;2;09;199;Saint-André-d'Apchon;1946;66;2012
84;Auvergne-Rhône-Alpes;42;1;01;200;Saint-André-le-Puy;1539;25;1564
84;Auvergne-Rhône-Alpes;42;3;08;201;Saint-Appolinard;678;9;687
84;Auvergne-Rhône-Alpes;42;1;05;202;Saint-Barthélemy-Lestra;684;15;699
84;Auvergne-Rhône-Alpes;42;2;09;203;Saint-Bonnet-des-Quarts;318;12;330
84;Auvergne-Rhône-Alpes;42;1;20;204;Saint-Bonnet-le-Château;1527;48;1575
84;Auvergne-Rhône-Alpes;42;1;02;205;Saint-Bonnet-le-Courreau;687;14;701
84;Auvergne-Rhône-Alpes;42;1;01;206;Saint-Bonnet-les-Oules;1638;40;1678
84;Auvergne-Rhône-Alpes;42;3;13;207;Saint-Chamond;34967;557;35524
84;Auvergne-Rhône-Alpes;42;3;21;208;Saint-Christo-en-Jarez;1891;28;1919
84;Auvergne-Rhône-Alpes;42;1;20;211;Saint-Cyprien;2485;30;2515
84;Auvergne-Rhône-Alpes;42;2;04;212;Saint-Cyr-de-Favières;917;27;944
84;Auvergne-Rhône-Alpes;42;2;04;213;Saint-Cyr-de-Valorges;304;12;316
84;Auvergne-Rhône-Alpes;42;1;05;214;Saint-Cyr-les-Vignes;1042;29;1071
84;Auvergne-Rhône-Alpes;42;2;03;215;Saint-Denis-de-Cabanne;1251;27;1278
84;Auvergne-Rhône-Alpes;42;1;05;216;Saint-Denis-sur-Coise;657;18;675
84;Auvergne-Rhône-Alpes;42;1;02;217;Saint-Didier-sur-Rochefort;417;7;424
84;Auvergne-Rhône-Alpes;42;3;99;218;Saint-Étienne;172565;1955;174520
84;Auvergne-Rhône-Alpes;42;1;02;219;Saint-Étienne-le-Molard;1019;23;1042
84;Auvergne-Rhône-Alpes;42;2;09;220;Saint-Forgeux-Lespinasse;646;13;659
84;Auvergne-Rhône-Alpes;42;1;01;222;Saint-Galmier;5722;142;5864
84;Auvergne-Rhône-Alpes;42;3;16;223;Saint-Genest-Lerpt;6131;70;6201
84;Auvergne-Rhône-Alpes;42;3;08;224;Saint-Genest-Malifaux;2861;143;3004
84;Auvergne-Rhône-Alpes;42;2;02;226;Saint-Georges-de-Baroille;419;3;422
84;Auvergne-Rhône-Alpes;42;1;02;227;Saint-Georges-en-Couzan;420;10;430
84;Auvergne-Rhône-Alpes;42;1;07;228;Saint-Georges-Haute-Ville;1440;25;1465
84;Auvergne-Rhône-Alpes;42;2;03;229;Saint-Germain-la-Montagne;240;7;247
84;Auvergne-Rhône-Alpes;42;2;02;230;Saint-Germain-Laval;1635;30;1665
84;Auvergne-Rhône-Alpes;42;2;09;231;Saint-Germain-Lespinasse;1251;85;1336
84;Auvergne-Rhône-Alpes;42;2;09;232;Saint-Haon-le-Châtel;638;12;650
84;Auvergne-Rhône-Alpes;42;2;09;233;Saint-Haon-le-Vieux;958;26;984
84;Auvergne-Rhône-Alpes;42;3;21;234;Saint-Héand;3592;70;3662
84;Auvergne-Rhône-Alpes;42;1;20;235;Saint-Hilaire-Cusson-la-Valmitte;335;5;340
84;Auvergne-Rhône-Alpes;42;2;03;236;Saint-Hilaire-sous-Charlieu;535;10;545
84;Auvergne-Rhône-Alpes;42;3;18;237;Saint-Jean-Bonnefonds;6638;69;6707
84;Auvergne-Rhône-Alpes;42;1;02;238;Saint-Jean-la-Vêtre;316;11;327
84;Auvergne-Rhône-Alpes;42;2;09;239;Saint-Jean-Saint-Maurice-sur-Loire;1148;28;1176
84;Auvergne-Rhône-Alpes;42;1;07;240;Saint-Jean-Soleymieux;860;12;872
84;Auvergne-Rhône-Alpes;42;2;04;241;Saint-Jodard;414;5;419
84;Auvergne-Rhône-Alpes;42;3;10;242;Saint-Joseph;1901;30;1931
84;Auvergne-Rhône-Alpes;42;2;02;243;Saint-Julien-d'Oddes;272;13;285
84;Auvergne-Rhône-Alpes;42;3;08;246;Saint-Julien-Molin-Molette;1147;27;1174
84;Auvergne-Rhône-Alpes;42;1;02;247;Saint-Just-en-Bas;289;8;297
84;Auvergne-Rhône-Alpes;42;2;09;248;Saint-Just-en-Chevalet;1141;42;1183
84;Auvergne-Rhône-Alpes;42;2;04;249;Saint-Just-la-Pendue;1642;35;1677
84;Auvergne-Rhône-Alpes;42;1;20;279;Saint-Just-Saint-Rambert;15083;270;15353
84;Auvergne-Rhône-Alpes;42;1;05;251;Saint-Laurent-la-Conche;608;13;621
84;Auvergne-Rhône-Alpes;42;1;02;252;Saint-Laurent-Rochefort;246;3;249
84;Auvergne-Rhône-Alpes;42;2;12;253;Saint-Léger-sur-Roanne;1145;42;1187
84;Auvergne-Rhône-Alpes;42;2;09;255;Saint-Marcel-d'Urfé;290;7;297
84;Auvergne-Rhône-Alpes;42;2;04;254;Saint-Marcel-de-Félines;809;17;826
84;Auvergne-Rhône-Alpes;42;1;20;256;Saint-Marcellin-en-Forez;4848;50;4898
84;Auvergne-Rhône-Alpes;42;2;09;257;Saint-Martin-d'Estréaux;839;16;855
84;Auvergne-Rhône-Alpes;42;3;10;259;Saint-Martin-la-Plaine;3755;74;3829
84;Auvergne-Rhône-Alpes;42;2;02;260;Saint-Martin-la-Sauveté;955;62;1017
84;Auvergne-Rhône-Alpes;42;1;05;261;Saint-Martin-Lestra;895;20;915
84;Auvergne-Rhône-Alpes;42;1;20;262;Saint-Maurice-en-Gourgois;1813;21;1834
84;Auvergne-Rhône-Alpes;42;1;05;264;Saint-Médard-en-Forez;1040;25;1065
84;Auvergne-Rhône-Alpes;42;3;08;265;Saint-Michel-sur-Rhône;826;25;851
84;Auvergne-Rhône-Alpes;42;1;20;266;Saint-Nizier-de-Fornas;666;12;678
84;Auvergne-Rhône-Alpes;42;2;03;267;Saint-Nizier-sous-Charlieu;1702;45;1747
84;Auvergne-Rhône-Alpes;42;1;07;269;Saint-Paul-d'Uzore;170;11;181
84;Auvergne-Rhône-Alpes;42;3;06;270;Saint-Paul-en-Cornillon;1364;27;1391
84;Auvergne-Rhône-Alpes;42;3;10;271;Saint-Paul-en-Jarez;4844;60;4904
84;Auvergne-Rhône-Alpes;42;3;08;272;Saint-Pierre-de-Bœuf;1726;39;1765
84;Auvergne-Rhône-Alpes;42;2;03;273;Saint-Pierre-la-Noaille;383;8;391
84;Auvergne-Rhône-Alpes;42;2;02;274;Saint-Polgues;259;8;267
84;Auvergne-Rhône-Alpes;42;3;18;275;Saint-Priest-en-Jarez;6120;93;6213
84;Auvergne-Rhône-Alpes;42;2;09;276;Saint-Priest-la-Prugne;433;5;438
84;Auvergne-Rhône-Alpes;42;2;04;277;Saint-Priest-la-Roche;350;1;351
84;Auvergne-Rhône-Alpes;42;1;02;278;Saint-Priest-la-Vêtre;148;1;149
84;Auvergne-Rhône-Alpes;42;3;08;280;Saint-Régis-du-Coin;387;8;395
84;Auvergne-Rhône-Alpes;42;2;09;281;Saint-Rirand;140;2;142
84;Auvergne-Rhône-Alpes;42;2;09;282;Saint-Romain-d'Urfé;260;5;265
84;Auvergne-Rhône-Alpes;42;3;21;283;Saint-Romain-en-Jarez;1226;13;1239
84;Auvergne-Rhône-Alpes;42;2;09;284;Saint-Romain-la-Motte;1434;62;1496
84;Auvergne-Rhône-Alpes;42;1;07;285;Saint-Romain-le-Puy;3998;60;4058
84;Auvergne-Rhône-Alpes;42;3;08;286;Saint-Romain-les-Atheux;960;15;975
84;Auvergne-Rhône-Alpes;42;3;08;287;Saint-Sauveur-en-Rue;1095;22;1117
84;Auvergne-Rhône-Alpes;42;1;02;288;Saint-Sixte;710;12;722
84;Auvergne-Rhône-Alpes;42;2;04;289;Saint-Symphorien-de-Lay;1887;36;1923
84;Auvergne-Rhône-Alpes;42;1;07;290;Saint-Thomas-la-Garde;595;22;617
84;Auvergne-Rhône-Alpes;42;2;03;293;Saint-Victor-sur-Rhins;1181;20;1201
84;Auvergne-Rhône-Alpes;42;2;04;294;Saint-Vincent-de-Boisset;966;28;994
84;Auvergne-Rhône-Alpes;42;2;04;196;Sainte-Agathe-en-Donzy;129;1;130
84;Auvergne-Rhône-Alpes;42;1;02;197;Sainte-Agathe-la-Bouteresse;1023;31;1054
84;Auvergne-Rhône-Alpes;42;2;04;209;Sainte-Colombe-sur-Gand;408;11;419
84;Auvergne-Rhône-Alpes;42;3;08;210;Sainte-Croix-en-Jarez;478;7;485
84;Auvergne-Rhône-Alpes;42;1;02;221;Sainte-Foy-Saint-Sulpice;512;13;525
84;Auvergne-Rhône-Alpes;42;1;02;295;Les Salles;541;7;548
84;Auvergne-Rhône-Alpes;42;1;05;296;Salt-en-Donzy;544;17;561
84;Auvergne-Rhône-Alpes;42;1;05;297;Salvizinet;589;19;608
84;Auvergne-Rhône-Alpes;42;1;02;298;Sauvain;380;5;385
84;Auvergne-Rhône-Alpes;42;1;07;299;Savigneux;3432;75;3507
84;Auvergne-Rhône-Alpes;42;2;03;300;Sevelinges;647;12;659
84;Auvergne-Rhône-Alpes;42;1;07;301;Soleymieux;654;15;669
84;Auvergne-Rhône-Alpes;42;3;21;302;Sorbiers;7933;170;8103
84;Auvergne-Rhône-Alpes;42;2;02;303;Souternon;288;7;295
84;Auvergne-Rhône-Alpes;42;1;20;304;Sury-le-Comtal;6552;270;6822
84;Auvergne-Rhône-Alpes;42;3;21;305;La Talaudière;6860;96;6956
84;Auvergne-Rhône-Alpes;42;3;08;306;Tarentaise;475;6;481
84;Auvergne-Rhône-Alpes;42;3;10;307;Tartaras;854;54;908
84;Auvergne-Rhône-Alpes;42;3;08;308;La Terrasse-sur-Dorlay;785;11;796
84;Auvergne-Rhône-Alpes;42;3;08;310;Thélis-la-Combe;158;5;163
84;Auvergne-Rhône-Alpes;42;3;21;311;La Tour-en-Jarez;1479;37;1516
84;Auvergne-Rhône-Alpes;42;1;20;312;La Tourette;584;16;600
84;Auvergne-Rhône-Alpes;42;1;02;313;Trelins;654;7;661
84;Auvergne-Rhône-Alpes;42;2;09;314;La Tuilière;289;8;297
84;Auvergne-Rhône-Alpes;42;1;01;315;Unias;433;15;448
84;Auvergne-Rhône-Alpes;42;3;06;316;Unieux;8597;86;8683
84;Auvergne-Rhône-Alpes;42;2;09;317;Urbise;130;6;136
84;Auvergne-Rhône-Alpes;42;1;20;318;Usson-en-Forez;1482;25;1507
84;Auvergne-Rhône-Alpes;42;1;05;319;Valeille;737;8;745
84;Auvergne-Rhône-Alpes;42;3;21;320;Valfleury;708;17;725
84;Auvergne-Rhône-Alpes;42;3;08;322;La Valla-en-Gier;1042;30;1072
84;Auvergne-Rhône-Alpes;42;1;02;321;La Valla-sur-Rochefort;104;1;105
84;Auvergne-Rhône-Alpes;42;1;01;323;Veauche;8984;104;9088
84;Auvergne-Rhône-Alpes;42;1;01;324;Veauchette;1180;17;1197
84;Auvergne-Rhône-Alpes;42;2;04;325;Vendranges;371;5;376
84;Auvergne-Rhône-Alpes;42;3;08;326;Véranne;835;27;862
84;Auvergne-Rhône-Alpes;42;3;08;327;Vérin;669;14;683
84;Auvergne-Rhône-Alpes;42;1;07;328;Verrières-en-Forez;705;73;778
84;Auvergne-Rhône-Alpes;42;3;08;329;La Versanne;373;5;378
84;Auvergne-Rhône-Alpes;42;1;02;245;Vêtre-sur-Anzon;550;5;555
84;Auvergne-Rhône-Alpes;42;2;02;268;Vézelin-sur-Loire;789;9;798
84;Auvergne-Rhône-Alpes;42;3;17;330;Villars;7970;158;8128
84;Auvergne-Rhône-Alpes;42;2;09;331;Villemontais;1017;33;1050
84;Auvergne-Rhône-Alpes;42;2;12;332;Villerest;4902;139;5041
84;Auvergne-Rhône-Alpes;42;2;03;333;Villers;585;11;596
84;Auvergne-Rhône-Alpes;42;2;04;334;Violay;1239;17;1256
84;Auvergne-Rhône-Alpes;42;1;05;335;Viricelles;457;21;478
84;Auvergne-Rhône-Alpes;42;1;05;336;Virigneux;631;19;650
84;Auvergne-Rhône-Alpes;42;2;09;337;Vivans;230;5;235
84;Auvergne-Rhône-Alpes;42;2;03;338;Vougy;1466;64;1530
84;Auvergne-Rhône-Alpes;43;1;17;001;Agnat;187;4;191
84;Auvergne-Rhône-Alpes;43;2;13;002;Aiguilhe;1511;64;1575
84;Auvergne-Rhône-Alpes;43;2;11;003;Allègre;907;18;925
84;Auvergne-Rhône-Alpes;43;2;08;004;Alleyrac;117;7;124
84;Auvergne-Rhône-Alpes;43;2;18;005;Alleyras;161;4;165
84;Auvergne-Rhône-Alpes;43;1;10;006;Ally;139;1;140
84;Auvergne-Rhône-Alpes;43;3;19;007;Araules;597;17;614
84;Auvergne-Rhône-Alpes;43;2;18;008;Arlempdes;138;6;144
84;Auvergne-Rhône-Alpes;43;1;10;009;Arlet;24;0;24
84;Auvergne-Rhône-Alpes;43;2;15;010;Arsac-en-Velay;1208;29;1237
84;Auvergne-Rhône-Alpes;43;1;10;011;Aubazat;178;5;183
84;Auvergne-Rhône-Alpes;43;3;01;012;Aurec-sur-Loire;6111;83;6194
84;Auvergne-Rhône-Alpes;43;1;17;014;Autrac;63;2;65
84;Auvergne-Rhône-Alpes;43;1;07;015;Auvers;54;0;54
84;Auvergne-Rhône-Alpes;43;1;17;016;Auzon;896;19;915
84;Auvergne-Rhône-Alpes;43;1;17;017;Azérat;273;6;279
84;Auvergne-Rhône-Alpes;43;2;18;018;Bains;1353;40;1393
84;Auvergne-Rhône-Alpes;43;2;18;019;Barges;96;2;98
84;Auvergne-Rhône-Alpes;43;3;02;020;Bas-en-Basset;4348;84;4432
84;Auvergne-Rhône-Alpes;43;2;06;021;Beaulieu;1029;20;1049
84;Auvergne-Rhône-Alpes;43;1;04;022;Beaumont;286;12;298
84;Auvergne-Rhône-Alpes;43;2;11;023;Beaune-sur-Arzon;221;3;224
84;Auvergne-Rhône-Alpes;43;3;19;024;Beaux;845;13;858
84;Auvergne-Rhône-Alpes;43;3;02;025;Beauzac;2936;65;3001
84;Auvergne-Rhône-Alpes;43;2;16;026;Bellevue-la-Montagne;419;14;433
84;Auvergne-Rhône-Alpes;43;1;11;027;Berbezit;47;0;47
84;Auvergne-Rhône-Alpes;43;3;19;028;Bessamorel;458;15;473
84;Auvergne-Rhône-Alpes;43;1;07;029;La Besseyre-Saint-Mary;100;0;100
84;Auvergne-Rhône-Alpes;43;2;16;030;Blanzac;402;10;412
84;Auvergne-Rhône-Alpes;43;1;10;031;Blassac;136;5;141
84;Auvergne-Rhône-Alpes;43;2;14;032;Blavozy;1656;31;1687
84;Auvergne-Rhône-Alpes;43;1;17;033;Blesle;637;8;645
84;Auvergne-Rhône-Alpes;43;3;02;034;Boisset;345;1;346
84;Auvergne-Rhône-Alpes;43;1;11;035;Bonneval;70;3;73
84;Auvergne-Rhône-Alpes;43;2;16;036;Borne;413;6;419
84;Auvergne-Rhône-Alpes;43;2;18;037;Le Bouchet-Saint-Nicolas;280;6;286
84;Auvergne-Rhône-Alpes;43;1;04;038;Bournoncle-Saint-Pierre;991;22;1013
84;Auvergne-Rhône-Alpes;43;2;18;039;Le Brignon;601;14;615
84;Auvergne-Rhône-Alpes;43;1;04;040;Brioude;6721;360;7081
84;Auvergne-Rhône-Alpes;43;2;14;041;Brives-Charensac;4085;235;4320
84;Auvergne-Rhône-Alpes;43;2;18;042;Cayres;729;8;737
84;Auvergne-Rhône-Alpes;43;2;16;043;Céaux-d'Allègre;474;8;482
84;Auvergne-Rhône-Alpes;43;1;10;044;Cerzat;209;4;213
84;Auvergne-Rhône-Alpes;43;2;12;045;Ceyssac;416;19;435
84;Auvergne-Rhône-Alpes;43;2;13;046;Chadrac;2516;70;2586
84;Auvergne-Rhône-Alpes;43;2;08;047;Chadron;292;8;300
84;Auvergne-Rhône-Alpes;43;1;11;048;La Chaise-Dieu;620;36;656
84;Auvergne-Rhône-Alpes;43;2;06;049;Chamalières-sur-Loire;491;9;500
84;Auvergne-Rhône-Alpes;43;1;17;050;Chambezon;116;0;116
84;Auvergne-Rhône-Alpes;43;3;08;051;Le Chambon-sur-Lignon;2470;57;2527
84;Auvergne-Rhône-Alpes;43;1;17;052;Champagnac-le-Vieux;206;8;214
84;Auvergne-Rhône-Alpes;43;2;08;053;Champclause;201;5;206
84;Auvergne-Rhône-Alpes;43;1;07;054;Chanaleilles;181;9;190
84;Auvergne-Rhône-Alpes;43;1;04;055;Chaniat;172;6;178
84;Auvergne-Rhône-Alpes;43;1;07;056;Chanteuges;441;13;454
84;Auvergne-Rhône-Alpes;43;2;11;057;La Chapelle-Bertin;48;3;51
84;Auvergne-Rhône-Alpes;43;3;09;058;La Chapelle-d'Aurec;1019;14;1033
84;Auvergne-Rhône-Alpes;43;1;11;059;La Chapelle-Geneste;110;1;111
84;Auvergne-Rhône-Alpes;43;1;07;060;Charraix;71;4;75
84;Auvergne-Rhône-Alpes;43;2;13;061;Chaspinhac;845;23;868
84;Auvergne-Rhône-Alpes;43;2;16;062;Chaspuzac;778;15;793
84;Auvergne-Rhône-Alpes;43;1;10;063;Chassagnes;157;2;159
84;Auvergne-Rhône-Alpes;43;1;17;064;Chassignolles;62;1;63
84;Auvergne-Rhône-Alpes;43;1;10;065;Chastel;129;4;133
84;Auvergne-Rhône-Alpes;43;2;08;066;Chaudeyrolles;107;4;111
84;Auvergne-Rhône-Alpes;43;1;10;067;Chavaniac-Lafayette;275;9;284
84;Auvergne-Rhône-Alpes;43;1;07;068;Chazelles;35;2;37
84;Auvergne-Rhône-Alpes;43;3;03;069;Chenereilles;325;7;332
84;Auvergne-Rhône-Alpes;43;1;10;070;Chilhac;181;2;183
84;Auvergne-Rhône-Alpes;43;2;11;071;Chomelix;475;7;482
84;Auvergne-Rhône-Alpes;43;1;10;072;La Chomette;154;6;160
84;Auvergne-Rhône-Alpes;43;1;11;073;Cistrières;140;2;142
84;Auvergne-Rhône-Alpes;43;1;04;074;Cohade;863;25;888
84;Auvergne-Rhône-Alpes;43;1;10;075;Collat;78;3;81
84;Auvergne-Rhône-Alpes;43;1;11;076;Connangles;146;1;147
84;Auvergne-Rhône-Alpes;43;2;18;077;Costaros;544;16;560
84;Auvergne-Rhône-Alpes;43;2;15;078;Coubon;3243;88;3331
84;Auvergne-Rhône-Alpes;43;1;10;079;Couteuges;301;11;312
84;Auvergne-Rhône-Alpes;43;2;11;080;Craponne-sur-Arzon;1982;41;2023
84;Auvergne-Rhône-Alpes;43;1;10;082;Cronce;75;1;76
84;Auvergne-Rhône-Alpes;43;1;07;083;Cubelles;152;2;154
84;Auvergne-Rhône-Alpes;43;2;18;084;Cussac-sur-Loire;1710;34;1744
84;Auvergne-Rhône-Alpes;43;1;07;085;Desges;59;1;60
84;Auvergne-Rhône-Alpes;43;1;10;086;Domeyrat;194;4;198
84;Auvergne-Rhône-Alpes;43;3;03;087;Dunières;2787;68;2855
84;Auvergne-Rhône-Alpes;43;1;17;088;Espalem;304;7;311
84;Auvergne-Rhône-Alpes;43;2;12;089;Espaly-Saint-Marcel;3513;175;3688
84;Auvergne-Rhône-Alpes;43;1;07;090;Esplantas-Vazeilles;126;4;130
84;Auvergne-Rhône-Alpes;43;2;08;091;Les Estables;333;11;344
84;Auvergne-Rhône-Alpes;43;2;08;092;Fay-sur-Lignon;363;8;371
84;Auvergne-Rhône-Alpes;43;1;11;093;Félines;318;7;325
84;Auvergne-Rhône-Alpes;43;1;10;094;Ferrussac;81;2;83
84;Auvergne-Rhône-Alpes;43;2;16;095;Fix-Saint-Geneys;123;6;129
84;Auvergne-Rhône-Alpes;43;1;04;096;Fontannes;952;228;1180
84;Auvergne-Rhône-Alpes;43;2;08;097;Freycenet-la-Cuche;106;1;107
84;Auvergne-Rhône-Alpes;43;2;08;098;Freycenet-la-Tour;104;5;109
84;Auvergne-Rhône-Alpes;43;1;17;099;Frugerès-les-Mines;557;6;563
84;Auvergne-Rhône-Alpes;43;1;10;100;Frugières-le-Pin;159;5;164
84;Auvergne-Rhône-Alpes;43;2;08;101;Goudet;60;6;66
84;Auvergne-Rhône-Alpes;43;3;19;102;Grazac;1063;22;1085
84;Auvergne-Rhône-Alpes;43;1;17;103;Grenier-Montgon;115;2;117
84;Auvergne-Rhône-Alpes;43;1;07;104;Grèzes;198;6;204
84;Auvergne-Rhône-Alpes;43;1;10;105;Javaugues;189;9;198
84;Auvergne-Rhône-Alpes;43;1;10;106;Jax;147;4;151
84;Auvergne-Rhône-Alpes;43;1;10;107;Josat;84;1;85
84;Auvergne-Rhône-Alpes;43;2;11;108;Jullianges;442;8;450
84;Auvergne-Rhône-Alpes;43;2;18;109;Lafarre;72;3;75
84;Auvergne-Rhône-Alpes;43;1;04;110;Lamothe;859;15;874
84;Auvergne-Rhône-Alpes;43;2;18;111;Landos;891;27;918
84;Auvergne-Rhône-Alpes;43;1;07;112;Langeac;3662;80;3742
84;Auvergne-Rhône-Alpes;43;2;08;113;Lantriac;1928;54;1982
84;Auvergne-Rhône-Alpes;43;3;19;114;Lapte;1715;38;1753
84;Auvergne-Rhône-Alpes;43;2;08;115;Laussonne;1010;19;1029
84;Auvergne-Rhône-Alpes;43;1;11;116;Laval-sur-Doulon;63;2;65
84;Auvergne-Rhône-Alpes;43;1;04;117;Lavaudieu;243;7;250
84;Auvergne-Rhône-Alpes;43;1;10;118;Lavoûte-Chilhac;281;4;285
84;Auvergne-Rhône-Alpes;43;2;06;119;Lavoûte-sur-Loire;840;18;858
84;Auvergne-Rhône-Alpes;43;1;17;120;Lempdes-sur-Allagnon;1342;25;1367
84;Auvergne-Rhône-Alpes;43;1;17;121;Léotoing;234;5;239
84;Auvergne-Rhône-Alpes;43;2;16;122;Lissac;275;5;280
84;Auvergne-Rhône-Alpes;43;1;17;123;Lorlanges;374;13;387
84;Auvergne-Rhône-Alpes;43;2;16;124;Loudes;918;24;942
84;Auvergne-Rhône-Alpes;43;1;10;125;Lubilhac;85;1;86
84;Auvergne-Rhône-Alpes;43;2;06;126;Malrevers;754;15;769
84;Auvergne-Rhône-Alpes;43;3;02;127;Malvalette;835;15;850
84;Auvergne-Rhône-Alpes;43;1;11;128;Malvières;135;2;137
84;Auvergne-Rhône-Alpes;43;3;03;129;Le Mas-de-Tence;168;7;175
84;Auvergne-Rhône-Alpes;43;1;10;131;Mazerat-Aurouze;200;2;202
84;Auvergne-Rhône-Alpes;43;3;08;130;Mazet-Saint-Voy;1109;28;1137
84;Auvergne-Rhône-Alpes;43;1;10;132;Mazeyrat-d'Allier;1480;45;1525
84;Auvergne-Rhône-Alpes;43;1;10;133;Mercœur;139;0;139
84;Auvergne-Rhône-Alpes;43;2;06;134;Mézères;158;4;162
84;Auvergne-Rhône-Alpes;43;2;08;135;Le Monastier-sur-Gazeille;1789;32;1821
84;Auvergne-Rhône-Alpes;43;1;07;136;Monistrol-d'Allier;202;2;204
84;Auvergne-Rhône-Alpes;43;3;09;137;Monistrol-sur-Loire;8718;420;9138
84;Auvergne-Rhône-Alpes;43;2;11;138;Monlet;420;12;432
84;Auvergne-Rhône-Alpes;43;1;10;139;Montclard;55;0;55
84;Auvergne-Rhône-Alpes;43;2;13;140;Le Monteil;670;23;693
84;Auvergne-Rhône-Alpes;43;3;03;141;Montfaucon-en-Velay;1202;26;1228
84;Auvergne-Rhône-Alpes;43;3;03;142;Montregard;596;10;606
84;Auvergne-Rhône-Alpes;43;2;08;143;Montusclat;138;0;138
84;Auvergne-Rhône-Alpes;43;2;08;144;Moudeyres;100;3;103
84;Auvergne-Rhône-Alpes;43;2;18;145;Ouides;57;0;57
84;Auvergne-Rhône-Alpes;43;1;04;147;Paulhac;636;22;658
84;Auvergne-Rhône-Alpes;43;1;10;148;Paulhaguet;876;18;894
84;Auvergne-Rhône-Alpes;43;1;07;149;Pébrac;114;2;116
84;Auvergne-Rhône-Alpes;43;2;06;150;Le Pertuis;455;12;467
84;Auvergne-Rhône-Alpes;43;1;07;151;Pinols;192;6;198
84;Auvergne-Rhône-Alpes;43;2;13;152;Polignac;2814;85;2899
84;Auvergne-Rhône-Alpes;43;3;01;153;Pont-Salomon;2019;31;2050
84;Auvergne-Rhône-Alpes;43;2;18;154;Pradelles;549;27;576
84;Auvergne-Rhône-Alpes;43;1;07;155;Prades;64;2;66
84;Auvergne-Rhône-Alpes;43;2;08;156;Présailles;116;6;122
84;Auvergne-Rhône-Alpes;43;2;99;157;Le Puy-en-Velay;18995;949;19944
84;Auvergne-Rhône-Alpes;43;2;06;158;Queyrières;305;17;322
84;Auvergne-Rhône-Alpes;43;3;03;159;Raucoules;923;23;946
84;Auvergne-Rhône-Alpes;43;2;18;160;Rauret;195;6;201
84;Auvergne-Rhône-Alpes;43;3;02;162;Retournac;2929;59;2988
84;Auvergne-Rhône-Alpes;43;3;03;163;Riotord;1174;17;1191
84;Auvergne-Rhône-Alpes;43;2;11;164;Roche-en-Régnier;500;7;507
84;Auvergne-Rhône-Alpes;43;2;06;165;Rosières;1528;32;1560
84;Auvergne-Rhône-Alpes;43;3;02;166;Saint-André-de-Chalencon;356;15;371
84;Auvergne-Rhône-Alpes;43;1;07;167;Saint-Arcons-d'Allier;189;4;193
84;Auvergne-Rhône-Alpes;43;2;18;168;Saint-Arcons-de-Barges;121;1;122
84;Auvergne-Rhône-Alpes;43;1;10;169;Saint-Austremoine;45;0;45
84;Auvergne-Rhône-Alpes;43;1;10;170;Saint-Beauzire;415;5;420
84;Auvergne-Rhône-Alpes;43;1;07;171;Saint-Bérain;90;3;93
84;Auvergne-Rhône-Alpes;43;3;03;172;Saint-Bonnet-le-Froid;244;2;246
84;Auvergne-Rhône-Alpes;43;1;07;173;Saint-Christophe-d'Allier;91;1;92
84;Auvergne-Rhône-Alpes;43;2;18;174;Saint-Christophe-sur-Dolaison;953;12;965
84;Auvergne-Rhône-Alpes;43;1;10;175;Saint-Cirgues;163;6;169
84;Auvergne-Rhône-Alpes;43;3;05;177;Saint-Didier-en-Velay;3403;51;3454
84;Auvergne-Rhône-Alpes;43;1;10;178;Saint-Didier-sur-Doulon;195;8;203
84;Auvergne-Rhône-Alpes;43;2;18;180;Saint-Étienne-du-Vigan;100;4;104
84;Auvergne-Rhône-Alpes;43;2;06;181;Saint-Étienne-Lardeyrol;759;20;779
84;Auvergne-Rhône-Alpes;43;1;17;182;Saint-Étienne-sur-Blesle;55;1;56
84;Auvergne-Rhône-Alpes;43;3;01;184;Saint-Ferréol-d'Auroure;2464;30;2494
84;Auvergne-Rhône-Alpes;43;2;08;186;Saint-Front;403;4;407
84;Auvergne-Rhône-Alpes;43;2;16;187;Saint-Geneys-près-Saint-Paulien;317;4;321
84;Auvergne-Rhône-Alpes;43;1;10;188;Saint-Georges-d'Aurac;466;6;472
84;Auvergne-Rhône-Alpes;43;2;11;189;Saint-Georges-Lagricol;527;13;540
84;Auvergne-Rhône-Alpes;43;2;14;190;Saint-Germain-Laprade;3634;82;3716
84;Auvergne-Rhône-Alpes;43;1;04;191;Saint-Géron;258;4;262
84;Auvergne-Rhône-Alpes;43;2;18;192;Saint-Haon;300;8;308
84;Auvergne-Rhône-Alpes;43;1;17;193;Saint-Hilaire;158;2;160
84;Auvergne-Rhône-Alpes;43;2;06;194;Saint-Hostien;755;18;773
84;Auvergne-Rhône-Alpes;43;1;10;195;Saint-Ilpize;189;5;194
84;Auvergne-Rhône-Alpes;43;2;11;196;Saint-Jean-d'Aubrigoux;177;2;179
84;Auvergne-Rhône-Alpes;43;2;16;197;Saint-Jean-de-Nay;355;5;360
84;Auvergne-Rhône-Alpes;43;2;18;198;Saint-Jean-Lachalm;289;8;297
84;Auvergne-Rhône-Alpes;43;3;03;199;Saint-Jeures;964;26;990
84;Auvergne-Rhône-Alpes;43;2;06;200;Saint-Julien-Chapteuil;1920;42;1962
84;Auvergne-Rhône-Alpes;43;2;11;201;Saint-Julien-d'Ance;247;8;255
84;Auvergne-Rhône-Alpes;43;1;07;202;Saint-Julien-des-Chazes;67;1;68
84;Auvergne-Rhône-Alpes;43;3;19;203;Saint-Julien-du-Pinet;471;13;484
84;Auvergne-Rhône-Alpes;43;3;03;204;Saint-Julien-Molhesabate;176;1;177
84;Auvergne-Rhône-Alpes;43;3;01;205;Saint-Just-Malmont;4194;76;4270
84;Auvergne-Rhône-Alpes;43;1;10;206;Saint-Just-près-Brioude;426;14;440
84;Auvergne-Rhône-Alpes;43;1;04;207;Saint-Laurent-Chabreuges;257;12;269
84;Auvergne-Rhône-Alpes;43;2;08;210;Saint-Martin-de-Fugères;219;5;224
84;Auvergne-Rhône-Alpes;43;3;09;211;Saint-Maurice-de-Lignon;2597;70;2667
84;Auvergne-Rhône-Alpes;43;3;11;212;Saint-Pal-de-Chalencon;1016;16;1032
84;Auvergne-Rhône-Alpes;43;3;05;213;Saint-Pal-de-Mons;2281;54;2335
84;Auvergne-Rhône-Alpes;43;1;11;214;Saint-Pal-de-Senouire;109;2;111
84;Auvergne-Rhône-Alpes;43;2;18;215;Saint-Paul-de-Tartas;194;7;201
84;Auvergne-Rhône-Alpes;43;2;16;216;Saint-Paulien;2416;54;2470
84;Auvergne-Rhône-Alpes;43;2;11;217;Saint-Pierre-du-Champ;530;12;542
84;Auvergne-Rhône-Alpes;43;2;06;218;Saint-Pierre-Eynac;1147;28;1175
84;Auvergne-Rhône-Alpes;43;1;10;219;Saint-Préjet-Armandon;107;3;110
84;Auvergne-Rhône-Alpes;43;1;07;220;Saint-Préjet-d'Allier;165;5;170
84;Auvergne-Rhône-Alpes;43;2;16;221;Saint-Privat-d'Allier;398;12;410
84;Auvergne-Rhône-Alpes;43;1;10;222;Saint-Privat-du-Dragon;157;3;160
84;Auvergne-Rhône-Alpes;43;3;03;223;Saint-Romain-Lachalm;1093;24;1117
84;Auvergne-Rhône-Alpes;43;1;07;225;Saint-Vénérand;52;0;52
84;Auvergne-Rhône-Alpes;43;1;17;226;Saint-Vert;112;3;115
84;Auvergne-Rhône-Alpes;43;3;05;227;Saint-Victor-Malescours;818;18;836
84;Auvergne-Rhône-Alpes;43;2;11;228;Saint-Victor-sur-Arlanc;89;2;91
84;Auvergne-Rhône-Alpes;43;2;16;229;Saint-Vidal;603;9;612
84;Auvergne-Rhône-Alpes;43;2;06;230;Saint-Vincent;1012;20;1032
84;Auvergne-Rhône-Alpes;43;1;10;183;Sainte-Eugénie-de-Villeneuve;107;2;109
84;Auvergne-Rhône-Alpes;43;1;17;185;Sainte-Florine;3154;67;3221
84;Auvergne-Rhône-Alpes;43;1;10;208;Sainte-Marguerite;43;2;45
84;Auvergne-Rhône-Alpes;43;3;05;224;Sainte-Sigolène;5959;99;6058
84;Auvergne-Rhône-Alpes;43;2;08;231;Salettes;136;4;140
84;Auvergne-Rhône-Alpes;43;1;10;232;Salzuit;362;7;369
84;Auvergne-Rhône-Alpes;43;2;16;233;Sanssac-l'Église;1116;41;1157
84;Auvergne-Rhône-Alpes;43;1;07;234;Saugues;1736;127;1863
84;Auvergne-Rhône-Alpes;43;3;05;236;La Séauve-sur-Semène;1470;19;1489
84;Auvergne-Rhône-Alpes;43;1;11;237;Sembadel;229;6;235
84;Auvergne-Rhône-Alpes;43;2;18;238;Séneujols;310;7;317
84;Auvergne-Rhône-Alpes;43;1;07;239;Siaugues-Sainte-Marie;799;16;815
84;Auvergne-Rhône-Alpes;43;3;02;240;Solignac-sous-Roche;243;7;250
84;Auvergne-Rhône-Alpes;43;2;18;241;Solignac-sur-Loire;1270;32;1302
84;Auvergne-Rhône-Alpes;43;1;07;242;Tailhac;72;3;75
84;Auvergne-Rhône-Alpes;43;3;03;244;Tence;3098;45;3143
84;Auvergne-Rhône-Alpes;43;1;07;245;Thoras;229;8;237
84;Auvergne-Rhône-Alpes;43;3;02;246;Tiranges;479;16;495
84;Auvergne-Rhône-Alpes;43;1;17;247;Torsiac;68;1;69
84;Auvergne-Rhône-Alpes;43;3;02;249;Valprivas;509;11;520
84;Auvergne-Rhône-Alpes;43;1;10;250;Vals-le-Chastel;44;3;47
84;Auvergne-Rhône-Alpes;43;2;12;251;Vals-près-le-Puy;3396;130;3526
84;Auvergne-Rhône-Alpes;43;2;11;252;Varennes-Saint-Honorat;24;2;26
84;Auvergne-Rhône-Alpes;43;2;08;253;Les Vastres;203;6;209
84;Auvergne-Rhône-Alpes;43;2;16;254;Vazeilles-Limandre;253;4;257
84;Auvergne-Rhône-Alpes;43;1;07;256;Venteuges;347;6;353
84;Auvergne-Rhône-Alpes;43;2;16;257;Vergezac;502;6;508
84;Auvergne-Rhône-Alpes;43;1;17;258;Vergongheon;1851;58;1909
84;Auvergne-Rhône-Alpes;43;2;16;259;Vernassal;355;11;366
84;Auvergne-Rhône-Alpes;43;2;16;260;Le Vernet;24;0;24
84;Auvergne-Rhône-Alpes;43;1;17;261;Vézézoux;593;6;599
84;Auvergne-Rhône-Alpes;43;1;04;262;Vieille-Brioude;1194;39;1233
84;Auvergne-Rhône-Alpes;43;2;18;263;Vielprat;55;1;56
84;Auvergne-Rhône-Alpes;43;1;10;264;Villeneuve-d'Allier;290;10;300
84;Auvergne-Rhône-Alpes;43;3;09;265;Les Villettes;1423;24;1447
84;Auvergne-Rhône-Alpes;43;1;10;013;Vissac-Auteyrac;327;12;339
84;Auvergne-Rhône-Alpes;43;2;06;267;Vorey;1447;15;1462
84;Auvergne-Rhône-Alpes;43;3;19;268;Yssingeaux;7202;465;7667
52;Pays de la Loire;44;5;08;001;Abbaretz;2088;27;2115
52;Pays de la Loire;44;2;07;002;Aigrefeuille-sur-Maine;3936;107;4043
52;Pays de la Loire;44;5;01;003;Ancenis-Saint-Géréon;10802;382;11184
52;Pays de la Loire;44;3;09;006;Assérac;1790;32;1822
52;Pays de la Loire;44;5;19;007;Avessac;2476;54;2530
52;Pays de la Loire;44;2;29;009;Basse-Goulaine;9036;232;9268
52;Pays de la Loire;44;3;02;010;Batz-sur-Mer;2906;75;2981
52;Pays de la Loire;44;3;02;055;La Baule-Escoublac;16132;526;16658
52;Pays de la Loire;44;3;20;012;La Bernerie-en-Retz;2968;48;3016
52;Pays de la Loire;44;3;27;013;Besné;3051;35;3086
52;Pays de la Loire;44;2;28;014;Le Bignon;3770;69;3839
52;Pays de la Loire;44;5;03;015;Blain;9793;170;9963
52;Pays de la Loire;44;2;30;016;La Boissière-du-Doré;1045;19;1064
52;Pays de la Loire;44;2;21;018;Bouaye;7844;153;7997
52;Pays de la Loire;44;3;03;019;Bouée;991;14;1005
52;Pays de la Loire;44;2;21;020;Bouguenais;19331;278;19609
52;Pays de la Loire;44;2;07;022;Boussay;2621;35;2656
52;Pays de la Loire;44;5;03;023;Bouvron;3115;46;3161
52;Pays de la Loire;44;2;21;024;Brains;2840;58;2898
52;Pays de la Loire;44;3;03;025;Campbon;3998;69;4067
52;Pays de la Loire;44;2;04;026;Carquefou;19805;433;20238
52;Pays de la Loire;44;5;18;027;Casson;2303;26;2329
52;Pays de la Loire;44;5;18;028;Le Cellier;3793;99;3892
52;Pays de la Loire;44;3;09;030;La Chapelle-des-Marais;4185;85;4270
52;Pays de la Loire;44;5;06;031;La Chapelle-Glain;812;8;820
52;Pays de la Loire;44;2;30;032;La Chapelle-Heulin;3263;45;3308
52;Pays de la Loire;44;3;03;033;La Chapelle-Launay;3052;42;3094
52;Pays de la Loire;44;2;05;035;La Chapelle-sur-Erdre;19609;435;20044
52;Pays de la Loire;44;2;31;037;Château-Thébaud;3026;174;3200
52;Pays de la Loire;44;5;06;036;Châteaubriant;11974;518;12492
52;Pays de la Loire;44;3;89;005;Chaumes-en-Retz;6759;109;6868
52;Pays de la Loire;44;3;20;038;Chauvé;2876;46;2922
52;Pays de la Loire;44;2;10;039;Cheix-en-Retz;1067;8;1075
52;Pays de la Loire;44;5;08;221;La Chevallerais;1549;20;1569
52;Pays de la Loire;44;2;28;041;La Chevrolière;5589;81;5670
52;Pays de la Loire;44;2;07;043;Clisson;7187;234;7421
52;Pays de la Loire;44;5;08;044;Conquereuil;1116;18;1134
52;Pays de la Loire;44;2;28;156;Corcoué-sur-Logne;2927;39;2966
52;Pays de la Loire;44;2;03;045;Cordemais;3705;46;3751
52;Pays de la Loire;44;3;23;046;Corsept;2667;54;2721
52;Pays de la Loire;44;2;24;047;Couëron;21372;243;21615
52;Pays de la Loire;44;5;01;048;Couffé;2563;51;2614
52;Pays de la Loire;44;3;02;049;Le Croisic;4093;54;4147
52;Pays de la Loire;44;3;19;050;Crossac;2952;28;2980
52;Pays de la Loire;44;5;08;051;Derval;3489;427;3916
52;Pays de la Loire;44;2;30;029;Divatte-sur-Loire;6844;99;6943
52;Pays de la Loire;44;3;27;052;Donges;7961;92;8053
52;Pays de la Loire;44;3;19;053;Drefféac;2228;33;2261
52;Pays de la Loire;44;5;06;054;Erbray;3006;72;3078
52;Pays de la Loire;44;5;05;056;Fay-de-Bretagne;3618;56;3674
52;Pays de la Loire;44;5;19;057;Fégréac;2445;49;2494
52;Pays de la Loire;44;5;06;058;Fercé;474;11;485
52;Pays de la Loire;44;3;23;061;Frossay;3221;57;3278
52;Pays de la Loire;44;5;03;062;Le Gâvre;1796;37;1833
52;Pays de la Loire;44;2;28;223;Geneston;3641;47;3688
52;Pays de la Loire;44;2;07;063;Gétigné;3669;65;3734
52;Pays de la Loire;44;2;07;064;Gorges;4658;338;4996
52;Pays de la Loire;44;5;06;065;Grand-Auverné;768;13;781
52;Pays de la Loire;44;5;05;066;Grandchamps-des-Fontaines;6016;109;6125
52;Pays de la Loire;44;5;08;224;La Grigonnais;1675;23;1698
52;Pays de la Loire;44;5;08;067;Guémené-Penfao;5200;81;5281
52;Pays de la Loire;44;3;19;068;Guenrouet;3349;56;3405
52;Pays de la Loire;44;3;09;069;Guérande;15873;553;16426
52;Pays de la Loire;44;2;31;070;La Haie-Fouassière;4659;110;4769
52;Pays de la Loire;44;2;29;071;Haute-Goulaine;5764;122;5886
52;Pays de la Loire;44;3;09;072;Herbignac;6822;124;6946
52;Pays de la Loire;44;5;18;073;Héric;6049;82;6131
52;Pays de la Loire;44;2;24;074;Indre;3969;44;4013
52;Pays de la Loire;44;5;06;075;Issé;1833;39;1872
52;Pays de la Loire;44;5;08;076;Jans;1370;23;1393
52;Pays de la Loire;44;5;18;077;Joué-sur-Erdre;2482;34;2516
52;Pays de la Loire;44;5;06;078;Juigné-des-Moutiers;345;3;348
52;Pays de la Loire;44;2;30;079;Le Landreau;2995;296;3291
52;Pays de la Loire;44;3;03;080;Lavau-sur-Loire;767;26;793
52;Pays de la Loire;44;2;28;081;Legé;4514;112;4626
52;Pays de la Loire;44;5;18;082;Ligné;5174;66;5240
52;Pays de la Loire;44;2;28;083;La Limouzinière;2414;29;2443
52;Pays de la Loire;44;5;01;213;Loireauxence;7522;137;7659
52;Pays de la Loire;44;2;30;084;Le Loroux-Bottereau;8227;133;8360
52;Pays de la Loire;44;5;06;085;Louisfert;1029;29;1058
52;Pays de la Loire;44;5;08;086;Lusanger;1047;20;1067
52;Pays de la Loire;44;2;10;087;Machecoul-Saint-Même;7473;243;7716
52;Pays de la Loire;44;2;07;088;Maisdon-sur-Sèvre;2942;38;2980
52;Pays de la Loire;44;3;03;089;Malville;3463;52;3515
52;Pays de la Loire;44;2;10;090;La Marne;1503;17;1520
52;Pays de la Loire;44;5;08;091;Marsac-sur-Don;1507;21;1528
52;Pays de la Loire;44;5;08;092;Massérac;691;13;704
52;Pays de la Loire;44;2;04;094;Mauves-sur-Loire;3215;44;3259
52;Pays de la Loire;44;5;06;095;La Meilleraye-de-Bretagne;1527;24;1551
52;Pays de la Loire;44;5;01;096;Mésanger;4687;75;4762
52;Pays de la Loire;44;3;09;097;Mesquer;1941;41;1982
52;Pays de la Loire;44;3;19;098;Missillac;5342;68;5410
52;Pays de la Loire;44;5;06;099;Moisdon-la-Rivière;1951;59;2010
52;Pays de la Loire;44;2;07;100;Monnières;2239;46;2285
52;Pays de la Loire;44;2;23;101;La Montagne;6231;148;6379
52;Pays de la Loire;44;2;28;102;Montbert;3125;55;3180
52;Pays de la Loire;44;3;27;103;Montoir-de-Bretagne;7088;78;7166
52;Pays de la Loire;44;5;01;104;Montrelais;852;11;863
52;Pays de la Loire;44;5;08;105;Mouais;385;4;389
52;Pays de la Loire;44;3;20;106;Les Moutiers-en-Retz;1640;24;1664
52;Pays de la Loire;44;5;18;107;Mouzeil;1889;25;1914
52;Pays de la Loire;44;2;30;108;Mouzillon;2830;52;2882
52;Pays de la Loire;44;2;96;109;Nantes;309346;5157;314503
52;Pays de la Loire;44;5;18;110;Nort-sur-Erdre;8763;186;8949
52;Pays de la Loire;44;5;18;111;Notre-Dame-des-Landes;2184;24;2208
52;Pays de la Loire;44;5;06;112;Noyal-sur-Brutz;592;11;603
52;Pays de la Loire;44;5;08;113;Nozay;4150;45;4195
52;Pays de la Loire;44;2;25;114;Orvault;26355;727;27082
52;Pays de la Loire;44;5;01;115;Oudon;3805;65;3870
52;Pays de la Loire;44;3;23;116;Paimbœuf;3090;110;3200
52;Pays de la Loire;44;2;30;117;Le Pallet;3239;53;3292
52;Pays de la Loire;44;5;01;118;Pannecé;1364;23;1387
52;Pays de la Loire;44;2;10;119;Paulx;1981;27;2008
52;Pays de la Loire;44;2;23;120;Le Pellerin;5100;159;5259
52;Pays de la Loire;44;5;06;121;Petit-Auverné;428;4;432
52;Pays de la Loire;44;5;18;122;Petit-Mars;3601;52;3653
52;Pays de la Loire;44;5;08;123;Pierric;976;15;991
52;Pays de la Loire;44;5;01;124;Le Pin;754;15;769
52;Pays de la Loire;44;3;09;125;Piriac-sur-Mer;2245;51;2296
52;Pays de la Loire;44;3;20;126;La Plaine-sur-Mer;4266;85;4351
52;Pays de la Loire;44;2;07;127;La Planche;2640;32;2672
52;Pays de la Loire;44;5;19;128;Plessé;5248;131;5379
52;Pays de la Loire;44;2;28;130;Pont-Saint-Martin;6037;81;6118
52;Pays de la Loire;44;3;19;129;Pontchâteau;10684;219;10903
52;Pays de la Loire;44;3;20;131;Pornic;15018;389;15407
52;Pays de la Loire;44;3;02;132;Pornichet;10669;293;10962
52;Pays de la Loire;44;2;10;133;Port-Saint-Père;2913;42;2955
52;Pays de la Loire;44;5;01;134;Pouillé-les-Côteaux;1051;25;1076
52;Pays de la Loire;44;3;02;135;Le Pouliguen;4275;101;4376
52;Pays de la Loire;44;3;20;136;Préfailles;1246;30;1276
52;Pays de la Loire;44;3;03;137;Prinquiau;3459;65;3524
52;Pays de la Loire;44;5;08;138;Puceul;1128;19;1147
52;Pays de la Loire;44;3;03;139;Quilly;1380;11;1391
52;Pays de la Loire;44;2;30;140;La Regrippière;1527;26;1553
52;Pays de la Loire;44;2;30;141;La Remaudière;1285;13;1298
52;Pays de la Loire;44;2;07;142;Remouillé;1903;35;1938
52;Pays de la Loire;44;2;97;143;Rezé;41411;743;42154
52;Pays de la Loire;44;5;18;144;Riaillé;2333;58;2391
52;Pays de la Loire;44;5;01;222;La Roche-Blanche;1194;13;1207
52;Pays de la Loire;44;2;10;145;Rouans;2956;37;2993
52;Pays de la Loire;44;5;06;146;Rougé;2230;58;2288
52;Pays de la Loire;44;5;06;148;Ruffigné;703;8;711
52;Pays de la Loire;44;5;08;149;Saffré;3907;50;3957
52;Pays de la Loire;44;2;21;150;Saint-Aignan-Grandlieu;3944;60;4004
52;Pays de la Loire;44;3;02;151;Saint-André-des-Eaux;6473;170;6643
52;Pays de la Loire;44;5;06;153;Saint-Aubin-des-Châteaux;1795;43;1838
52;Pays de la Loire;44;3;23;154;Saint-Brevin-les-Pins;13802;302;14104
52;Pays de la Loire;44;2;28;155;Saint-Colomban;3355;75;3430
52;Pays de la Loire;44;2;10;157;Saint-Étienne-de-Mer-Morte;1733;20;1753
52;Pays de la Loire;44;2;03;158;Saint-Étienne-de-Montluc;7129;183;7312
52;Pays de la Loire;44;2;31;159;Saint-Fiacre-sur-Maine;1207;22;1229
52;Pays de la Loire;44;3;19;161;Saint-Gildas-des-Bois;3774;69;3843
52;Pays de la Loire;44;2;98;162;Saint-Herblain;46268;730;46998
52;Pays de la Loire;44;3;10;164;Saint-Hilaire-de-Chaléons;2287;44;2331
52;Pays de la Loire;44;2;07;165;Saint-Hilaire-de-Clisson;2285;44;2329
52;Pays de la Loire;44;2;23;166;Saint-Jean-de-Boiseau;5827;109;5936
52;Pays de la Loire;44;3;09;168;Saint-Joachim;4033;64;4097
52;Pays de la Loire;44;2;30;169;Saint-Julien-de-Concelles;6917;98;7015
52;Pays de la Loire;44;5;06;170;Saint-Julien-de-Vouvantes;984;15;999
52;Pays de la Loire;44;2;21;171;Saint-Léger-les-Vignes;1844;33;1877
52;Pays de la Loire;44;2;07;173;Saint-Lumine-de-Clisson;2103;45;2148
52;Pays de la Loire;44;2;28;174;Saint-Lumine-de-Coutais;2162;39;2201
52;Pays de la Loire;44;3;09;175;Saint-Lyphard;4760;96;4856
52;Pays de la Loire;44;3;27;176;Saint-Malo-de-Guersac;3166;64;3230
52;Pays de la Loire;44;2;10;178;Saint-Mars-de-Coutais;2610;43;2653
52;Pays de la Loire;44;5;18;179;Saint-Mars-du-Désert;4899;80;4979
52;Pays de la Loire;44;3;20;182;Saint-Michel-Chef-Chef;4993;85;5078
52;Pays de la Loire;44;3;09;183;Saint-Molf;2622;57;2679
52;Pays de la Loire;44;3;99;184;Saint-Nazaire;69993;1779;71772
52;Pays de la Loire;44;5;19;185;Saint-Nicolas-de-Redon;3179;68;3247
52;Pays de la Loire;44;3;23;187;Saint-Père-en-Retz;4564;156;4720
52;Pays de la Loire;44;2;28;188;Saint-Philbert-de-Grand-Lieu;8921;192;9113
52;Pays de la Loire;44;2;29;190;Saint-Sébastien-sur-Loire;26838;670;27508
52;Pays de la Loire;44;3;23;192;Saint-Viaud;2510;42;2552
52;Pays de la Loire;44;5;08;193;Saint-Vincent-des-Landes;1528;27;1555
52;Pays de la Loire;44;3;19;152;Sainte-Anne-sur-Brivet;2967;52;3019
52;Pays de la Loire;44;2;04;172;Sainte-Luce-sur-Loire;15360;256;15616
52;Pays de la Loire;44;2;10;186;Sainte-Pazanne;6774;127;6901
52;Pays de la Loire;44;3;19;189;Sainte-Reine-de-Bretagne;2374;29;2403
52;Pays de la Loire;44;2;24;194;Sautron;8192;158;8350
52;Pays de la Loire;44;3;03;195;Savenay;8679;177;8856
52;Pays de la Loire;44;3;19;196;Sévérac;1627;22;1649
52;Pays de la Loire;44;5;08;197;Sion-les-Mines;1583;40;1623
52;Pays de la Loire;44;2;31;198;Les Sorinières;8541;128;8669
52;Pays de la Loire;44;5;06;199;Soudan;1997;56;2053
52;Pays de la Loire;44;5;06;200;Soulvache;350;4;354
52;Pays de la Loire;44;5;05;201;Sucé-sur-Erdre;7023;197;7220
52;Pays de la Loire;44;5;18;202;Teillé;1791;25;1816
52;Pays de la Loire;44;2;03;203;Le Temple-de-Bretagne;1967;16;1983
52;Pays de la Loire;44;2;04;204;Thouaré-sur-Loire;10025;187;10212
52;Pays de la Loire;44;5;18;205;Les Touches;2474;31;2505
52;Pays de la Loire;44;2;28;206;Touvois;1828;25;1853
52;Pays de la Loire;44;5;18;207;Trans-sur-Erdre;1077;6;1083
52;Pays de la Loire;44;5;08;208;Treffieux;883;11;894
52;Pays de la Loire;44;5;05;209;Treillières;9219;238;9457
52;Pays de la Loire;44;3;27;210;Trignac;7868;79;7947
52;Pays de la Loire;44;3;09;211;La Turballe;4426;97;4523
52;Pays de la Loire;44;5;01;163;Vair-sur-Loire;4671;101;4772
52;Pays de la Loire;44;2;30;212;Vallet;9015;170;9185
52;Pays de la Loire;44;5;01;180;Vallons-de-l'Erdre;6556;120;6676
52;Pays de la Loire;44;5;08;214;Vay;2046;28;2074
52;Pays de la Loire;44;2;31;215;Vertou;24219;649;24868
52;Pays de la Loire;44;2;07;216;Vieillevigne;3959;72;4031
52;Pays de la Loire;44;5;05;217;Vigneux-de-Bretagne;6030;127;6157
52;Pays de la Loire;44;3;10;021;Villeneuve-en-Retz;4929;53;4982
52;Pays de la Loire;44;5;06;218;Villepot;669;14;683
52;Pays de la Loire;44;2;10;220;Vue;1638;26;1664
24;Centre-Val de Loire;45;1;07;001;Adon;220;5;225
24;Centre-Val de Loire;45;1;08;002;Aillant-sur-Milleron;398;8;406
24;Centre-Val de Loire;45;1;02;004;Amilly;12977;600;13577
24;Centre-Val de Loire;45;3;17;005;Andonville;246;6;252
24;Centre-Val de Loire;45;2;05;006;Ardon;1117;28;1145
24;Centre-Val de Loire;45;2;10;008;Artenay;1890;27;1917
24;Centre-Val de Loire;45;3;17;009;Aschères-le-Marché;1145;30;1175
24;Centre-Val de Loire;45;3;09;010;Ascoux;1164;21;1185
24;Centre-Val de Loire;45;3;17;011;Attray;211;4;215
24;Centre-Val de Loire;45;3;17;012;Audeville;190;2;192
24;Centre-Val de Loire;45;3;09;013;Augerville-la-Rivière;232;3;235
24;Centre-Val de Loire;45;3;09;014;Aulnay-la-Rivière;506;13;519
24;Centre-Val de Loire;45;3;17;015;Autruy-sur-Juine;688;13;701
24;Centre-Val de Loire;45;1;07;016;Autry-le-Châtel;961;27;988
24;Centre-Val de Loire;45;1;08;017;Auvilliers-en-Gâtinais;360;3;363
24;Centre-Val de Loire;45;3;09;018;Auxy;987;18;1005
24;Centre-Val de Loire;45;2;01;019;Baccon;690;29;719
24;Centre-Val de Loire;45;2;10;020;Le Bardon;1036;18;1054
24;Centre-Val de Loire;45;3;09;021;Barville-en-Gâtinais;324;6;330
24;Centre-Val de Loire;45;3;09;022;Batilly-en-Gâtinais;458;3;461
24;Centre-Val de Loire;45;1;07;023;Batilly-en-Puisaye;116;2;118
24;Centre-Val de Loire;45;2;01;024;Baule;2073;38;2111
24;Centre-Val de Loire;45;3;17;025;Bazoches-les-Gallerandes;1538;21;1559
24;Centre-Val de Loire;45;1;04;026;Bazoches-sur-le-Betz;946;18;964
24;Centre-Val de Loire;45;1;08;027;Beauchamps-sur-Huillard;405;7;412
24;Centre-Val de Loire;45;2;01;028;Beaugency;7298;185;7483
24;Centre-Val de Loire;45;1;07;029;Beaulieu-sur-Loire;1815;21;1836
24;Centre-Val de Loire;45;3;09;030;Beaune-la-Rolande;2008;128;2136
24;Centre-Val de Loire;45;1;08;031;Bellegarde;1620;83;1703
24;Centre-Val de Loire;45;1;04;032;Le Bignon-Mirabeau;323;8;331
24;Centre-Val de Loire;45;3;09;033;Boësses;380;20;400
24;Centre-Val de Loire;45;2;18;034;Boigny-sur-Bionne;2128;51;2179
24;Centre-Val de Loire;45;3;09;035;Boiscommun;1140;23;1163
24;Centre-Val de Loire;45;1;07;036;Boismorand;815;17;832
24;Centre-Val de Loire;45;3;17;037;Boisseaux;497;10;507
24;Centre-Val de Loire;45;3;09;038;Bondaroy;412;13;425
24;Centre-Val de Loire;45;2;21;039;Bonnée;713;12;725
24;Centre-Val de Loire;45;1;07;040;Bonny-sur-Loire;1952;27;1979
24;Centre-Val de Loire;45;3;09;041;Bordeaux-en-Gâtinais;112;3;115
24;Centre-Val de Loire;45;2;21;042;Les Bordes;1892;43;1935
24;Centre-Val de Loire;45;2;18;043;Bou;958;23;981
24;Centre-Val de Loire;45;2;17;044;Bougy-lez-Neuville;159;3;162
24;Centre-Val de Loire;45;3;09;045;Bouilly-en-Gâtinais;319;15;334
24;Centre-Val de Loire;45;2;10;046;Boulay-les-Barres;982;18;1000
24;Centre-Val de Loire;45;3;09;047;Bouzonville-aux-Bois;428;14;442
24;Centre-Val de Loire;45;2;03;049;Bouzy-la-Forêt;1221;29;1250
24;Centre-Val de Loire;45;3;09;050;Boynes;1355;37;1392
24;Centre-Val de Loire;45;2;21;051;Bray-Saint-Aignan;1746;34;1780
24;Centre-Val de Loire;45;1;07;052;Breteau;90;0;90
24;Centre-Val de Loire;45;1;07;053;Briare;5209;94;5303
24;Centre-Val de Loire;45;3;09;054;Briarres-sur-Essonne;544;10;554
24;Centre-Val de Loire;45;2;10;055;Bricy;554;15;569
24;Centre-Val de Loire;45;3;09;056;Bromeilles;329;6;335
24;Centre-Val de Loire;45;2;10;058;Bucy-le-Roi;171;1;172
24;Centre-Val de Loire;45;2;10;059;Bucy-Saint-Liphard;191;1;192
24;Centre-Val de Loire;45;1;07;060;La Bussière;805;18;823
24;Centre-Val de Loire;45;1;02;061;Cepoy;2367;51;2418
24;Centre-Val de Loire;45;2;10;062;Cercottes;1459;25;1484
24;Centre-Val de Loire;45;2;21;063;Cerdon;942;19;961
24;Centre-Val de Loire;45;1;07;064;Cernoy-en-Berry;451;10;461
24;Centre-Val de Loire;45;3;17;065;Césarville-Dossainville;273;2;275
24;Centre-Val de Loire;45;1;08;066;Chailly-en-Gâtinais;683;11;694
24;Centre-Val de Loire;45;2;10;067;Chaingy;3663;124;3787
24;Centre-Val de Loire;45;1;02;068;Châlette-sur-Loing;12576;259;12835
24;Centre-Val de Loire;45;3;09;069;Chambon-la-Forêt;942;14;956
24;Centre-Val de Loire;45;1;07;070;Champoulet;55;0;55
24;Centre-Val de Loire;45;2;06;072;Chanteau;1470;21;1491
24;Centre-Val de Loire;45;1;04;073;Chantecoq;494;8;502
24;Centre-Val de Loire;45;2;10;074;La Chapelle-Onzerain;124;2;126
24;Centre-Val de Loire;45;2;19;075;La Chapelle-Saint-Mesmin;10353;197;10550
24;Centre-Val de Loire;45;1;04;076;La Chapelle-Saint-Sépulcre;241;6;247
24;Centre-Val de Loire;45;1;08;077;La Chapelle-sur-Aveyron;636;6;642
24;Centre-Val de Loire;45;1;08;078;Chapelon;257;0;257
24;Centre-Val de Loire;45;1;08;079;Le Charme;151;0;151
24;Centre-Val de Loire;45;3;17;080;Charmont-en-Beauce;367;9;376
24;Centre-Val de Loire;45;2;10;081;Charsonville;616;18;634
24;Centre-Val de Loire;45;1;04;083;Château-Renard;2187;33;2220
24;Centre-Val de Loire;45;2;03;082;Châteauneuf-sur-Loire;8126;112;8238
24;Centre-Val de Loire;45;1;08;084;Châtenoy;471;10;481
24;Centre-Val de Loire;45;1;08;085;Châtillon-Coligny;1889;25;1914
24;Centre-Val de Loire;45;3;17;086;Châtillon-le-Roi;276;8;284
24;Centre-Val de Loire;45;1;07;087;Châtillon-sur-Loire;3144;52;3196
24;Centre-Val de Loire;45;3;17;088;Chaussy;316;11;327
24;Centre-Val de Loire;45;2;18;089;Chécy;8667;175;8842
24;Centre-Val de Loire;45;1;04;091;Chevannes;320;13;333
24;Centre-Val de Loire;45;1;11;092;Chevillon-sur-Huillard;1422;37;1459
24;Centre-Val de Loire;45;2;10;093;Chevilly;2662;38;2700
24;Centre-Val de Loire;45;1;04;094;Chevry-sous-le-Bignon;226;2;228
24;Centre-Val de Loire;45;3;09;095;Chilleurs-aux-Bois;1992;33;2025
24;Centre-Val de Loire;45;1;07;096;Les Choux;515;9;524
24;Centre-Val de Loire;45;1;04;097;Chuelles;1196;13;1209
24;Centre-Val de Loire;45;2;01;098;Cléry-Saint-André;3443;66;3509
24;Centre-Val de Loire;45;2;10;099;Coinces;543;9;552
24;Centre-Val de Loire;45;2;18;100;Combleux;498;22;520
24;Centre-Val de Loire;45;2;03;101;Combreux;276;6;282
24;Centre-Val de Loire;45;1;02;102;Conflans-sur-Loing;365;10;375
24;Centre-Val de Loire;45;1;04;103;Corbeilles;1544;17;1561
24;Centre-Val de Loire;45;1;02;104;Corquilleroy;2792;54;2846
24;Centre-Val de Loire;45;1;08;105;Cortrat;76;2;78
24;Centre-Val de Loire;45;1;08;107;Coudroy;322;0;322
24;Centre-Val de Loire;45;1;21;108;Coullons;2370;37;2407
24;Centre-Val de Loire;45;2;10;109;Coulmiers;536;12;548
24;Centre-Val de Loire;45;1;08;112;La Cour-Marigny;350;11;361
24;Centre-Val de Loire;45;3;09;110;Courcelles-le-Roi;309;2;311
24;Centre-Val de Loire;45;3;09;111;Courcy-aux-Loges;442;2;444
24;Centre-Val de Loire;45;1;04;113;Courtemaux;257;2;259
24;Centre-Val de Loire;45;1;04;114;Courtempierre;235;3;238
24;Centre-Val de Loire;45;1;04;115;Courtenay;4018;68;4086
24;Centre-Val de Loire;45;2;01;116;Cravant;977;17;994
24;Centre-Val de Loire;45;3;17;118;Crottes-en-Pithiverais;339;6;345
24;Centre-Val de Loire;45;3;17;119;Dadonville;2433;64;2497
24;Centre-Val de Loire;45;1;07;120;Dammarie-en-Puisaye;173;2;175
24;Centre-Val de Loire;45;1;08;121;Dammarie-sur-Loing;489;9;498
24;Centre-Val de Loire;45;2;21;122;Dampierre-en-Burly;1508;26;1534
24;Centre-Val de Loire;45;2;03;123;Darvoy;1865;32;1897
24;Centre-Val de Loire;45;3;09;124;Desmonts;170;3;173
24;Centre-Val de Loire;45;3;09;125;Dimancheville;115;3;118
24;Centre-Val de Loire;45;2;03;126;Donnery;2854;39;2893
24;Centre-Val de Loire;45;1;04;127;Dordives;3313;37;3350
24;Centre-Val de Loire;45;1;04;129;Douchy-Montcorbon;1385;26;1411
24;Centre-Val de Loire;45;2;01;130;Dry;1391;33;1424
24;Centre-Val de Loire;45;3;09;131;Échilleuses;396;8;404
24;Centre-Val de Loire;45;3;09;132;Égry;360;5;365
24;Centre-Val de Loire;45;3;17;133;Engenville;564;17;581
24;Centre-Val de Loire;45;2;10;134;Épieds-en-Beauce;1435;27;1462
24;Centre-Val de Loire;45;3;17;135;Erceville;307;5;312
24;Centre-Val de Loire;45;1;04;136;Ervauville;546;6;552
24;Centre-Val de Loire;45;3;09;137;Escrennes;732;17;749
24;Centre-Val de Loire;45;1;07;138;Escrignelles;52;0;52
24;Centre-Val de Loire;45;3;09;139;Estouy;514;18;532
24;Centre-Val de Loire;45;1;07;141;Faverelles;154;1;155
24;Centre-Val de Loire;45;2;03;142;Fay-aux-Loges;3756;67;3823
24;Centre-Val de Loire;45;1;07;143;Feins-en-Gâtinais;35;1;36
24;Centre-Val de Loire;45;2;20;144;Férolles;1153;83;1236
24;Centre-Val de Loire;45;1;04;145;Ferrières-en-Gâtinais;3687;80;3767
24;Centre-Val de Loire;45;2;05;146;La Ferté-Saint-Aubin;7454;123;7577
24;Centre-Val de Loire;45;2;06;147;Fleury-les-Aubrais;21026;279;21305
24;Centre-Val de Loire;45;1;04;148;Fontenay-sur-Loing;1720;14;1734
24;Centre-Val de Loire;45;1;04;149;Foucherolles;278;2;280
24;Centre-Val de Loire;45;1;08;150;Fréville-du-Gâtinais;180;4;184
24;Centre-Val de Loire;45;3;09;151;Gaubertin;257;8;265
24;Centre-Val de Loire;45;2;10;152;Gémigny;206;4;210
24;Centre-Val de Loire;45;2;21;153;Germigny-des-Prés;722;24;746
24;Centre-Val de Loire;45;2;10;154;Gidy;2009;33;2042
24;Centre-Val de Loire;45;1;07;155;Gien;14007;423;14430
24;Centre-Val de Loire;45;1;04;156;Girolles;619;20;639
24;Centre-Val de Loire;45;3;09;157;Givraines;414;6;420
24;Centre-Val de Loire;45;1;04;158;Gondreville;335;10;345
24;Centre-Val de Loire;45;3;09;159;Grangermont;193;3;196
24;Centre-Val de Loire;45;3;17;160;Greneville-en-Beauce;700;8;708
24;Centre-Val de Loire;45;1;04;161;Griselles;792;19;811
24;Centre-Val de Loire;45;3;17;162;Guigneville;529;14;543
24;Centre-Val de Loire;45;2;21;164;Guilly;644;16;660
24;Centre-Val de Loire;45;1;04;165;Gy-les-Nonains;628;9;637
24;Centre-Val de Loire;45;2;10;166;Huêtre;283;5;288
24;Centre-Val de Loire;45;2;10;167;Huisseau-sur-Mauves;1655;30;1685
24;Centre-Val de Loire;45;2;03;168;Ingrannes;537;3;540
24;Centre-Val de Loire;45;2;19;169;Ingré;9087;227;9314
24;Centre-Val de Loire;45;3;17;170;Intville-la-Guétard;140;2;142
24;Centre-Val de Loire;45;2;21;171;Isdes;556;12;568
24;Centre-Val de Loire;45;2;03;173;Jargeau;4604;45;4649
24;Centre-Val de Loire;45;3;17;174;Jouy-en-Pithiverais;272;0;272
24;Centre-Val de Loire;45;2;01;175;Jouy-le-Potier;1350;30;1380
24;Centre-Val de Loire;45;3;09;176;Juranville;442;4;446
24;Centre-Val de Loire;45;3;09;177;Laas;236;4;240
24;Centre-Val de Loire;45;1;08;178;Ladon;1389;18;1407
24;Centre-Val de Loire;45;2;01;179;Lailly-en-Val;3112;45;3157
24;Centre-Val de Loire;45;1;07;180;Langesse;79;0;79
24;Centre-Val de Loire;45;3;17;181;Léouville;83;2;85
24;Centre-Val de Loire;45;2;05;182;Ligny-le-Ribault;1236;29;1265
24;Centre-Val de Loire;45;2;10;183;Lion-en-Beauce;140;1;141
24;Centre-Val de Loire;45;2;21;184;Lion-en-Sullias;405;6;411
24;Centre-Val de Loire;45;1;11;185;Lombreuil;303;10;313
24;Centre-Val de Loire;45;3;09;186;Lorcy;560;8;568
24;Centre-Val de Loire;45;1;08;187;Lorris;2943;50;2993
24;Centre-Val de Loire;45;2;06;188;Loury;2452;59;2511
24;Centre-Val de Loire;45;1;04;189;Louzouer;266;7;273
24;Centre-Val de Loire;45;3;09;191;Le Malesherbois;8201;162;8363
24;Centre-Val de Loire;45;2;05;193;Marcilly-en-Villette;2124;39;2163
24;Centre-Val de Loire;45;2;18;194;Mardié;2816;52;2868
24;Centre-Val de Loire;45;3;09;195;Mareau-aux-Bois;576;14;590
24;Centre-Val de Loire;45;2;01;196;Mareau-aux-Prés;1351;23;1374
24;Centre-Val de Loire;45;2;06;197;Marigny-les-Usages;1560;35;1595
24;Centre-Val de Loire;45;3;09;198;Marsainvilliers;297;8;305
24;Centre-Val de Loire;45;1;04;199;Melleroy;504;4;508
24;Centre-Val de Loire;45;2;05;200;Ménestreau-en-Villette;1468;35;1503
24;Centre-Val de Loire;45;1;04;201;Mérinville;185;3;188
24;Centre-Val de Loire;45;2;01;202;Messas;923;14;937
24;Centre-Val de Loire;45;2;10;203;Meung-sur-Loire;6440;93;6533
24;Centre-Val de Loire;45;1;08;205;Mézières-en-Gâtinais;272;5;277
24;Centre-Val de Loire;45;2;01;204;Mézières-lez-Cléry;824;21;845
24;Centre-Val de Loire;45;1;04;206;Mignères;320;3;323
24;Centre-Val de Loire;45;1;04;207;Mignerette;395;8;403
24;Centre-Val de Loire;45;1;11;208;Montargis;14643;569;15212
24;Centre-Val de Loire;45;3;09;209;Montbarrois;311;4;315
24;Centre-Val de Loire;45;1;08;210;Montbouy;739;18;757
24;Centre-Val de Loire;45;1;08;212;Montcresson;1281;26;1307
24;Centre-Val de Loire;45;1;08;213;Montereau;608;14;622
24;Centre-Val de Loire;45;2;17;214;Montigny;246;4;250
24;Centre-Val de Loire;45;3;09;215;Montliard;235;3;238
24;Centre-Val de Loire;45;1;11;216;Mormant-sur-Vernisson;120;2;122
24;Centre-Val de Loire;45;3;17;217;Morville-en-Beauce;168;6;174
24;Centre-Val de Loire;45;1;07;218;Le Moulinet-sur-Solin;119;1;120
24;Centre-Val de Loire;45;1;08;219;Moulon;195;1;196
24;Centre-Val de Loire;45;3;09;220;Nancray-sur-Rimarde;599;18;617
24;Centre-Val de Loire;45;1;04;222;Nargis;1498;33;1531
24;Centre-Val de Loire;45;1;08;223;Nesploy;368;7;375
24;Centre-Val de Loire;45;2;17;224;Neuville-aux-Bois;4714;72;4786
24;Centre-Val de Loire;45;3;09;225;La Neuville-sur-Essonne;386;14;400
24;Centre-Val de Loire;45;2;21;226;Neuvy-en-Sullias;1362;26;1388
24;Centre-Val de Loire;45;1;07;227;Nevoy;1171;23;1194
24;Centre-Val de Loire;45;3;09;228;Nibelle;1177;11;1188
24;Centre-Val de Loire;45;1;08;229;Nogent-sur-Vernisson;2556;33;2589
24;Centre-Val de Loire;45;1;08;230;Noyers;756;4;760
24;Centre-Val de Loire;45;3;17;231;Oison;130;9;139
24;Centre-Val de Loire;45;2;12;232;Olivet;21951;523;22474
24;Centre-Val de Loire;45;3;09;233;Ondreville-sur-Essonne;407;9;416
24;Centre-Val de Loire;45;2;99;234;Orléans;116685;2400;119085
24;Centre-Val de Loire;45;2;15;235;Ormes;4122;78;4200
24;Centre-Val de Loire;45;3;09;237;Orville;119;1;120
24;Centre-Val de Loire;45;1;07;238;Ousson-sur-Loire;752;9;761
24;Centre-Val de Loire;45;1;08;239;Oussoy-en-Gâtinais;409;13;422
24;Centre-Val de Loire;45;3;17;240;Outarville;1337;23;1360
24;Centre-Val de Loire;45;2;20;241;Ouvrouer-les-Champs;558;11;569
24;Centre-Val de Loire;45;1;08;242;Ouzouer-des-Champs;244;8;252
24;Centre-Val de Loire;45;1;08;243;Ouzouer-sous-Bellegarde;313;6;319
24;Centre-Val de Loire;45;2;21;244;Ouzouer-sur-Loire;2738;70;2808
24;Centre-Val de Loire;45;1;07;245;Ouzouer-sur-Trézée;1131;21;1152
24;Centre-Val de Loire;45;3;17;246;Pannecières;131;1;132
24;Centre-Val de Loire;45;1;11;247;Pannes;3698;63;3761
24;Centre-Val de Loire;45;2;10;248;Patay;2190;34;2224
24;Centre-Val de Loire;45;1;02;249;Paucourt;904;24;928
24;Centre-Val de Loire;45;1;04;250;Pers-en-Gâtinais;256;1;257
24;Centre-Val de Loire;45;1;07;251;Pierrefitte-ès-Bois;309;4;313
24;Centre-Val de Loire;45;3;17;252;Pithiviers;8981;148;9129
24;Centre-Val de Loire;45;3;17;253;Pithiviers-le-Vieil;1813;47;1860
24;Centre-Val de Loire;45;1;21;254;Poilly-lez-Gien;2406;62;2468
24;Centre-Val de Loire;45;1;04;255;Préfontaines;452;9;461
24;Centre-Val de Loire;45;1;08;256;Presnoy;246;6;252
24;Centre-Val de Loire;45;1;08;257;Pressigny-les-Pins;498;7;505
24;Centre-Val de Loire;45;3;09;258;Puiseaux;3416;58;3474
24;Centre-Val de Loire;45;1;08;259;Quiers-sur-Bézonde;1152;22;1174
24;Centre-Val de Loire;45;3;09;260;Ramoulu;251;9;260
24;Centre-Val de Loire;45;2;06;261;Rebréchien;1324;17;1341
24;Centre-Val de Loire;45;2;10;262;Rouvray-Sainte-Croix;142;0;142
24;Centre-Val de Loire;45;3;17;263;Rouvres-Saint-Jean;281;8;289
24;Centre-Val de Loire;45;2;10;264;Rozières-en-Beauce;194;5;199
24;Centre-Val de Loire;45;1;04;265;Rozoy-le-Vieil;418;5;423
24;Centre-Val de Loire;45;2;10;266;Ruan;205;1;206
24;Centre-Val de Loire;45;2;21;268;Saint-Aignan-le-Jaillard;606;7;613
24;Centre-Val de Loire;45;2;10;269;Saint-Ay;3454;68;3522
24;Centre-Val de Loire;45;2;21;270;Saint-Benoît-sur-Loire;2030;44;2074
24;Centre-Val de Loire;45;1;21;271;Saint-Brisson-sur-Loire;981;25;1006
24;Centre-Val de Loire;45;2;05;272;Saint-Cyr-en-Val;3309;72;3381
24;Centre-Val de Loire;45;2;03;273;Saint-Denis-de-l'Hôtel;3045;39;3084
24;Centre-Val de Loire;45;2;20;274;Saint-Denis-en-Val;7517;177;7694
24;Centre-Val de Loire;45;1;04;275;Saint-Firmin-des-Bois;462;4;466
24;Centre-Val de Loire;45;1;07;276;Saint-Firmin-sur-Loire;521;5;526
24;Centre-Val de Loire;45;2;21;277;Saint-Florent;457;11;468
24;Centre-Val de Loire;45;1;04;279;Saint-Germain-des-Prés;1916;18;1934
24;Centre-Val de Loire;45;1;21;280;Saint-Gondon;1109;19;1128
24;Centre-Val de Loire;45;1;04;281;Saint-Hilaire-les-Andrésis;916;15;931
24;Centre-Val de Loire;45;2;12;282;Saint-Hilaire-Saint-Mesmin;3040;83;3123
24;Centre-Val de Loire;45;1;08;283;Saint-Hilaire-sur-Puiseaux;175;4;179
24;Centre-Val de Loire;45;2;18;284;Saint-Jean-de-Braye;20751;598;21349
24;Centre-Val de Loire;45;2;19;285;Saint-Jean-de-la-Ruelle;16273;306;16579
24;Centre-Val de Loire;45;2;20;286;Saint-Jean-le-Blanc;8702;222;8924
24;Centre-Val de Loire;45;1;04;287;Saint-Loup-de-Gonois;97;3;100
24;Centre-Val de Loire;45;3;09;288;Saint-Loup-des-Vignes;398;10;408
24;Centre-Val de Loire;45;2;17;289;Saint-Lyé-la-Forêt;1170;18;1188
24;Centre-Val de Loire;45;2;03;290;Saint-Martin-d'Abbat;1769;28;1797
24;Centre-Val de Loire;45;1;21;291;Saint-Martin-sur-Ocre;1240;37;1277
24;Centre-Val de Loire;45;1;08;292;Saint-Maurice-sur-Aveyron;865;14;879
24;Centre-Val de Loire;45;1;11;293;Saint-Maurice-sur-Fessard;1183;26;1209
24;Centre-Val de Loire;45;3;09;294;Saint-Michel;123;0;123
24;Centre-Val de Loire;45;2;10;296;Saint-Péravy-la-Colombe;759;15;774
24;Centre-Val de Loire;45;2;21;297;Saint-Père-sur-Loire;1049;12;1061
24;Centre-Val de Loire;45;2;12;298;Saint-Pryvé-Saint-Mesmin;5803;98;5901
24;Centre-Val de Loire;45;2;10;299;Saint-Sigismond;262;4;266
24;Centre-Val de Loire;45;1;08;278;Sainte-Geneviève-des-Bois;1083;34;1117
24;Centre-Val de Loire;45;2;20;300;Sandillon;3971;87;4058
24;Centre-Val de Loire;45;3;09;301;Santeau;420;3;423
24;Centre-Val de Loire;45;2;15;302;Saran;16365;208;16573
24;Centre-Val de Loire;45;1;04;303;Sceaux-du-Gâtinais;635;13;648
24;Centre-Val de Loire;45;2;03;305;Seichebrières;207;1;208
24;Centre-Val de Loire;45;1;04;306;La Selle-en-Hermoy;810;14;824
24;Centre-Val de Loire;45;1;04;307;La Selle-sur-le-Bied;1012;20;1032
24;Centre-Val de Loire;45;2;18;308;Semoy;3176;73;3249
24;Centre-Val de Loire;45;2;05;309;Sennely;709;6;715
24;Centre-Val de Loire;45;3;17;310;Sermaises;1646;23;1669
24;Centre-Val de Loire;45;2;20;311;Sigloy;678;5;683
24;Centre-Val de Loire;45;1;11;312;Solterre;469;7;476
24;Centre-Val de Loire;45;2;10;313;Sougy;826;13;839
24;Centre-Val de Loire;45;2;03;314;Sully-la-Chapelle;431;8;439
24;Centre-Val de Loire;45;2;21;315;Sully-sur-Loire;5348;91;5439
24;Centre-Val de Loire;45;2;03;316;Sury-aux-Bois;792;19;811
24;Centre-Val de Loire;45;2;01;317;Tavers;1346;36;1382
24;Centre-Val de Loire;45;3;17;320;Thignonville;400;11;411
24;Centre-Val de Loire;45;1;08;321;Thimory;737;11;748
24;Centre-Val de Loire;45;1;04;322;Thorailles;179;4;183
24;Centre-Val de Loire;45;1;07;323;Thou;229;4;233
24;Centre-Val de Loire;45;2;20;324;Tigy;2315;48;2363
24;Centre-Val de Loire;45;3;17;325;Tivernon;285;4;289
24;Centre-Val de Loire;45;2;10;326;Tournoisis;407;9;416
24;Centre-Val de Loire;45;2;06;327;Traînou;3343;79;3422
24;Centre-Val de Loire;45;1;04;328;Treilles-en-Gâtinais;287;5;292
24;Centre-Val de Loire;45;1;04;329;Triguères;1293;25;1318
24;Centre-Val de Loire;45;2;10;330;Trinay;225;4;229
24;Centre-Val de Loire;45;2;20;331;Vannes-sur-Cosson;602;8;610
24;Centre-Val de Loire;45;1;08;332;Varennes-Changy;1489;26;1515
24;Centre-Val de Loire;45;2;06;333;Vennecy;1812;37;1849
24;Centre-Val de Loire;45;1;08;334;Vieilles-Maisons-sur-Joudry;638;8;646
24;Centre-Val de Loire;45;2;20;335;Vienne-en-Val;1942;29;1971
24;Centre-Val de Loire;45;2;21;336;Viglain;871;7;878
24;Centre-Val de Loire;45;2;10;337;Villamblain;285;8;293
24;Centre-Val de Loire;45;1;11;338;Villemandeur;6815;349;7164
24;Centre-Val de Loire;45;1;08;339;Villemoutiers;486;6;492
24;Centre-Val de Loire;45;2;21;340;Villemurlin;585;3;588
24;Centre-Val de Loire;45;2;10;341;Villeneuve-sur-Conie;206;7;213
24;Centre-Val de Loire;45;2;17;342;Villereau;375;3;378
24;Centre-Val de Loire;45;1;04;343;Villevoques;212;6;218
24;Centre-Val de Loire;45;2;01;344;Villorceau;1132;22;1154
24;Centre-Val de Loire;45;1;11;345;Vimory;1173;35;1208
24;Centre-Val de Loire;45;2;03;346;Vitry-aux-Loges;2185;37;2222
24;Centre-Val de Loire;45;3;09;347;Vrigny;823;24;847
24;Centre-Val de Loire;45;3;09;348;Yèvre-la-Ville;702;17;719
76;Occitanie;46;1;12;001;Albas;525;13;538
76;Occitanie;46;2;10;002;Albiac;70;2;72
76;Occitanie;46;3;10;003;Alvignac;720;26;746
76;Occitanie;46;2;11;004;Anglars;214;2;216
76;Occitanie;46;1;12;005;Anglars-Juillac;326;8;334
76;Occitanie;46;3;09;006;Anglars-Nozac;365;4;369
76;Occitanie;46;1;02;007;Arcambal;994;24;1018
76;Occitanie;46;3;15;008;Les Arques;195;5;200
76;Occitanie;46;2;11;009;Assier;651;20;671
76;Occitanie;46;1;13;010;Aujols;364;10;374
76;Occitanie;46;2;16;011;Autoire;358;9;367
76;Occitanie;46;2;16;012;Aynac;550;10;560
76;Occitanie;46;1;13;013;Bach;178;2;180
76;Occitanie;46;2;08;015;Bagnac-sur-Célé;1475;38;1513
76;Occitanie;46;3;14;016;Baladou;399;16;415
76;Occitanie;46;2;16;017;Bannes;135;3;138
76;Occitanie;46;1;12;263;Barguelonne-en-Quercy;680;17;697
76;Occitanie;46;3;10;018;Le Bastit;143;3;146
76;Occitanie;46;1;13;020;Beauregard;233;12;245
76;Occitanie;46;2;07;021;Béduer;720;26;746
76;Occitanie;46;1;12;022;Bélaye;224;1;225
76;Occitanie;46;1;13;023;Belfort-du-Quercy;516;6;522
76;Occitanie;46;1;02;156;Bellefont-La Rauze;1230;24;1254
76;Occitanie;46;2;06;024;Belmont-Bretenoux;401;11;412
76;Occitanie;46;1;13;026;Belmont-Sainte-Foi;101;3;104
76;Occitanie;46;1;05;027;Berganty;116;2;118
76;Occitanie;46;2;11;338;Bessonies;81;2;83
76;Occitanie;46;3;14;028;Bétaille;1006;26;1032
76;Occitanie;46;2;06;029;Biars-sur-Cère;2139;52;2191
76;Occitanie;46;3;10;030;Bio;348;13;361
76;Occitanie;46;3;05;031;Blars;138;3;141
76;Occitanie;46;1;04;032;Boissières;397;5;402
76;Occitanie;46;2;11;034;Le Bourg;331;10;341
76;Occitanie;46;2;07;035;Boussac;185;8;193
76;Occitanie;46;2;11;036;Le Bouyssou;139;2;141
76;Occitanie;46;1;05;037;Bouziès;84;1;85
76;Occitanie;46;2;05;039;Brengues;211;5;216
76;Occitanie;46;2;06;038;Bretenoux;1356;26;1382
76;Occitanie;46;1;05;040;Cabrerets;229;8;237
76;Occitanie;46;2;05;041;Cadrieu;158;7;165
76;Occitanie;46;1;98;042;Cahors;19878;930;20808
76;Occitanie;46;2;06;043;Cahus;206;2;208
76;Occitanie;46;1;12;044;Caillac;599;21;620
76;Occitanie;46;2;05;045;Cajarc;1125;34;1159
76;Occitanie;46;1;04;046;Calamane;458;10;468
76;Occitanie;46;3;17;047;Calès;167;6;173
76;Occitanie;46;2;05;049;Calvignac;207;3;210
76;Occitanie;46;1;12;050;Cambayrac;154;5;159
76;Occitanie;46;2;07;051;Cambes;364;10;374
76;Occitanie;46;2;07;052;Camboulit;257;5;262
76;Occitanie;46;2;07;053;Camburat;421;13;434
76;Occitanie;46;3;05;054;Caniac-du-Causse;367;3;370
76;Occitanie;46;2;08;055;Capdenac;1105;26;1131
76;Occitanie;46;2;05;056;Carayac;101;5;106
76;Occitanie;46;2;11;057;Cardaillac;602;18;620
76;Occitanie;46;3;14;058;Carennac;408;15;423
76;Occitanie;46;3;10;059;Carlucet;220;9;229
76;Occitanie;46;1;12;060;Carnac-Rouffiac;219;1;220
76;Occitanie;46;1;15;061;Cassagnes;181;4;185
76;Occitanie;46;1;12;062;Castelfranc;426;8;434
76;Occitanie;46;1;13;063;Castelnau Montratier-Sainte Alauzie;1880;41;1921
76;Occitanie;46;1;04;064;Catus;860;15;875
76;Occitanie;46;3;14;065;Cavagnac;461;14;475
76;Occitanie;46;3;09;066;Cazals;625;15;640
76;Occitanie;46;1;05;068;Cénevières;172;3;175
76;Occitanie;46;1;13;069;Cézac;168;2;170
76;Occitanie;46;1;03;070;Cieurac;550;14;564
76;Occitanie;46;3;04;072;Concorès;313;7;320
76;Occitanie;46;1;13;073;Concots;423;17;440
76;Occitanie;46;3;14;074;Condat;414;8;422
76;Occitanie;46;2;07;075;Corn;227;5;232
76;Occitanie;46;2;06;076;Cornac;348;9;357
76;Occitanie;46;3;10;078;Couzou;92;2;94
76;Occitanie;46;3;05;079;Cras;103;2;105
76;Occitanie;46;1;04;080;Crayssac;770;13;783
76;Occitanie;46;1;05;081;Crégols;76;3;79
76;Occitanie;46;1;13;082;Cremps;361;9;370
76;Occitanie;46;3;14;083;Cressensac-Sarrazac;1136;23;1159
76;Occitanie;46;3;14;084;Creysse;305;8;313
76;Occitanie;46;2;08;085;Cuzac;241;6;247
76;Occitanie;46;3;14;086;Cuzance;607;13;620
76;Occitanie;46;3;89;138;Cœur de Causse;954;20;974
76;Occitanie;46;3;09;087;Dégagnac;667;18;685
76;Occitanie;46;1;12;088;Douelle;816;29;845
76;Occitanie;46;1;15;089;Duravel;965;7;972
76;Occitanie;46;2;10;090;Durbans;141;2;143
76;Occitanie;46;1;13;091;Escamps;209;5;214
76;Occitanie;46;1;05;092;Esclauzels;224;4;228
76;Occitanie;46;2;05;093;Espagnac-Sainte-Eulalie;91;3;94
76;Occitanie;46;2;05;094;Espédaillac;270;5;275
76;Occitanie;46;1;04;095;Espère;1044;26;1070
76;Occitanie;46;2;11;096;Espeyroux;97;2;99
76;Occitanie;46;2;06;097;Estal;109;6;115
76;Occitanie;46;3;17;098;Fajoles;288;6;294
76;Occitanie;46;2;07;100;Faycelles;659;26;685
76;Occitanie;46;2;08;101;Felzins;443;6;449
76;Occitanie;46;2;99;102;Figeac;9792;681;10473
76;Occitanie;46;2;10;104;Flaujac-Gare;99;6;105
76;Occitanie;46;1;03;105;Flaujac-Poujols;772;17;789
76;Occitanie;46;3;14;106;Floirac;258;7;265
76;Occitanie;46;1;15;107;Floressas;163;5;168
76;Occitanie;46;2;07;108;Fons;405;17;422
76;Occitanie;46;1;13;109;Fontanes;476;8;484
76;Occitanie;46;2;07;111;Fourmagnac;161;4;165
76;Occitanie;46;1;04;112;Francoulès;220;5;225
76;Occitanie;46;3;04;113;Frayssinet;304;7;311
76;Occitanie;46;3;15;114;Frayssinet-le-Gélat;358;7;365
76;Occitanie;46;2;16;115;Frayssinhes;167;6;173
76;Occitanie;46;2;05;116;Frontenac;69;6;75
76;Occitanie;46;2;06;117;Gagnac-sur-Cère;671;44;715
76;Occitanie;46;3;17;118;Gignac;666;13;679
76;Occitanie;46;1;04;119;Gigouzac;275;0;275
76;Occitanie;46;3;09;120;Gindou;321;4;325
76;Occitanie;46;3;04;121;Ginouillac;154;5;159
76;Occitanie;46;2;06;122;Gintrac;103;4;107
76;Occitanie;46;2;06;123;Girac;379;8;387
76;Occitanie;46;2;06;124;Glanes;308;11;319
76;Occitanie;46;2;11;125;Gorses;325;10;335
76;Occitanie;46;3;15;126;Goujounac;225;2;227
76;Occitanie;46;3;09;127;Gourdon;4094;128;4222
76;Occitanie;46;3;10;128;Gramat;3528;65;3593
76;Occitanie;46;2;05;129;Gréalou;282;9;291
76;Occitanie;46;1;15;130;Grézels;224;5;229
76;Occitanie;46;2;05;131;Grèzes;175;5;180
76;Occitanie;46;2;10;132;Issendolus;516;22;538
76;Occitanie;46;2;11;133;Issepts;241;4;245
76;Occitanie;46;1;15;134;Les Junies;269;5;274
76;Occitanie;46;2;11;135;Labastide-du-Haut-Mont;49;1;50
76;Occitanie;46;1;04;136;Labastide-du-Vert;269;7;276
76;Occitanie;46;1;03;137;Labastide-Marnhac;1226;22;1248
76;Occitanie;46;2;11;139;Labathude;209;6;215
76;Occitanie;46;1;13;140;Laburgade;353;14;367
76;Occitanie;46;1;15;142;Lacapelle-Cabanac;162;2;164
76;Occitanie;46;2;11;143;Lacapelle-Marival;1272;24;1296
76;Occitanie;46;3;17;144;Lacave;262;13;275
76;Occitanie;46;3;17;145;Lachapelle-Auzac;792;13;805
76;Occitanie;46;2;16;146;Ladirat;97;5;102
76;Occitanie;46;1;15;147;Lagardelle;124;0;124
76;Occitanie;46;1;13;148;Lalbenque;1684;45;1729
76;Occitanie;46;1;02;149;Lamagdelaine;698;21;719
76;Occitanie;46;3;04;151;Lamothe-Cassel;129;3;132
76;Occitanie;46;3;17;152;Lamothe-Fénelon;293;4;297
76;Occitanie;46;3;17;153;Lanzac;588;17;605
76;Occitanie;46;1;13;154;Laramière;348;12;360
76;Occitanie;46;2;05;155;Larnagol;137;1;138
76;Occitanie;46;2;05;157;Larroque-Toirac;133;5;138
76;Occitanie;46;2;16;159;Latouille-Lentillac;226;13;239
76;Occitanie;46;2;11;160;Latronquière;441;15;456
76;Occitanie;46;2;11;161;Lauresses;263;6;269
76;Occitanie;46;3;05;162;Lauzès;189;6;195
76;Occitanie;46;2;06;163;Laval-de-Cère;296;8;304
76;Occitanie;46;3;09;164;Lavercantière;244;12;256
76;Occitanie;46;3;10;165;Lavergne;446;17;463
76;Occitanie;46;1;12;262;Lendou-en-Quercy;642;15;657
76;Occitanie;46;3;05;167;Lentillac-du-Causse;99;0;99
76;Occitanie;46;2;08;168;Lentillac-Saint-Blaise;179;1;180
76;Occitanie;46;3;09;169;Léobard;210;7;217
76;Occitanie;46;2;16;170;Leyme;933;24;957
76;Occitanie;46;1;15;171;Lherm;229;2;231
76;Occitanie;46;1;13;172;Lhospitalet;496;17;513
76;Occitanie;46;1;13;173;Limogne-en-Quercy;762;19;781
76;Occitanie;46;2;08;174;Linac;223;1;224
76;Occitanie;46;2;07;175;Lissac-et-Mouret;918;32;950
76;Occitanie;46;2;11;176;Livernon;680;17;697
76;Occitanie;46;2;16;177;Loubressac;537;21;558
76;Occitanie;46;3;17;178;Loupiac;260;1;261
76;Occitanie;46;1;13;179;Lugagnac;127;5;132
76;Occitanie;46;2;08;180;Lunan;567;21;588
76;Occitanie;46;3;05;181;Lunegarde;100;3;103
76;Occitanie;46;1;12;182;Luzech;1815;30;1845
76;Occitanie;46;2;05;183;Marcilhac-sur-Célé;200;2;202
76;Occitanie;46;3;09;184;Marminiac;361;11;372
76;Occitanie;46;3;14;185;Martel;1597;50;1647
76;Occitanie;46;3;17;186;Masclat;361;7;368
76;Occitanie;46;1;15;187;Mauroux;526;11;537
76;Occitanie;46;1;04;188;Maxou;305;7;312
76;Occitanie;46;3;17;337;Mayrac;249;7;256
76;Occitanie;46;2;16;189;Mayrinhac-Lentour;511;13;524
76;Occitanie;46;1;04;190;Mechmont;125;3;128
76;Occitanie;46;1;01;191;Mercuès;1116;21;1137
76;Occitanie;46;3;17;192;Meyronne;278;7;285
76;Occitanie;46;3;10;193;Miers;455;13;468
76;Occitanie;46;3;09;194;Milhac;183;3;186
76;Occitanie;46;2;16;195;Molières;362;7;369
76;Occitanie;46;3;04;196;Montamel;108;3;111
76;Occitanie;46;1;03;197;Le Montat;1036;118;1154
76;Occitanie;46;2;05;198;Montbrun;99;1;100
76;Occitanie;46;1;15;199;Montcabrier;355;3;358
76;Occitanie;46;3;15;200;Montcléra;271;5;276
76;Occitanie;46;1;12;201;Montcuq-en-Quercy-Blanc;1706;55;1761
76;Occitanie;46;1;13;202;Montdoumerc;538;7;545
76;Occitanie;46;2;11;203;Montet-et-Bouxal;218;7;225
76;Occitanie;46;3;04;204;Montfaucon;592;9;601
76;Occitanie;46;1;04;205;Montgesty;339;3;342
76;Occitanie;46;1;12;206;Montlauzun;123;4;127
76;Occitanie;46;2;08;207;Montredon;297;5;302
76;Occitanie;46;3;14;208;Montvalent;286;11;297
76;Occitanie;46;3;17;209;Nadaillac-de-Rouge;159;8;167
76;Occitanie;46;3;05;210;Nadillac;61;2;63
76;Occitanie;46;1;04;211;Nuzéjouls;372;2;374
76;Occitanie;46;3;05;212;Orniac;72;3;75
76;Occitanie;46;3;10;213;Padirac;158;10;168
76;Occitanie;46;1;12;214;Parnac;377;9;386
76;Occitanie;46;3;17;215;Payrac;620;17;637
76;Occitanie;46;3;09;216;Payrignac;671;14;685
76;Occitanie;46;3;05;252;Les Pechs du Vers;310;8;318
76;Occitanie;46;1;13;217;Pern;449;10;459
76;Occitanie;46;1;15;218;Pescadoires;190;3;193
76;Occitanie;46;3;04;219;Peyrilles;354;13;367
76;Occitanie;46;3;17;220;Pinsac;774;24;798
76;Occitanie;46;2;07;221;Planioles;525;9;534
76;Occitanie;46;3;15;222;Pomarède;189;3;192
76;Occitanie;46;1;04;223;Pontcirq;158;0;158
76;Occitanie;46;1;87;033;Porte-du-Quercy;576;10;586
76;Occitanie;46;1;01;224;Pradines;3467;100;3567
76;Occitanie;46;1;15;225;Prayssac;2397;74;2471
76;Occitanie;46;2;08;226;Prendeignes;230;8;238
76;Occitanie;46;1;13;227;Promilhanes;226;3;229
76;Occitanie;46;2;06;228;Prudhomat;715;15;730
76;Occitanie;46;1;15;231;Puy-l'Évêque;1973;31;2004
76;Occitanie;46;2;06;229;Puybrun;1005;18;1023
76;Occitanie;46;2;05;230;Puyjourdes;89;2;91
76;Occitanie;46;2;05;233;Quissac;112;3;115
76;Occitanie;46;3;09;234;Rampoux;98;2;100
76;Occitanie;46;2;10;235;Reilhac;172;4;176
76;Occitanie;46;3;17;236;Reilhaguet;130;5;135
76;Occitanie;46;2;11;237;Reyrevignes;386;12;398
76;Occitanie;46;3;10;238;Rignac;266;14;280
76;Occitanie;46;3;17;239;Le Roc;220;6;226
76;Occitanie;46;3;10;240;Rocamadour;606;20;626
76;Occitanie;46;3;09;241;Rouffilhac;186;4;190
76;Occitanie;46;2;11;242;Rudelle;173;7;180
76;Occitanie;46;2;11;243;Rueyres;196;2;198
76;Occitanie;46;2;11;244;Sabadel-Latronquière;96;0;96
76;Occitanie;46;3;05;245;Sabadel-Lauzès;79;1;80
76;Occitanie;46;2;16;246;Saignes;78;1;79
76;Occitanie;46;1;13;247;Saillac;159;5;164
76;Occitanie;46;2;11;249;Saint-Bressou;114;3;117
76;Occitanie;46;3;15;250;Saint-Caprais;75;2;77
76;Occitanie;46;2;16;251;Saint-Céré;3462;167;3629
76;Occitanie;46;3;04;253;Saint-Chamarand;187;2;189
76;Occitanie;46;2;05;254;Saint-Chels;141;5;146
76;Occitanie;46;2;11;255;Saint-Cirgues;350;14;364
76;Occitanie;46;1;05;256;Saint-Cirq-Lapopie;203;2;205
76;Occitanie;46;3;09;257;Saint-Cirq-Madelon;128;3;131
76;Occitanie;46;3;09;258;Saint-Cirq-Souillaguet;159;1;160
76;Occitanie;46;3;09;259;Saint-Clair;145;2;147
76;Occitanie;46;1;04;264;Saint-Denis-Catus;181;6;187
76;Occitanie;46;3;14;265;Saint-Denis-lès-Martel;333;7;340
76;Occitanie;46;2;08;266;Saint-Félix;522;8;530
76;Occitanie;46;3;04;267;Saint-Germain-du-Bel-Air;562;12;574
76;Occitanie;46;1;88;268;Saint Géry-Vers;863;18;881
76;Occitanie;46;2;11;269;Saint-Hilaire;66;2;68
76;Occitanie;46;2;05;270;Saint-Jean-de-Laur;237;4;241
76;Occitanie;46;2;16;339;Saint-Jean-Lagineste;336;6;342
76;Occitanie;46;2;16;271;Saint-Jean-Lespinasse;393;17;410
76;Occitanie;46;2;08;272;Saint-Jean-Mirabel;240;4;244
76;Occitanie;46;2;16;273;Saint-Laurent-les-Tours;891;25;916
76;Occitanie;46;1;05;276;Saint-Martin-Labouval;186;6;192
76;Occitanie;46;1;15;277;Saint-Martin-le-Redon;210;12;222
76;Occitanie;46;2;11;279;Saint-Maurice-en-Quercy;218;4;222
76;Occitanie;46;1;04;280;Saint-Médard;177;6;183
76;Occitanie;46;2;16;281;Saint-Médard-de-Presque;202;7;209
76;Occitanie;46;2;11;282;Saint-Médard-Nicourby;93;0;93
76;Occitanie;46;3;14;283;Saint-Michel-de-Bannières;318;8;326
76;Occitanie;46;2;06;284;Saint-Michel-Loubéjou;401;15;416
76;Occitanie;46;2;16;286;Saint-Paul-de-Vern;181;4;185
76;Occitanie;46;1;13;103;Saint-Paul-Flaugnac;997;27;1024
76;Occitanie;46;2;08;288;Saint-Perdoux;211;9;220
76;Occitanie;46;1;04;340;Saint-Pierre-Lafeuille;367;12;379
76;Occitanie;46;2;05;289;Saint-Pierre-Toirac;153;0;153
76;Occitanie;46;3;09;290;Saint-Projet;342;8;350
76;Occitanie;46;2;11;292;Saint-Simon;172;2;174
76;Occitanie;46;3;17;293;Saint-Sozy;468;12;480
76;Occitanie;46;2;05;294;Saint-Sulpice;144;4;148
76;Occitanie;46;2;16;295;Saint-Vincent-du-Pendit;191;6;197
76;Occitanie;46;1;12;296;Saint-Vincent-Rive-d'Olt;443;15;458
76;Occitanie;46;2;11;260;Sainte-Colombe;208;2;210
76;Occitanie;46;3;09;297;Salviac;1211;26;1237
76;Occitanie;46;2;05;299;Sauliac-sur-Célé;121;3;124
76;Occitanie;46;1;12;301;Sauzet;515;5;520
76;Occitanie;46;2;11;302;Sénaillac-Latronquière;142;4;146
76;Occitanie;46;3;05;303;Sénaillac-Lauzès;128;3;131
76;Occitanie;46;3;04;304;Séniergues;131;1;132
76;Occitanie;46;1;15;305;Sérignac;300;1;301
76;Occitanie;46;2;11;306;Sonac;85;3;88
76;Occitanie;46;1;15;307;Soturac;637;5;642
76;Occitanie;46;3;04;308;Soucirac;101;1;102
76;Occitanie;46;3;17;309;Souillac;3284;392;3676
76;Occitanie;46;3;05;310;Soulomès;120;2;122
76;Occitanie;46;2;06;311;Sousceyrac-en-Quercy;1351;23;1374
76;Occitanie;46;3;14;312;Strenquels;271;2;273
76;Occitanie;46;2;06;313;Tauriac;418;8;426
76;Occitanie;46;2;11;314;Terrou;168;45;213
76;Occitanie;46;2;06;315;Teyssieu;173;4;177
76;Occitanie;46;3;04;316;Thédirac;296;5;301
76;Occitanie;46;3;10;317;Thégra;472;13;485
76;Occitanie;46;2;11;318;Thémines;218;3;221
76;Occitanie;46;2;11;319;Théminettes;169;6;175
76;Occitanie;46;1;05;320;Tour-de-Faure;323;14;337
76;Occitanie;46;1;15;321;Touzac;373;8;381
76;Occitanie;46;1;03;322;Trespoux-Rassiels;812;32;844
76;Occitanie;46;3;04;323;Ussel;95;2;97
76;Occitanie;46;3;04;324;Uzech;216;4;220
76;Occitanie;46;1;13;328;Varaire;314;6;320
76;Occitanie;46;1;13;329;Vaylats;323;4;327
76;Occitanie;46;3;14;330;Vayrac;1292;26;1318
76;Occitanie;46;2;08;332;Viazac;328;4;332
76;Occitanie;46;1;13;333;Vidaillac;171;4;175
76;Occitanie;46;3;09;334;Le Vigan;1603;37;1640
76;Occitanie;46;3;14;232;Le Vignon-en-Quercy;1014;25;1039
76;Occitanie;46;1;12;335;Villesèque;396;17;413
76;Occitanie;46;1;15;336;Vire-sur-Lot;350;31;381
75;Nouvelle-Aquitaine;47;1;97;001;Agen;33576;841;34417
75;Nouvelle-Aquitaine;47;2;07;002;Agmé;104;4;108
75;Nouvelle-Aquitaine;47;2;19;003;Agnac;422;7;429
75;Nouvelle-Aquitaine;47;1;06;004;Aiguillon;4387;141;4528
75;Nouvelle-Aquitaine;47;2;19;005;Allemans-du-Dropt;493;5;498
75;Nouvelle-Aquitaine;47;3;12;006;Allez-et-Cazeneuve;567;20;587
75;Nouvelle-Aquitaine;47;4;08;007;Allons;165;6;171
75;Nouvelle-Aquitaine;47;4;11;008;Ambrus;113;0;113
75;Nouvelle-Aquitaine;47;4;05;009;Andiran;222;8;230
75;Nouvelle-Aquitaine;47;2;08;010;Antagnac;231;3;234
75;Nouvelle-Aquitaine;47;3;09;011;Anthé;201;7;208
75;Nouvelle-Aquitaine;47;4;08;012;Anzex;313;2;315
75;Nouvelle-Aquitaine;47;2;08;013;Argenton;315;11;326
75;Nouvelle-Aquitaine;47;2;19;014;Armillac;198;7;205
75;Nouvelle-Aquitaine;47;1;17;015;Astaffort;2050;38;2088
75;Nouvelle-Aquitaine;47;1;15;016;Aubiac;1119;25;1144
75;Nouvelle-Aquitaine;47;3;16;017;Auradou;396;9;405
75;Nouvelle-Aquitaine;47;2;07;018;Auriac-sur-Dropt;177;6;183
75;Nouvelle-Aquitaine;47;1;01;019;Bajamont;978;19;997
75;Nouvelle-Aquitaine;47;2;07;020;Baleyssagues;176;5;181
75;Nouvelle-Aquitaine;47;4;11;021;Barbaste;1522;126;1648
75;Nouvelle-Aquitaine;47;1;06;022;Bazens;546;9;555
75;Nouvelle-Aquitaine;47;3;10;023;Beaugas;359;4;363
75;Nouvelle-Aquitaine;47;2;13;024;Beaupuy;1650;41;1691
75;Nouvelle-Aquitaine;47;1;16;025;Beauville;566;7;573
75;Nouvelle-Aquitaine;47;4;08;026;Beauziac;237;8;245
75;Nouvelle-Aquitaine;47;3;21;027;Bias;3031;66;3097
75;Nouvelle-Aquitaine;47;2;14;028;Birac-sur-Trec;843;18;861
75;Nouvelle-Aquitaine;47;3;09;029;Blanquefort-sur-Briolance;470;9;479
75;Nouvelle-Aquitaine;47;1;16;030;Blaymont;209;6;215
75;Nouvelle-Aquitaine;47;1;02;031;Boé;5593;92;5685
75;Nouvelle-Aquitaine;47;1;02;032;Bon-Encontre;6199;147;6346
75;Nouvelle-Aquitaine;47;3;10;033;Boudy-de-Beauregard;414;3;417
75;Nouvelle-Aquitaine;47;2;08;034;Bouglon;616;13;629
75;Nouvelle-Aquitaine;47;2;19;035;Bourgougnague;321;80;401
75;Nouvelle-Aquitaine;47;3;09;036;Bourlens;380;5;385
75;Nouvelle-Aquitaine;47;3;10;037;Bournel;246;4;250
75;Nouvelle-Aquitaine;47;1;06;038;Bourran;616;9;625
75;Nouvelle-Aquitaine;47;4;08;039;Boussès;37;0;37
75;Nouvelle-Aquitaine;47;1;15;040;Brax;2070;46;2116
75;Nouvelle-Aquitaine;47;4;11;041;Bruch;748;15;763
75;Nouvelle-Aquitaine;47;2;18;042;Brugnac;183;7;190
75;Nouvelle-Aquitaine;47;4;11;043;Buzet-sur-Baïse;1284;14;1298
75;Nouvelle-Aquitaine;47;3;19;044;Cahuzac;307;3;310
75;Nouvelle-Aquitaine;47;4;05;045;Calignac;478;5;483
75;Nouvelle-Aquitaine;47;2;08;046;Calonges;648;12;660
75;Nouvelle-Aquitaine;47;2;07;047;Cambes;180;5;185
75;Nouvelle-Aquitaine;47;3;10;048;Cancon;1340;20;1360
75;Nouvelle-Aquitaine;47;3;12;049;Casseneuil;2386;46;2432
75;Nouvelle-Aquitaine;47;1;16;050;Cassignas;125;1;126
75;Nouvelle-Aquitaine;47;1;17;051;Castelculier;2375;52;2427
75;Nouvelle-Aquitaine;47;4;08;052;Casteljaloux;4579;57;4636
75;Nouvelle-Aquitaine;47;1;16;053;Castella;367;7;374
75;Nouvelle-Aquitaine;47;2;18;054;Castelmoron-sur-Lot;1748;24;1772
75;Nouvelle-Aquitaine;47;2;07;056;Castelnau-sur-Gupie;890;32;922
75;Nouvelle-Aquitaine;47;3;10;055;Castelnaud-de-Gratecambe;508;7;515
75;Nouvelle-Aquitaine;47;3;19;057;Castillonnès;1417;21;1438
75;Nouvelle-Aquitaine;47;4;08;058;Caubeyres;253;1;254
75;Nouvelle-Aquitaine;47;2;07;059;Caubon-Saint-Sauveur;255;4;259
75;Nouvelle-Aquitaine;47;1;17;060;Caudecoste;1072;19;1091
75;Nouvelle-Aquitaine;47;2;14;061;Caumont-sur-Garonne;726;9;735
75;Nouvelle-Aquitaine;47;1;16;062;Cauzac;423;4;427
75;Nouvelle-Aquitaine;47;3;19;063;Cavarc;159;2;161
75;Nouvelle-Aquitaine;47;3;09;064;Cazideroque;230;7;237
75;Nouvelle-Aquitaine;47;2;18;065;Clairac;2622;194;2816
75;Nouvelle-Aquitaine;47;1;06;066;Clermont-Dessous;876;12;888
75;Nouvelle-Aquitaine;47;1;17;067;Clermont-Soubiran;382;8;390
75;Nouvelle-Aquitaine;47;2;13;068;Cocumont;1081;22;1103
75;Nouvelle-Aquitaine;47;1;15;069;Colayrac-Saint-Cirq;3074;48;3122
75;Nouvelle-Aquitaine;47;3;09;070;Condezaygues;854;24;878
75;Nouvelle-Aquitaine;47;2;18;071;Coulx;238;2;240
75;Nouvelle-Aquitaine;47;3;09;072;Courbiac;114;2;116
75;Nouvelle-Aquitaine;47;1;06;073;Cours;202;5;207
75;Nouvelle-Aquitaine;47;2;13;074;Couthures-sur-Garonne;339;2;341
75;Nouvelle-Aquitaine;47;1;16;075;La Croix-Blanche;1053;23;1076
75;Nouvelle-Aquitaine;47;1;17;076;Cuq;268;4;272
75;Nouvelle-Aquitaine;47;3;09;077;Cuzorn;849;17;866
75;Nouvelle-Aquitaine;47;4;11;078;Damazan;1354;46;1400
75;Nouvelle-Aquitaine;47;3;16;079;Dausse;510;18;528
75;Nouvelle-Aquitaine;47;3;10;080;Dévillac;133;3;136
75;Nouvelle-Aquitaine;47;3;12;081;Dolmayrac;712;15;727
75;Nouvelle-Aquitaine;47;1;16;082;Dondas;214;1;215
75;Nouvelle-Aquitaine;47;3;10;083;Doudrac;90;3;93
75;Nouvelle-Aquitaine;47;3;19;084;Douzains;269;5;274
75;Nouvelle-Aquitaine;47;4;08;085;Durance;293;3;296
75;Nouvelle-Aquitaine;47;2;07;086;Duras;1284;21;1305
75;Nouvelle-Aquitaine;47;1;16;087;Engayrac;169;3;172
75;Nouvelle-Aquitaine;47;2;07;088;Escassefort;600;9;609
75;Nouvelle-Aquitaine;47;2;07;089;Esclottes;151;2;153
75;Nouvelle-Aquitaine;47;4;05;090;Espiens;374;8;382
75;Nouvelle-Aquitaine;47;1;15;091;Estillac;2007;44;2051
75;Nouvelle-Aquitaine;47;1;17;092;Fals;378;4;382
75;Nouvelle-Aquitaine;47;4;08;093;Fargues-sur-Ourbise;344;9;353
75;Nouvelle-Aquitaine;47;2;14;094;Fauguerolles;790;8;798
75;Nouvelle-Aquitaine;47;2;18;095;Fauillet;848;16;864
75;Nouvelle-Aquitaine;47;3;19;096;Ferrensac;211;6;217
75;Nouvelle-Aquitaine;47;4;11;097;Feugarolles;993;21;1014
75;Nouvelle-Aquitaine;47;4;05;098;Fieux;351;9;360
75;Nouvelle-Aquitaine;47;3;12;099;Fongrave;625;16;641
75;Nouvelle-Aquitaine;47;1;01;100;Foulayronnes;5430;217;5647
75;Nouvelle-Aquitaine;47;2;14;101;Fourques-sur-Garonne;1318;28;1346
75;Nouvelle-Aquitaine;47;4;05;102;Francescas;747;11;758
75;Nouvelle-Aquitaine;47;4;05;103;Fréchou;229;4;233
75;Nouvelle-Aquitaine;47;1;06;104;Frégimont;259;4;263
75;Nouvelle-Aquitaine;47;3;16;105;Frespech;293;5;298
75;Nouvelle-Aquitaine;47;3;09;106;Fumel;4834;92;4926
75;Nouvelle-Aquitaine;47;1;06;107;Galapian;316;6;322
75;Nouvelle-Aquitaine;47;2;13;108;Gaujac;255;7;262
75;Nouvelle-Aquitaine;47;3;10;109;Gavaudun;284;5;289
75;Nouvelle-Aquitaine;47;2;14;110;Gontaud-de-Nogaret;1695;29;1724
75;Nouvelle-Aquitaine;47;1;06;111;Granges-sur-Lot;596;8;604
75;Nouvelle-Aquitaine;47;2;18;112;Grateloup-Saint-Gayrand;428;13;441
75;Nouvelle-Aquitaine;47;1;17;113;Grayssas;130;3;133
75;Nouvelle-Aquitaine;47;2;08;114;Grézet-Cavagnan;385;1;386
75;Nouvelle-Aquitaine;47;2;08;115;Guérin;249;7;256
75;Nouvelle-Aquitaine;47;3;21;117;Hautefage-la-Tour;993;17;1010
75;Nouvelle-Aquitaine;47;2;18;118;Hautesvignes;177;1;178
75;Nouvelle-Aquitaine;47;4;08;119;Houeillès;569;8;577
75;Nouvelle-Aquitaine;47;2;07;120;Jusix;116;3;119
75;Nouvelle-Aquitaine;47;2;08;121;Labastide-Castel-Amouroux;308;1;309
75;Nouvelle-Aquitaine;47;2;18;122;Labretonie;180;3;183
75;Nouvelle-Aquitaine;47;3;09;123;Lacapelle-Biron;423;5;428
75;Nouvelle-Aquitaine;47;3;10;124;Lacaussade;216;6;222
75;Nouvelle-Aquitaine;47;1;06;125;Lacépède;320;7;327
75;Nouvelle-Aquitaine;47;2;07;126;Lachapelle;84;1;85
75;Nouvelle-Aquitaine;47;2;18;127;Lafitte-sur-Lot;827;13;840
75;Nouvelle-Aquitaine;47;1;17;128;Lafox;1141;30;1171
75;Nouvelle-Aquitaine;47;1;06;129;Lagarrigue;276;6;282
75;Nouvelle-Aquitaine;47;2;08;130;Lagruère;324;6;330
75;Nouvelle-Aquitaine;47;2;07;131;Lagupie;713;15;728
75;Nouvelle-Aquitaine;47;3;19;132;Lalandusse;222;4;226
75;Nouvelle-Aquitaine;47;4;05;133;Lamontjoie;605;8;613
75;Nouvelle-Aquitaine;47;4;05;134;Lannes;369;9;378
75;Nouvelle-Aquitaine;47;2;18;135;Laparade;370;10;380
75;Nouvelle-Aquitaine;47;2;19;136;Laperche;127;4;131
75;Nouvelle-Aquitaine;47;1;15;137;Laplume;1390;33;1423
75;Nouvelle-Aquitaine;47;1;16;138;Laroque-Timbaut;1721;41;1762
75;Nouvelle-Aquitaine;47;4;05;139;Lasserre;76;3;79
75;Nouvelle-Aquitaine;47;1;06;140;Laugnac;667;15;682
75;Nouvelle-Aquitaine;47;3;10;141;Laussou;295;7;302
75;Nouvelle-Aquitaine;47;2;19;142;Lauzun;745;6;751
75;Nouvelle-Aquitaine;47;4;11;143;Lavardac;2260;60;2320
75;Nouvelle-Aquitaine;47;2;19;144;Lavergne;593;13;606
75;Nouvelle-Aquitaine;47;1;17;145;Layrac;3623;55;3678
75;Nouvelle-Aquitaine;47;3;20;146;Lédat;1398;36;1434
75;Nouvelle-Aquitaine;47;2;07;147;Lévignac-de-Guyenne;663;14;677
75;Nouvelle-Aquitaine;47;4;08;148;Leyritz-Moncassin;205;1;206
75;Nouvelle-Aquitaine;47;2;14;150;Longueville;366;7;373
75;Nouvelle-Aquitaine;47;2;07;151;Loubès-Bernac;415;3;418
75;Nouvelle-Aquitaine;47;3;19;152;Lougratte;402;10;412
75;Nouvelle-Aquitaine;47;1;06;154;Lusignan-Petit;362;4;366
75;Nouvelle-Aquitaine;47;1;06;155;Madaillan;651;15;666
75;Nouvelle-Aquitaine;47;2;13;156;Marcellus;863;8;871
75;Nouvelle-Aquitaine;47;2;98;157;Marmande;17691;589;18280
75;Nouvelle-Aquitaine;47;1;15;158;Marmont-Pachas;169;3;172
75;Nouvelle-Aquitaine;47;2;08;159;Le Mas-d'Agenais;1490;34;1524
75;Nouvelle-Aquitaine;47;3;09;160;Masquières;181;2;183
75;Nouvelle-Aquitaine;47;3;16;161;Massels;115;0;115
75;Nouvelle-Aquitaine;47;3;16;162;Massoulès;215;5;220
75;Nouvelle-Aquitaine;47;2;07;163;Mauvezin-sur-Gupie;593;8;601
75;Nouvelle-Aquitaine;47;3;10;164;Mazières-Naresse;127;4;131
75;Nouvelle-Aquitaine;47;2;13;165;Meilhan-sur-Garonne;1326;69;1395
75;Nouvelle-Aquitaine;47;4;05;167;Mézin;1554;27;1581
75;Nouvelle-Aquitaine;47;2;19;168;Miramont-de-Guyenne;3154;105;3259
75;Nouvelle-Aquitaine;47;1;15;169;Moirax;1156;41;1197
75;Nouvelle-Aquitaine;47;3;10;170;Monbahus;596;30;626
75;Nouvelle-Aquitaine;47;1;16;171;Monbalen;421;10;431
75;Nouvelle-Aquitaine;47;4;05;172;Moncaut;614;19;633
75;Nouvelle-Aquitaine;47;3;12;173;Monclar;871;13;884
75;Nouvelle-Aquitaine;47;4;05;174;Moncrabeau;733;18;751
75;Nouvelle-Aquitaine;47;3;10;175;Monflanquin;2313;55;2368
75;Nouvelle-Aquitaine;47;4;11;176;Mongaillard;180;7;187
75;Nouvelle-Aquitaine;47;4;11;177;Monheurt;192;3;195
75;Nouvelle-Aquitaine;47;3;10;178;Monségur;399;8;407
75;Nouvelle-Aquitaine;47;3;09;179;Monsempron-Libos;2091;29;2120
75;Nouvelle-Aquitaine;47;4;05;180;Montagnac-sur-Auvignon;615;14;629
75;Nouvelle-Aquitaine;47;3;10;181;Montagnac-sur-Lède;273;3;276
75;Nouvelle-Aquitaine;47;3;12;182;Montastruc;265;1;266
75;Nouvelle-Aquitaine;47;3;19;183;Montauriol;173;6;179
75;Nouvelle-Aquitaine;47;3;10;184;Montaut;251;3;254
75;Nouvelle-Aquitaine;47;3;09;185;Montayral;2680;66;2746
75;Nouvelle-Aquitaine;47;4;11;186;Montesquieu;783;12;795
75;Nouvelle-Aquitaine;47;2;07;187;Monteton;331;2;333
75;Nouvelle-Aquitaine;47;2;19;188;Montignac-de-Lauzun;286;4;290
75;Nouvelle-Aquitaine;47;2;07;189;Montignac-Toupinerie;149;0;149
75;Nouvelle-Aquitaine;47;1;06;190;Montpezat;559;46;605
75;Nouvelle-Aquitaine;47;2;13;191;Montpouillan;800;8;808
75;Nouvelle-Aquitaine;47;3;10;192;Monviel;79;1;80
75;Nouvelle-Aquitaine;47;3;10;193;Moulinet;198;4;202
75;Nouvelle-Aquitaine;47;2;07;194;Moustier;326;4;330
75;Nouvelle-Aquitaine;47;4;05;195;Nérac;6827;506;7333
75;Nouvelle-Aquitaine;47;1;06;196;Nicole;225;3;228
75;Nouvelle-Aquitaine;47;4;05;197;Nomdieu;255;8;263
75;Nouvelle-Aquitaine;47;3;10;198;Pailloles;339;6;345
75;Nouvelle-Aquitaine;47;2;07;199;Pardaillan;308;3;311
75;Nouvelle-Aquitaine;47;3;10;200;Parranquet;116;1;117
75;Nouvelle-Aquitaine;47;1;04;201;Le Passage;9561;171;9732
75;Nouvelle-Aquitaine;47;3;10;202;Paulhiac;308;7;315
75;Nouvelle-Aquitaine;47;3;16;203;Penne-d'Agenais;2346;49;2395
75;Nouvelle-Aquitaine;47;2;19;204;Peyrière;278;3;281
75;Nouvelle-Aquitaine;47;4;08;205;Pindères;209;8;217
75;Nouvelle-Aquitaine;47;3;12;206;Pinel-Hauterive;572;5;577
75;Nouvelle-Aquitaine;47;4;11;207;Pompiey;215;5;220
75;Nouvelle-Aquitaine;47;4;08;208;Pompogne;210;6;216
75;Nouvelle-Aquitaine;47;1;01;209;Pont-du-Casse;4212;121;4333
75;Nouvelle-Aquitaine;47;1;06;210;Port-Sainte-Marie;1931;32;1963
75;Nouvelle-Aquitaine;47;4;05;211;Poudenas;254;4;258
75;Nouvelle-Aquitaine;47;2;08;212;Poussignac;275;6;281
75;Nouvelle-Aquitaine;47;1;06;213;Prayssas;998;27;1025
75;Nouvelle-Aquitaine;47;4;11;214;Puch-d'Agenais;700;13;713
75;Nouvelle-Aquitaine;47;3;21;215;Pujols;3635;135;3770
75;Nouvelle-Aquitaine;47;2;07;216;Puymiclan;656;13;669
75;Nouvelle-Aquitaine;47;1;17;217;Puymirol;930;21;951
75;Nouvelle-Aquitaine;47;2;19;218;Puysserampion;245;4;249
75;Nouvelle-Aquitaine;47;3;10;219;Rayet;179;2;181
75;Nouvelle-Aquitaine;47;4;11;220;Razimet;305;6;311
75;Nouvelle-Aquitaine;47;4;05;221;Réaup-Lisse;606;18;624
75;Nouvelle-Aquitaine;47;4;08;222;La Réunion;488;9;497
75;Nouvelle-Aquitaine;47;3;10;223;Rives;221;8;229
75;Nouvelle-Aquitaine;47;2;08;224;Romestaing;166;6;172
75;Nouvelle-Aquitaine;47;1;15;225;Roquefort;1885;36;1921
75;Nouvelle-Aquitaine;47;2;19;226;Roumagne;542;10;552
75;Nouvelle-Aquitaine;47;2;08;227;Ruffiac;173;2;175
75;Nouvelle-Aquitaine;47;3;21;228;Saint-Antoine-de-Ficalba;722;11;733
75;Nouvelle-Aquitaine;47;2;07;229;Saint-Astier;222;5;227
75;Nouvelle-Aquitaine;47;3;10;230;Saint-Aubin;415;9;424
75;Nouvelle-Aquitaine;47;2;07;231;Saint-Avit;170;2;172
75;Nouvelle-Aquitaine;47;2;07;232;Saint-Barthélemy-d'Agenais;516;4;520
75;Nouvelle-Aquitaine;47;1;17;234;Saint-Caprais-de-Lerm;646;20;666
75;Nouvelle-Aquitaine;47;2;19;235;Saint-Colomb-de-Lauzun;478;4;482
75;Nouvelle-Aquitaine;47;3;12;239;Saint-Étienne-de-Fougères;829;13;842
75;Nouvelle-Aquitaine;47;3;10;240;Saint-Étienne-de-Villeréal;298;9;307
75;Nouvelle-Aquitaine;47;3;10;241;Saint-Eutrope-de-Born;680;18;698
75;Nouvelle-Aquitaine;47;3;09;242;Saint-Front-sur-Lémance;530;13;543
75;Nouvelle-Aquitaine;47;3;09;328;Saint-Georges;550;19;569
75;Nouvelle-Aquitaine;47;2;07;245;Saint-Géraud;95;2;97
75;Nouvelle-Aquitaine;47;1;15;246;Saint-Hilaire-de-Lusignan;1491;39;1530
75;Nouvelle-Aquitaine;47;2;07;247;Saint-Jean-de-Duras;245;9;254
75;Nouvelle-Aquitaine;47;1;17;248;Saint-Jean-de-Thurac;560;7;567
75;Nouvelle-Aquitaine;47;4;11;249;Saint-Laurent;525;4;529
75;Nouvelle-Aquitaine;47;4;11;250;Saint-Léger;133;4;137
75;Nouvelle-Aquitaine;47;4;11;251;Saint-Léon;322;5;327
75;Nouvelle-Aquitaine;47;4;08;254;Saint-Martin-Curton;313;8;321
75;Nouvelle-Aquitaine;47;1;16;255;Saint-Martin-de-Beauville;177;3;180
75;Nouvelle-Aquitaine;47;3;10;256;Saint-Martin-de-Villeréal;107;4;111
75;Nouvelle-Aquitaine;47;2;07;257;Saint-Martin-Petit;586;8;594
75;Nouvelle-Aquitaine;47;3;10;259;Saint-Maurice-de-Lestapel;106;4;110
75;Nouvelle-Aquitaine;47;1;16;260;Saint-Maurin;454;6;460
75;Nouvelle-Aquitaine;47;1;17;262;Saint-Nicolas-de-la-Balerme;408;4;412
75;Nouvelle-Aquitaine;47;2;14;263;Saint-Pardoux-du-Breuil;612;14;626
75;Nouvelle-Aquitaine;47;2;19;264;Saint-Pardoux-Isaac;1141;14;1155
75;Nouvelle-Aquitaine;47;3;12;265;Saint-Pastour;389;8;397
75;Nouvelle-Aquitaine;47;4;05;266;Saint-Pé-Saint-Simon;211;4;215
75;Nouvelle-Aquitaine;47;4;11;267;Saint-Pierre-de-Buzet;290;2;292
75;Nouvelle-Aquitaine;47;1;17;269;Saint-Pierre-de-Clairac;865;19;884
75;Nouvelle-Aquitaine;47;2;07;271;Saint-Pierre-sur-Dropt;338;3;341
75;Nouvelle-Aquitaine;47;3;19;272;Saint-Quentin-du-Dropt;195;7;202
75;Nouvelle-Aquitaine;47;1;16;273;Saint-Robert;184;6;190
75;Nouvelle-Aquitaine;47;1;17;274;Saint-Romain-le-Noble;418;6;424
75;Nouvelle-Aquitaine;47;1;06;275;Saint-Salvy;200;1;201
75;Nouvelle-Aquitaine;47;1;06;276;Saint-Sardos;295;7;302
75;Nouvelle-Aquitaine;47;2;13;277;Saint-Sauveur-de-Meilhan;333;1;334
75;Nouvelle-Aquitaine;47;2;07;278;Saint-Sernin;434;8;442
75;Nouvelle-Aquitaine;47;1;17;279;Saint-Sixte;358;5;363
75;Nouvelle-Aquitaine;47;3;16;280;Saint-Sylvestre-sur-Lot;2296;51;2347
75;Nouvelle-Aquitaine;47;1;17;281;Saint-Urcisse;236;1;237
75;Nouvelle-Aquitaine;47;4;05;282;Saint-Vincent-de-Lamontjoie;245;7;252
75;Nouvelle-Aquitaine;47;3;09;283;Saint-Vite;1170;25;1195
75;Nouvelle-Aquitaine;47;2;13;233;Sainte-Bazeille;3136;126;3262
75;Nouvelle-Aquitaine;47;2;07;236;Sainte-Colombe-de-Duras;105;1;106
75;Nouvelle-Aquitaine;47;3;21;237;Sainte-Colombe-de-Villeneuve;492;11;503
75;Nouvelle-Aquitaine;47;1;15;238;Sainte-Colombe-en-Bruilhois;1662;48;1710
75;Nouvelle-Aquitaine;47;2;08;244;Sainte-Gemme-Martaillac;411;5;416
75;Nouvelle-Aquitaine;47;3;12;252;Sainte-Livrade-sur-Lot;6459;177;6636
75;Nouvelle-Aquitaine;47;2;08;253;Sainte-Marthe;605;5;610
75;Nouvelle-Aquitaine;47;4;05;258;Sainte-Maure-de-Peyriac;332;11;343
75;Nouvelle-Aquitaine;47;3;10;284;Salles;293;7;300
75;Nouvelle-Aquitaine;47;2;14;285;Samazan;884;18;902
75;Nouvelle-Aquitaine;47;4;08;286;Sauméjan;107;0;107
75;Nouvelle-Aquitaine;47;4;05;287;Saumont;256;3;259
75;Nouvelle-Aquitaine;47;1;17;288;Sauvagnas;527;14;541
75;Nouvelle-Aquitaine;47;1;16;289;La Sauvetat-de-Savères;536;11;547
75;Nouvelle-Aquitaine;47;2;07;290;La Sauvetat-du-Dropt;535;10;545
75;Nouvelle-Aquitaine;47;3;10;291;La Sauvetat-sur-Lède;633;15;648
75;Nouvelle-Aquitaine;47;3;09;292;Sauveterre-la-Lémance;537;7;544
75;Nouvelle-Aquitaine;47;1;17;293;Sauveterre-Saint-Denis;387;17;404
75;Nouvelle-Aquitaine;47;2;07;294;Savignac-de-Duras;220;1;221
75;Nouvelle-Aquitaine;47;3;10;295;Savignac-sur-Leyze;302;6;308
75;Nouvelle-Aquitaine;47;2;19;296;Ségalas;156;5;161
75;Nouvelle-Aquitaine;47;3;06;297;Sembas;141;3;144
75;Nouvelle-Aquitaine;47;2;08;298;Sénestis;211;3;214
75;Nouvelle-Aquitaine;47;3;19;299;Sérignac-Péboudou;175;5;180
75;Nouvelle-Aquitaine;47;1;15;300;Sérignac-sur-Garonne;1172;21;1193
75;Nouvelle-Aquitaine;47;2;07;301;Seyches;1050;10;1060
75;Nouvelle-Aquitaine;47;4;05;302;Sos;664;7;671
75;Nouvelle-Aquitaine;47;2;07;303;Soumensac;231;9;240
75;Nouvelle-Aquitaine;47;2;14;304;Taillebourg;65;2;67
75;Nouvelle-Aquitaine;47;1;16;305;Tayrac;397;7;404
75;Nouvelle-Aquitaine;47;3;12;306;Le Temple-sur-Lot;1027;18;1045
75;Nouvelle-Aquitaine;47;3;09;307;Thézac;200;5;205
75;Nouvelle-Aquitaine;47;4;11;308;Thouars-sur-Garonne;218;3;221
75;Nouvelle-Aquitaine;47;3;12;309;Tombebœuf;460;4;464
75;Nouvelle-Aquitaine;47;2;18;310;Tonneins;9069;223;9292
75;Nouvelle-Aquitaine;47;3;10;311;Tourliac;135;7;142
75;Nouvelle-Aquitaine;47;3;09;312;Tournon-d'Agenais;761;13;774
75;Nouvelle-Aquitaine;47;3;12;313;Tourtrès;134;0;134
75;Nouvelle-Aquitaine;47;3;16;314;Trémons;392;10;402
75;Nouvelle-Aquitaine;47;3;09;315;Trentels;872;27;899
75;Nouvelle-Aquitaine;47;2;18;316;Varès;671;8;679
75;Nouvelle-Aquitaine;47;2;18;317;Verteuil-d'Agenais;607;11;618
75;Nouvelle-Aquitaine;47;4;11;318;Vianne;1016;15;1031
75;Nouvelle-Aquitaine;47;3;12;319;Villebramar;100;4;104
75;Nouvelle-Aquitaine;47;4;08;320;Villefranche-du-Queyran;390;1;391
75;Nouvelle-Aquitaine;47;2;07;321;Villeneuve-de-Duras;319;5;324
75;Nouvelle-Aquitaine;47;3;99;323;Villeneuve-sur-Lot;22064;705;22769
75;Nouvelle-Aquitaine;47;3;10;324;Villeréal;1279;40;1319
75;Nouvelle-Aquitaine;47;2;08;325;Villeton;456;6;462
75;Nouvelle-Aquitaine;47;2;14;326;Virazeil;1702;33;1735
75;Nouvelle-Aquitaine;47;4;11;327;Xaintrailles;418;3;421
76;Occitanie;48;2;01;001;Albaret-le-Comtal;174;5;179
76;Occitanie;48;2;12;002;Albaret-Sainte-Marie;568;24;592
76;Occitanie;48;2;06;003;Allenc;241;5;246
76;Occitanie;48;2;13;004;Altier;202;11;213
76;Occitanie;48;2;08;005;Antrenas;331;8;339
76;Occitanie;48;2;01;007;Arzenc-d'Apcher;50;0;50
76;Occitanie;48;2;06;008;Arzenc-de-Randon;200;8;208
76;Occitanie;48;2;07;010;Auroux;385;8;393
76;Occitanie;48;2;06;013;Badaroux;969;41;1010
76;Occitanie;48;2;03;016;Balsièges;549;19;568
76;Occitanie;48;2;02;017;Banassac-Canilhac;1044;33;1077
76;Occitanie;48;2;03;018;Barjac;751;17;768
76;Occitanie;48;1;04;019;Barre-des-Cévennes;202;7;209
76;Occitanie;48;1;04;020;Bassurels;61;0;61
76;Occitanie;48;2;13;021;La Bastide-Puylaurent;157;3;160
76;Occitanie;48;1;13;050;Bédouès-Cocurès;471;14;485
76;Occitanie;48;2;06;038;Bel-Air-Val-d'Ance;526;7;533
76;Occitanie;48;2;01;025;Les Bessons;440;28;468
76;Occitanie;48;2;12;026;Blavignac;258;1;259
76;Occitanie;48;1;13;028;Les Bondons;141;4;145
76;Occitanie;48;2;06;029;Le Born;147;0;147
76;Occitanie;48;2;03;099;Bourgs sur Colagne;2137;49;2186
76;Occitanie;48;2;13;030;Brenoux;382;9;391
76;Occitanie;48;2;01;031;Brion;79;1;80
76;Occitanie;48;2;01;032;Le Buisson;224;6;230
76;Occitanie;48;2;02;034;La Canourgue;2161;95;2256
76;Occitanie;48;1;04;166;Cans et Cévennes;284;11;295
76;Occitanie;48;1;04;036;Cassagnas;123;2;125
76;Occitanie;48;2;06;037;Chadenet;109;2;111
76;Occitanie;48;2;02;039;Chanac;1455;32;1487
76;Occitanie;48;2;07;041;Chastanier;78;0;78
76;Occitanie;48;2;11;042;Chastel-Nouvel;882;33;915
76;Occitanie;48;2;06;043;Châteauneuf-de-Randon;550;8;558
76;Occitanie;48;2;01;044;Chauchailles;90;2;92
76;Occitanie;48;2;06;045;Chaudeyrac;305;11;316
76;Occitanie;48;2;11;046;Chaulhac;70;1;71
76;Occitanie;48;2;07;048;Cheylard-l'Évêque;64;3;67
76;Occitanie;48;1;04;051;Le Collet-de-Dèze;748;48;796
76;Occitanie;48;2;13;053;Cubières;179;7;186
76;Occitanie;48;2;13;054;Cubiérettes;53;1;54
76;Occitanie;48;2;03;055;Cultures;165;4;169
76;Occitanie;48;2;03;056;Esclanèdes;392;9;401
76;Occitanie;48;2;01;058;La Fage-Montivernoux;155;5;160
76;Occitanie;48;2;01;059;La Fage-Saint-Julien;303;6;309
76;Occitanie;48;1;05;061;Florac Trois Rivières;2075;42;2117
76;Occitanie;48;2;11;063;Fontans;219;3;222
76;Occitanie;48;2;01;064;Fournels;367;8;375
76;Occitanie;48;1;04;065;Fraissinet-de-Fourques;79;0;79
76;Occitanie;48;1;04;067;Gabriac;100;3;103
76;Occitanie;48;2;03;068;Gabrias;152;5;157
76;Occitanie;48;1;05;069;Gatuzières;56;0;56
76;Occitanie;48;1;88;146;Gorges du Tarn Causses;953;31;984
76;Occitanie;48;2;06;070;Grandrieu;747;13;760
76;Occitanie;48;2;01;071;Grandvals;72;1;73
76;Occitanie;48;2;03;072;Grèzes;224;6;230
76;Occitanie;48;2;01;073;Les Hermaux;99;2;101
76;Occitanie;48;1;05;074;Hures-la-Parade;247;14;261
76;Occitanie;48;1;05;075;Ispagnac;890;20;910
76;Occitanie;48;2;11;077;Julianges;53;2;55
76;Occitanie;48;2;08;126;Lachamp-Ribennes;344;10;354
76;Occitanie;48;2;11;079;Lajo;106;3;109
76;Occitanie;48;2;07;080;Langogne;2891;194;3085
76;Occitanie;48;2;13;081;Lanuéjols;323;10;333
76;Occitanie;48;2;06;082;Laubert;97;4;101
76;Occitanie;48;2;11;083;Les Laubies;159;4;163
76;Occitanie;48;2;02;085;Laval-du-Tarn;96;4;100
76;Occitanie;48;2;07;086;Luc;216;5;221
76;Occitanie;48;1;02;088;La Malène;138;4;142
76;Occitanie;48;2;11;089;Le Malzieu-Forain;476;11;487
76;Occitanie;48;2;11;090;Le Malzieu-Ville;730;15;745
76;Occitanie;48;2;01;091;Marchastel;57;6;63
76;Occitanie;48;2;08;092;Marvejols;4722;241;4963
76;Occitanie;48;1;05;141;Mas-Saint-Chély;113;5;118
76;Occitanie;48;1;02;094;Massegros Causses Gorges;991;27;1018
76;Occitanie;48;2;99;095;Mende;12134;833;12967
76;Occitanie;48;1;05;096;Meyrueis;831;132;963
76;Occitanie;48;1;04;097;Moissac-Vallée-Française;218;9;227
76;Occitanie;48;1;04;098;Molezon;93;4;97
76;Occitanie;48;2;89;027;Mont Lozère et Goulet;1041;48;1089
76;Occitanie;48;2;06;100;Montbel;114;3;117
76;Occitanie;48;2;03;103;Montrodat;1236;79;1315
76;Occitanie;48;2;87;127;Monts-de-Randon;1301;20;1321
76;Occitanie;48;2;01;012;Les Monts-Verts;354;11;365
76;Occitanie;48;2;01;104;Nasbinals;528;29;557
76;Occitanie;48;2;07;105;Naussac-Fontanes;356;18;374
76;Occitanie;48;2;01;106;Noalhac;99;0;99
76;Occitanie;48;2;03;107;Palhers;182;7;189
76;Occitanie;48;2;06;108;La Panouse;77;2;79
76;Occitanie;48;2;11;110;Paulhac-en-Margeride;101;4;105
76;Occitanie;48;2;06;111;Pelouse;234;8;242
76;Occitanie;48;2;01;009;Peyre en Aubrac;2287;81;2368
76;Occitanie;48;2;13;015;Pied-de-Borne;180;12;192
76;Occitanie;48;2;06;112;Pierrefiche;163;5;168
76;Occitanie;48;1;04;115;Le Pompidou;160;7;167
76;Occitanie;48;1;13;116;Pont de Montvert - Sud Mont Lozère;584;24;608
76;Occitanie;48;2;13;117;Pourcharesses;120;2;122
76;Occitanie;48;2;13;119;Prévenchères;254;13;267
76;Occitanie;48;2;01;087;Prinsuéjols-Malbouzon;280;10;290
76;Occitanie;48;2;12;121;Prunières;256;17;273
76;Occitanie;48;2;01;123;Recoules-d'Aubrac;186;6;192
76;Occitanie;48;2;08;124;Recoules-de-Fumas;103;0;103
76;Occitanie;48;2;12;128;Rimeize;585;21;606
76;Occitanie;48;2;07;129;Rocles;233;6;239
76;Occitanie;48;1;04;130;Rousses;118;1;119
76;Occitanie;48;1;05;131;Le Rozier;132;6;138
76;Occitanie;48;2;11;132;Saint-Alban-sur-Limagnole;1349;31;1380
76;Occitanie;48;2;13;135;Saint-André-Capcèze;183;0;183
76;Occitanie;48;1;04;136;Saint-André-de-Lancize;134;2;136
76;Occitanie;48;2;13;137;Saint-Bauzile;621;25;646
76;Occitanie;48;2;03;138;Saint-Bonnet-de-Chirac;68;1;69
76;Occitanie;48;2;07;139;Saint Bonnet-Laval;253;2;255
76;Occitanie;48;2;12;140;Saint-Chély-d'Apcher;4164;582;4746
76;Occitanie;48;2;11;145;Saint-Denis-en-Margeride;171;7;178
76;Occitanie;48;2;13;147;Saint-Étienne-du-Valdonnez;647;40;687
76;Occitanie;48;1;04;148;Saint-Étienne-Vallée-Française;510;31;541
76;Occitanie;48;2;07;150;Saint-Flour-de-Mercoire;192;7;199
76;Occitanie;48;2;06;151;Saint-Frézal-d'Albuges;70;2;72
76;Occitanie;48;2;11;153;Saint-Gal;87;5;92
76;Occitanie;48;1;04;155;Saint-Germain-de-Calberte;448;6;454
76;Occitanie;48;2;03;156;Saint-Germain-du-Teil;889;12;901
76;Occitanie;48;1;04;158;Saint-Hilaire-de-Lavit;113;4;117
76;Occitanie;48;2;06;160;Saint-Jean-la-Fouillouse;158;7;165
76;Occitanie;48;2;01;161;Saint-Juéry;67;2;69
76;Occitanie;48;1;04;163;Saint-Julien-des-Points;109;1;110
76;Occitanie;48;2;01;165;Saint-Laurent-de-Muret;185;10;195
76;Occitanie;48;2;01;167;Saint-Laurent-de-Veyrès;37;1;38
76;Occitanie;48;2;08;168;Saint-Léger-de-Peyre;187;5;192
76;Occitanie;48;2;11;169;Saint-Léger-du-Malzieu;215;4;219
76;Occitanie;48;1;04;170;Saint-Martin-de-Boubaux;184;5;189
76;Occitanie;48;1;04;171;Saint-Martin-de-Lansuscle;188;5;193
76;Occitanie;48;1;04;173;Saint-Michel-de-Dèze;243;3;246
76;Occitanie;48;2;06;174;Saint-Paul-le-Froid;140;3;143
76;Occitanie;48;2;01;175;Saint-Pierre-de-Nogaret;180;5;185
76;Occitanie;48;1;05;176;Saint-Pierre-des-Tripiers;88;4;92
76;Occitanie;48;2;12;177;Saint-Pierre-le-Vieux;318;9;327
76;Occitanie;48;1;04;178;Saint-Privat-de-Vallongue;227;6;233
76;Occitanie;48;2;11;179;Saint-Privat-du-Fau;124;2;126
76;Occitanie;48;2;02;181;Saint-Saturnin;64;2;66
76;Occitanie;48;2;06;182;Saint-Sauveur-de-Ginestoux;57;2;59
76;Occitanie;48;1;04;144;Sainte-Croix-Vallée-Française;274;9;283
76;Occitanie;48;2;11;149;Sainte-Eulalie;37;2;39
76;Occitanie;48;2;06;157;Sainte-Hélène;101;4;105
76;Occitanie;48;2;01;187;Les Salces;97;1;98
76;Occitanie;48;2;03;185;Les Salelles;164;6;170
76;Occitanie;48;2;11;188;Serverette;257;5;262
76;Occitanie;48;2;01;190;Termes;210;8;218
76;Occitanie;48;2;02;191;La Tieule;91;3;94
76;Occitanie;48;2;01;192;Trélans;92;2;94
76;Occitanie;48;1;04;193;Vebron;204;1;205
76;Occitanie;48;1;04;152;Ventalon en Cévennes;237;6;243
76;Occitanie;48;1;13;194;Vialas;432;48;480
76;Occitanie;48;2;13;198;Villefort;548;12;560
52;Pays de la Loire;49;3;15;002;Allonnes;3029;55;3084
52;Pays de la Loire;49;1;98;007;Angers;152960;3077;156037
52;Pays de la Loire;49;4;20;008;Angrie;949;13;962
52;Pays de la Loire;49;3;14;009;Antoigné;465;4;469
52;Pays de la Loire;49;4;20;010;Armaillé;314;5;319
52;Pays de la Loire;49;3;19;011;Artannes-sur-Thouet;424;17;441
52;Pays de la Loire;49;1;11;012;Aubigné-sur-Layon;366;11;377
52;Pays de la Loire;49;1;04;015;Avrillé;13692;332;14024
52;Pays de la Loire;49;1;21;017;Baracé;580;5;585
52;Pays de la Loire;49;3;08;018;Baugé-en-Anjou;11892;250;12142
52;Pays de la Loire;49;1;03;020;Beaucouzé;5156;100;5256
52;Pays de la Loire;49;3;08;021;Beaufort-en-Anjou;7226;157;7383
52;Pays de la Loire;49;1;11;022;Beaulieu-sur-Layon;1391;29;1420
52;Pays de la Loire;49;2;09;023;Beaupréau-en-Mauges;23228;712;23940
52;Pays de la Loire;49;4;10;026;Bécon-les-Granits;2803;114;2917
52;Pays de la Loire;49;2;09;027;Bégrolles-en-Mauges;2068;40;2108
52;Pays de la Loire;49;1;03;028;Béhuard;125;6;131
52;Pays de la Loire;49;1;11;345;Bellevigne-en-Layon;5730;113;5843
52;Pays de la Loire;49;3;84;060;Bellevigne-les-Châteaux;3520;81;3601
52;Pays de la Loire;49;1;17;029;Blaison-Saint-Sulpice;1250;29;1279
52;Pays de la Loire;49;3;15;030;Blou;994;21;1015
52;Pays de la Loire;49;3;08;138;Les Bois d'Anjou;2653;56;2709
52;Pays de la Loire;49;1;02;035;Bouchemaine;6774;138;6912
52;Pays de la Loire;49;4;20;036;Bouillé-Ménard;750;20;770
52;Pays de la Loire;49;4;20;038;Bourg-l'Évêque;251;4;255
52;Pays de la Loire;49;3;15;041;Brain-sur-Allonnes;2003;32;2035
52;Pays de la Loire;49;3;15;045;La Breille-les-Pins;602;13;615
52;Pays de la Loire;49;1;05;048;Briollay;2967;39;3006
52;Pays de la Loire;49;1;86;050;Brissac Loire Aubance;10807;278;11085
52;Pays de la Loire;49;3;14;053;Brossay;364;4;368
52;Pays de la Loire;49;4;20;054;Candé;2834;62;2896
52;Pays de la Loire;49;1;05;055;Cantenay-Épinard;2303;36;2339
52;Pays de la Loire;49;4;20;056;Carbay;260;6;266
52;Pays de la Loire;49;2;13;057;Cernusson;354;6;360
52;Pays de la Loire;49;2;13;058;Les Cerqueux;873;9;882
52;Pays de la Loire;49;4;20;061;Challain-la-Potherie;808;19;827
52;Pays de la Loire;49;1;10;063;Chalonnes-sur-Loire;6535;171;6706
52;Pays de la Loire;49;4;21;064;Chambellay;403;10;413
52;Pays de la Loire;49;1;10;068;Champtocé-sur-Loire;1868;30;1898
52;Pays de la Loire;49;2;13;070;Chanteloup-les-Bois;700;10;710
52;Pays de la Loire;49;1;06;076;La Chapelle-Saint-Laud;762;7;769
52;Pays de la Loire;49;1;10;082;Chaudefonds-sur-Layon;952;15;967
52;Pays de la Loire;49;4;20;089;Chazé-sur-Argos;1055;28;1083
52;Pays de la Loire;49;1;21;090;Cheffes;974;12;986
52;Pays de la Loire;49;2;11;092;Chemillé-en-Anjou;21392;590;21982
52;Pays de la Loire;49;4;21;067;Chenillé-Champteussé;351;6;357
52;Pays de la Loire;49;2;99;099;Cholet;53917;1870;55787
52;Pays de la Loire;49;3;14;100;Cizay-la-Madeleine;464;4;468
52;Pays de la Loire;49;2;13;102;Cléré-sur-Layon;341;6;347
52;Pays de la Loire;49;1;06;107;Cornillé-les-Caves;470;16;486
52;Pays de la Loire;49;2;13;109;Coron;1593;32;1625
52;Pays de la Loire;49;1;06;110;Corzé;1841;15;1856
52;Pays de la Loire;49;3;14;112;Le Coudray-Macouard;923;27;950
52;Pays de la Loire;49;3;14;113;Courchamps;506;10;516
52;Pays de la Loire;49;3;15;114;Courléon;147;4;151
52;Pays de la Loire;49;1;10;120;Denée;1394;24;1418
52;Pays de la Loire;49;3;14;121;Dénezé-sous-Doué;470;9;479
52;Pays de la Loire;49;3;19;123;Distré;1713;57;1770
52;Pays de la Loire;49;3;14;125;Doué-en-Anjou;11005;273;11278
52;Pays de la Loire;49;1;21;127;Durtal;3387;72;3459
52;Pays de la Loire;49;1;05;129;Écouflant;4159;55;4214
52;Pays de la Loire;49;1;05;130;Écuillé;639;7;646
52;Pays de la Loire;49;3;14;131;Épieds;761;13;774
52;Pays de la Loire;49;4;87;367;Erdre-en-Anjou;5746;83;5829
52;Pays de la Loire;49;1;21;132;Étriché;1549;17;1566
52;Pays de la Loire;49;1;05;135;Feneu;2193;38;2231
52;Pays de la Loire;49;3;19;140;Fontevraud-l'Abbaye;1536;26;1562
52;Pays de la Loire;49;1;17;167;Les Garennes sur Loire;4508;121;4629
52;Pays de la Loire;49;3;85;261;Gennes-Val-de-Loire;8724;165;8889
52;Pays de la Loire;49;4;21;155;Grez-Neuville;1441;39;1480
52;Pays de la Loire;49;4;21;080;Les Hauts-d'Anjou;8759;188;8947
52;Pays de la Loire;49;1;06;174;Huillé-Lézigné;1322;18;1340
52;Pays de la Loire;49;1;10;160;Ingrandes-Le Fresne sur Loire;2624;56;2680
52;Pays de la Loire;49;4;21;161;La Jaille-Yvon;321;10;331
52;Pays de la Loire;49;1;06;163;Jarzé Villages;2742;28;2770
52;Pays de la Loire;49;4;21;170;Juvardeil;815;14;829
52;Pays de la Loire;49;3;15;171;La Lande-Chasles;124;1;125
52;Pays de la Loire;49;4;21;176;Le Lion-d'Angers;4924;72;4996
52;Pays de la Loire;49;4;20;178;Loiré;864;28;892
52;Pays de la Loire;49;1;07;307;Loire-Authion;15702;592;16294
52;Pays de la Loire;49;3;15;180;Longué-Jumelles;6794;119;6913
52;Pays de la Loire;49;1;89;200;Longuenée-en-Anjou;6331;168;6499
52;Pays de la Loire;49;3;14;182;Louresse-Rochemenier;864;16;880
52;Pays de la Loire;49;2;13;373;Lys-Haut-Layon;7880;186;8066
52;Pays de la Loire;49;1;06;188;Marcé;841;14;855
52;Pays de la Loire;49;2;16;244;Mauges-sur-Loire;18284;446;18730
52;Pays de la Loire;49;2;13;192;Maulévrier;3176;77;3253
52;Pays de la Loire;49;2;18;193;Le May-sur-Èvre;3805;70;3875
52;Pays de la Loire;49;3;08;194;Mazé-Milon;5799;101;5900
52;Pays de la Loire;49;2;13;195;Mazières-en-Mauges;1177;27;1204
52;Pays de la Loire;49;3;07;201;La Ménitré;2072;34;2106
52;Pays de la Loire;49;4;21;205;Miré;984;12;996
52;Pays de la Loire;49;1;21;209;Montigné-lès-Rairies;423;3;426
52;Pays de la Loire;49;2;13;211;Montilliers;1223;30;1253
52;Pays de la Loire;49;3;14;215;Montreuil-Bellay;3822;249;4071
52;Pays de la Loire;49;1;04;214;Montreuil-Juigné;7517;147;7664
52;Pays de la Loire;49;1;06;216;Montreuil-sur-Loir;569;6;575
52;Pays de la Loire;49;4;21;217;Montreuil-sur-Maine;759;11;770
52;Pays de la Loire;49;2;09;218;Montrevault-sur-Èvre;15859;306;16165
52;Pays de la Loire;49;3;19;219;Montsoreau;446;8;454
52;Pays de la Loire;49;1;21;220;Morannes sur Sarthe-Daumeray;3664;55;3719
52;Pays de la Loire;49;3;15;221;Mouliherne;849;23;872
52;Pays de la Loire;49;1;11;222;Mozé-sur-Louet;1991;43;2034
52;Pays de la Loire;49;1;17;223;Mûrs-Erigné;5522;98;5620
52;Pays de la Loire;49;3;15;224;Neuillé;992;14;1006
52;Pays de la Loire;49;3;08;228;Noyant-Villages;5633;170;5803
52;Pays de la Loire;49;2;13;231;Nuaillé;1469;39;1508
52;Pays de la Loire;49;4;20;248;Ombrée d'Anjou;8998;251;9249
52;Pays de la Loire;49;2;16;069;Orée d'Anjou;16413;265;16678
52;Pays de la Loire;49;3;19;235;Parnay;431;15;446
52;Pays de la Loire;49;2;13;236;Passavant-sur-Layon;125;5;130
52;Pays de la Loire;49;3;08;237;La Pellerine;139;2;141
52;Pays de la Loire;49;2;13;240;La Plaine;1017;34;1051
52;Pays de la Loire;49;1;07;241;Le Plessis-Grammoire;2381;57;2438
52;Pays de la Loire;49;1;17;246;Les Ponts-de-Cé;12679;573;13252
52;Pays de la Loire;49;1;10;247;La Possonnière;2437;41;2478
52;Pays de la Loire;49;3;14;253;Le Puy-Notre-Dame;1192;21;1213
52;Pays de la Loire;49;1;21;257;Les Rairies;1013;16;1029
52;Pays de la Loire;49;1;06;377;Rives-du-Loir-en-Anjou;5560;90;5650
52;Pays de la Loire;49;1;10;259;Rochefort-sur-Loire;2355;41;2396
52;Pays de la Loire;49;2;18;260;La Romagne;1879;91;1970
52;Pays de la Loire;49;3;19;262;Rou-Marson;664;9;673
52;Pays de la Loire;49;4;10;266;Saint-Augustin-des-Bois;1218;28;1246
52;Pays de la Loire;49;1;06;267;Saint-Barthélemy-d'Anjou;9195;238;9433
52;Pays de la Loire;49;2;18;269;Saint-Christophe-du-Bois;2755;57;2812
52;Pays de la Loire;49;1;03;271;Saint-Clément-de-la-Place;2131;27;2158
52;Pays de la Loire;49;3;15;272;Saint-Clément-des-Levées;1106;20;1126
52;Pays de la Loire;49;1;10;283;Saint-Georges-sur-Loire;3610;39;3649
52;Pays de la Loire;49;1;10;284;Saint-Germain-des-Prés;1398;21;1419
52;Pays de la Loire;49;1;17;288;Saint-Jean-de-la-Croix;229;6;235
52;Pays de la Loire;49;3;14;291;Saint-Just-sur-Dive;389;5;394
52;Pays de la Loire;49;1;03;294;Saint-Lambert-la-Potherie;2843;29;2872
52;Pays de la Loire;49;1;03;298;Saint-Léger-de-Linières;3597;62;3659
52;Pays de la Loire;49;2;18;299;Saint-Léger-sous-Cholet;2930;89;3019
52;Pays de la Loire;49;3;14;302;Saint-Macaire-du-Bois;457;5;462
52;Pays de la Loire;49;1;03;306;Saint-Martin-du-Fouilloux;1674;36;1710
52;Pays de la Loire;49;1;17;308;Saint-Melaine-sur-Aubance;2063;56;2119
52;Pays de la Loire;49;2;13;310;Saint-Paul-du-Bois;589;14;603
52;Pays de la Loire;49;3;15;311;Saint-Philbert-du-Peuple;1309;27;1336
52;Pays de la Loire;49;4;10;321;Saint-Sigismond;381;8;389
52;Pays de la Loire;49;1;02;278;Sainte-Gemmes-sur-Loire;3406;261;3667
52;Pays de la Loire;49;1;07;326;Sarrigné;817;19;836
52;Pays de la Loire;49;3;19;328;Saumur;26734;967;27701
52;Pays de la Loire;49;1;03;329;Savennières;1338;23;1361
52;Pays de la Loire;49;4;21;330;Sceaux-d'Anjou;1195;14;1209
52;Pays de la Loire;49;4;20;331;Segré-en-Anjou Bleu;17562;826;18388
52;Pays de la Loire;49;2;18;332;La Séguinière;4150;78;4228
52;Pays de la Loire;49;1;06;333;Seiches-sur-le-Loir;2978;42;3020
52;Pays de la Loire;49;1;06;334;Sermaise;329;5;334
52;Pays de la Loire;49;2;18;301;Sèvremoine;25414;569;25983
52;Pays de la Loire;49;2;13;336;Somloire;889;16;905
52;Pays de la Loire;49;1;17;338;Soulaines-sur-Aubance;1423;29;1452
52;Pays de la Loire;49;1;05;339;Soulaire-et-Bourg;1495;31;1526
52;Pays de la Loire;49;3;19;341;Souzay-Champigny;761;23;784
52;Pays de la Loire;49;1;11;086;Terranjou;3967;83;4050
52;Pays de la Loire;49;2;13;343;La Tessoualle;3198;71;3269
52;Pays de la Loire;49;4;21;344;Thorigné-d'Anjou;1226;25;1251
52;Pays de la Loire;49;1;21;347;Tiercé;4381;72;4453
52;Pays de la Loire;49;2;13;352;Toutlemonde;1334;26;1360
52;Pays de la Loire;49;1;07;353;Trélazé;14658;152;14810
52;Pays de la Loire;49;2;13;355;Trémentines;3005;54;3059
52;Pays de la Loire;49;3;14;003;Tuffalun;1772;38;1810
52;Pays de la Loire;49;3;19;358;Turquant;576;14;590
52;Pays de la Loire;49;3;14;359;Les Ulmes;579;15;594
52;Pays de la Loire;49;4;10;183;Val d'Erdre-Auxence;4892;60;4952
52;Pays de la Loire;49;1;88;292;Val-du-Layon;3402;51;3453
52;Pays de la Loire;49;3;15;361;Varennes-sur-Loire;1839;40;1879
52;Pays de la Loire;49;3;19;362;Varrains;1221;50;1271
52;Pays de la Loire;49;3;14;364;Vaudelnay;1143;20;1163
52;Pays de la Loire;49;3;15;368;Vernantes;1997;26;2023
52;Pays de la Loire;49;3;15;369;Vernoil-le-Fourrier;1266;19;1285
52;Pays de la Loire;49;3;19;370;Verrie;480;7;487
52;Pays de la Loire;49;1;06;323;Verrières-en-Anjou;7153;292;7445
52;Pays de la Loire;49;2;13;371;Vezins;1717;31;1748
52;Pays de la Loire;49;3;15;374;Villebernier;1490;34;1524
52;Pays de la Loire;49;3;15;378;Vivy;2582;36;2618
52;Pays de la Loire;49;2;13;381;Yzernay;1841;30;1871
28;Normandie;50;4;22;002;Agneaux;4027;509;4536
28;Normandie;50;3;01;003;Agon-Coutainville;2791;95;2886
28;Normandie;50;4;18;004;Airel;547;3;550
28;Normandie;50;4;18;006;Amigny;147;5;152
28;Normandie;50;1;03;008;Anctoville-sur-Boscq;450;26;476
28;Normandie;50;2;26;013;Anneville-en-Saire;390;8;398
28;Normandie;50;3;20;015;Annoville;672;11;683
28;Normandie;50;3;05;016;Appeville;178;2;180
28;Normandie;50;1;19;019;Aucey-la-Plaine;427;6;433
28;Normandie;50;2;05;021;Audouville-la-Hubert;79;1;80
28;Normandie;50;2;26;022;Aumeville-Lestre;114;3;117
28;Normandie;50;4;05;023;Auvers;675;10;685
28;Normandie;50;3;01;024;Auxais;174;3;177
28;Normandie;50;1;84;025;Avranches;10155;556;10711
28;Normandie;50;2;25;026;Azeville;85;1;86
28;Normandie;50;1;02;027;Bacilly;935;25;960
28;Normandie;50;3;20;028;La Baleine;91;1;92
28;Normandie;50;1;16;029;Barenton;1172;65;1237
28;Normandie;50;2;26;030;Barfleur;570;10;580
28;Normandie;50;2;17;031;Barneville-Carteret;2231;57;2288
28;Normandie;50;4;23;032;La Barre-de-Semilly;1000;39;1039
28;Normandie;50;2;17;033;Baubigny;145;4;149
28;Normandie;50;4;23;034;Baudre;539;18;557
28;Normandie;50;3;05;036;Baupte;431;8;439
28;Normandie;50;1;03;038;Beauchamps;408;11;419
28;Normandie;50;4;09;039;Beaucoudray;132;3;135
28;Normandie;50;1;16;040;Beauficel;135;6;141
28;Normandie;50;1;19;042;Beauvoir;423;5;428
28;Normandie;50;3;20;044;Belval;315;1;316
28;Normandie;50;2;17;045;Benoîtville;617;23;640
28;Normandie;50;4;18;046;Bérigny;425;6;431
28;Normandie;50;4;27;048;Beslon;560;9;569
28;Normandie;50;2;04;049;Besneville;665;15;680
28;Normandie;50;4;09;050;Beuvrigny;138;0;138
28;Normandie;50;2;05;052;Beuzeville-la-Bastille;144;2;146
28;Normandie;50;4;09;054;Biéville;189;5;194
28;Normandie;50;2;04;055;Biniville;114;2;116
28;Normandie;50;3;01;058;Blainville-sur-Mer;1653;59;1712
28;Normandie;50;2;05;059;Blosville;313;1;314
28;Normandie;50;4;27;060;La Bloutière;428;8;436
28;Normandie;50;1;27;062;Boisyvon;113;0;113
28;Normandie;50;2;04;064;La Bonneville;186;7;193
28;Normandie;50;4;27;069;Bourguenolles;344;12;356
28;Normandie;50;4;23;546;Bourgvallées;3213;69;3282
28;Normandie;50;2;05;070;Boutteville;73;5;78
28;Normandie;50;3;10;072;Brainville;215;7;222
28;Normandie;50;1;15;074;Brécey;2120;147;2267
28;Normandie;50;1;03;076;Bréhal;3410;87;3497
28;Normandie;50;2;24;077;Bretteville;1074;46;1120
28;Normandie;50;3;11;078;Bretteville-sur-Ay;382;8;390
28;Normandie;50;2;04;079;Breuville;422;6;428
28;Normandie;50;1;03;081;Bréville-sur-Mer;778;29;807
28;Normandie;50;2;04;082;Bricquebec-en-Cotentin;5899;154;6053
28;Normandie;50;2;17;083;Bricquebosq;588;7;595
28;Normandie;50;3;10;084;Bricqueville-la-Blouette;554;18;572
28;Normandie;50;1;03;085;Bricqueville-sur-Mer;1212;40;1252
28;Normandie;50;2;26;086;Brillevast;325;4;329
28;Normandie;50;2;25;087;Brix;2131;52;2183
28;Normandie;50;1;16;088;Brouains;136;2;138
28;Normandie;50;1;21;090;Buais-Les-Monts;623;8;631
28;Normandie;50;3;10;092;Cambernon;710;15;725
28;Normandie;50;3;20;093;Cametours;423;6;429
28;Normandie;50;3;10;094;Camprond;411;9;420
28;Normandie;50;4;23;095;Canisy;1796;56;1852
28;Normandie;50;2;26;096;Canteloup;208;8;216
28;Normandie;50;2;11;097;Canville-la-Rocque;129;2;131
28;Normandie;50;4;23;098;Carantilly;638;15;653
28;Normandie;50;4;83;099;Carentan-les-Marais;10118;188;10306
28;Normandie;50;2;26;101;Carneville;236;6;242
28;Normandie;50;1;02;102;Carolles;744;19;763
28;Normandie;50;2;04;105;Catteville;99;5;104
28;Normandie;50;4;18;106;Cavigny;263;2;265
28;Normandie;50;1;19;108;Céaux;422;14;436
28;Normandie;50;1;03;109;Cérences;1819;40;1859
28;Normandie;50;4;18;110;Cerisy-la-Forêt;1034;20;1054
28;Normandie;50;3;20;111;Cerisy-la-Salle;1043;19;1062
28;Normandie;50;1;15;112;La Chaise-Baudouin;471;8;479
28;Normandie;50;1;02;117;Champeaux;360;12;372
28;Normandie;50;4;27;118;Champrepus;337;7;344
28;Normandie;50;1;03;120;Chanteloup;356;4;360
28;Normandie;50;1;27;121;La Chapelle-Cécelin;248;4;252
28;Normandie;50;1;15;124;La Chapelle-Urée;158;3;161
28;Normandie;50;1;16;514;Chaulieu;295;1;296
28;Normandie;50;1;02;126;Chavoy;128;7;135
28;Normandie;50;2;98;129;Cherbourg-en-Cotentin;79200;2366;81566
28;Normandie;50;4;27;130;Chérencé-le-Héron;409;6;415
28;Normandie;50;2;26;135;Clitourps;208;3;211
28;Normandie;50;4;27;137;La Colombe;631;14;645
28;Normandie;50;2;04;138;Colomby;537;10;547
28;Normandie;50;4;09;139;Condé-sur-Vire;4027;162;4189
28;Normandie;50;1;03;143;Coudeville-sur-Mer;856;34;890
28;Normandie;50;1;27;144;Coulouvray-Boisbenâtre;559;3;562
28;Normandie;50;3;10;145;Courcy;596;13;609
28;Normandie;50;1;19;146;Courtils;229;2;231
28;Normandie;50;3;10;147;Coutances;8501;1204;9705
28;Normandie;50;4;18;148;Couvains;507;4;511
28;Normandie;50;2;08;149;Couville;1143;16;1159
28;Normandie;50;2;26;150;Crasville;242;2;244
28;Normandie;50;3;11;151;Créances;2137;29;2166
28;Normandie;50;1;15;152;Les Cresnays;230;3;233
28;Normandie;50;1;19;155;Crollon;302;8;310
28;Normandie;50;2;04;156;Crosville-sur-Douve;63;0;63
28;Normandie;50;1;15;158;Cuves;283;8;291
28;Normandie;50;4;23;159;Dangy;672;15;687
28;Normandie;50;4;18;161;Le Dézert;589;10;599
28;Normandie;50;2;24;162;Digosville;1546;51;1597
28;Normandie;50;4;09;164;Domjean;1038;28;1066
28;Normandie;50;1;13;165;Donville-les-Bains;3166;90;3256
28;Normandie;50;3;11;166;Doville;321;15;336
28;Normandie;50;1;02;167;Dragey-Ronthon;824;18;842
28;Normandie;50;1;19;168;Ducey-Les Chéris;2786;61;2847
28;Normandie;50;2;25;169;Écausseville;102;1;103
28;Normandie;50;2;25;172;Émondeville;352;11;363
28;Normandie;50;1;03;174;Équilly;195;9;204
28;Normandie;50;2;25;175;Éroudeville;222;9;231
28;Normandie;50;2;04;176;L' Étang-Bertrand;341;14;355
28;Normandie;50;2;04;177;Étienville;371;7;378
28;Normandie;50;2;26;178;Fermanville;1281;23;1304
28;Normandie;50;3;01;181;Feugères;333;8;341
28;Normandie;50;3;11;182;La Feuillie;270;12;282
28;Normandie;50;2;17;183;Fierville-les-Mines;339;6;345
28;Normandie;50;2;17;184;Flamanville;1759;23;1782
28;Normandie;50;4;27;185;Fleury;1035;24;1059
28;Normandie;50;2;25;186;Flottemanville;196;7;203
28;Normandie;50;1;03;188;Folligny;1089;28;1117
28;Normandie;50;2;25;190;Fontenay-sur-Mer;178;3;181
28;Normandie;50;4;09;192;Fourneaux;146;0;146
28;Normandie;50;1;16;193;Le Fresne-Poret;216;2;218
28;Normandie;50;2;25;194;Fresville;367;8;375
28;Normandie;50;1;16;195;Gathemo;245;2;247
28;Normandie;50;2;26;196;Gatteville-le-Phare;490;15;505
28;Normandie;50;3;20;197;Gavray-sur-Sienne;1966;28;1994
28;Normandie;50;3;01;198;Geffosses;440;5;445
28;Normandie;50;1;02;199;Genêts;435;6;441
28;Normandie;50;1;16;200;Ger;806;8;814
28;Normandie;50;1;15;205;La Godefroy;275;7;282
28;Normandie;50;2;04;207;Golleville;174;2;176
28;Normandie;50;3;01;208;Gonfreville;151;2;153
28;Normandie;50;2;26;209;Gonneville-Le Theil;1553;45;1598
28;Normandie;50;3;01;210;Gorges;349;8;357
28;Normandie;50;4;09;214;Gouvets;270;7;277
28;Normandie;50;3;82;215;Gouville-sur-Mer;3173;84;3257
28;Normandie;50;4;18;216;Graignes-Mesnil-Angot;802;104;906
28;Normandie;50;1;15;217;Le Grand-Celland;586;10;596
28;Normandie;50;1;21;391;Grandparigny;2682;88;2770
28;Normandie;50;1;13;218;Granville;12580;665;13245
28;Normandie;50;3;10;219;Gratot;656;12;668
28;Normandie;50;3;20;221;Grimesnil;61;2;63
28;Normandie;50;1;03;115;Le Grippon;370;11;381
28;Normandie;50;2;17;222;Grosville;787;21;808
28;Normandie;50;4;27;225;Le Guislain;135;1;136
28;Normandie;50;2;14;041;La Hague;11634;364;11998
28;Normandie;50;2;25;227;Le Ham;307;4;311
28;Normandie;50;3;20;228;Hambye;1150;27;1177
28;Normandie;50;1;21;229;Hamelin;92;1;93
28;Normandie;50;2;08;230;Hardinvast;881;34;915
28;Normandie;50;3;01;232;Hauteville-la-Guichard;469;18;487
28;Normandie;50;3;20;231;Hauteville-sur-Mer;697;20;717
28;Normandie;50;2;04;233;Hautteville-Bocage;155;5;160
28;Normandie;50;3;11;236;La Haye;4006;118;4124
28;Normandie;50;4;27;234;La Haye-Bellefond;83;0;83
28;Normandie;50;2;17;235;La Haye-d'Ectot;257;5;262
28;Normandie;50;1;03;237;La Haye-Pesnel;1330;26;1356
28;Normandie;50;2;17;238;Héauville;468;6;474
28;Normandie;50;2;17;240;Helleville;525;7;532
28;Normandie;50;2;25;241;Hémevez;181;5;186
28;Normandie;50;3;10;243;Heugueville-sur-Sienne;552;7;559
28;Normandie;50;2;05;246;Hiesville;65;1;66
28;Normandie;50;1;03;247;Hocquigny;184;5;189
28;Normandie;50;2;25;251;Huberville;369;10;379
28;Normandie;50;1;03;252;Hudimesnil;900;16;916
28;Normandie;50;1;19;253;Huisnes-sur-Mer;185;9;194
28;Normandie;50;1;15;256;Isigny-le-Buat;3319;83;3402
28;Normandie;50;2;25;258;Joganville;109;3;112
28;Normandie;50;1;19;259;Juilley;656;27;683
28;Normandie;50;1;02;066;Jullouville;2312;71;2383
28;Normandie;50;1;15;260;Juvigny les Vallées;1700;32;1732
28;Normandie;50;4;09;261;Lamberville;174;1;175
28;Normandie;50;4;27;262;La Lande-d'Airou;518;6;524
28;Normandie;50;1;21;263;Lapenty;369;10;379
28;Normandie;50;3;11;265;Laulne;189;2;191
28;Normandie;50;3;20;266;Lengronne;423;10;433
28;Normandie;50;3;11;267;Lessay;2245;39;2284
28;Normandie;50;2;25;268;Lestre;248;5;253
28;Normandie;50;2;05;269;Liesville-sur-Douve;204;6;210
28;Normandie;50;2;25;270;Lieusaint;418;13;431
28;Normandie;50;1;15;271;Lingeard;82;1;83
28;Normandie;50;3;20;272;Lingreville;1011;21;1032
28;Normandie;50;1;21;274;Les Loges-Marchis;992;158;1150
28;Normandie;50;1;15;275;Les Loges-sur-Brécey;134;7;141
28;Normandie;50;1;02;276;Lolif;566;19;585
28;Normandie;50;1;03;277;Longueville;604;15;619
28;Normandie;50;1;03;278;Le Loreur;275;6;281
28;Normandie;50;4;22;279;Le Lorey;604;15;619
28;Normandie;50;1;03;281;La Lucerne-d'Outremer;780;19;799
28;Normandie;50;1;03;282;Le Luot;273;9;282
28;Normandie;50;4;23;283;La Luzerne;76;1;77
28;Normandie;50;2;04;285;Magneville;330;4;334
28;Normandie;50;1;02;288;Marcey-les-Grèves;1284;29;1313
28;Normandie;50;3;01;289;Marchésieux;716;12;728
28;Normandie;50;1;19;290;Marcilly;328;10;338
28;Normandie;50;4;27;291;Margueray;131;4;135
28;Normandie;50;4;22;292;Marigny-Le-Lozon;2645;58;2703
28;Normandie;50;2;08;294;Martinvast;1266;35;1301
28;Normandie;50;4;27;295;Maupertuis;137;2;139
28;Normandie;50;2;26;296;Maupertus-sur-Mer;220;9;229
28;Normandie;50;4;18;297;La Meauffe;1040;30;1070
28;Normandie;50;4;05;298;Méautis;656;12;668
28;Normandie;50;2;17;299;Le Mesnil;219;7;226
28;Normandie;50;1;15;300;Le Mesnil-Adelée;169;7;176
28;Normandie;50;4;22;302;Le Mesnil-Amey;277;7;284
28;Normandie;50;2;24;305;Le Mesnil-au-Val;728;18;746
28;Normandie;50;1;03;304;Le Mesnil-Aubert;186;7;193
28;Normandie;50;4;22;310;Le Mesnil-Eury;174;3;177
28;Normandie;50;3;20;311;Le Mesnil-Garnier;228;8;236
28;Normandie;50;1;15;312;Le Mesnil-Gilbert;136;3;139
28;Normandie;50;1;19;317;Le Mesnil-Ozenne;268;3;271
28;Normandie;50;4;18;321;Le Mesnil-Rouxelin;508;21;529
28;Normandie;50;4;18;324;Le Mesnil-Véneron;123;2;125
28;Normandie;50;3;20;326;Le Mesnil-Villeman;235;1;236
28;Normandie;50;1;21;315;Le Mesnillard;260;7;267
28;Normandie;50;1;03;327;La Meurdraquière;172;4;176
28;Normandie;50;3;11;328;Millières;799;9;808
28;Normandie;50;2;17;332;Les Moitiers-d'Allonne;690;15;705
28;Normandie;50;1;19;353;Le Mont-Saint-Michel;30;0;30
28;Normandie;50;4;27;334;Montabot;280;3;283
28;Normandie;50;2;25;335;Montaigu-la-Brisette;510;15;525
28;Normandie;50;3;20;336;Montaigu-les-Bois;226;3;229
28;Normandie;50;4;27;338;Montbray;308;3;311
28;Normandie;50;3;01;340;Montcuit;185;4;189
28;Normandie;50;2;25;341;Montebourg;2096;102;2198
28;Normandie;50;2;26;342;Montfarville;808;17;825
28;Normandie;50;3;10;345;Monthuchon;680;32;712
28;Normandie;50;1;21;347;Montjoie-Saint-Martin;243;4;247
28;Normandie;50;3;20;349;Montmartin-sur-Mer;1337;45;1382
28;Normandie;50;3;20;350;Montpinchon;529;9;538
28;Normandie;50;4;09;351;Montrabot;85;2;87
28;Normandie;50;4;22;352;Montreuil-sur-Lozon;330;7;337
28;Normandie;50;3;11;273;Montsenelle;1407;20;1427
28;Normandie;50;4;18;356;Moon-sur-Elle;842;12;854
28;Normandie;50;4;27;357;Morigny;84;1;85
28;Normandie;50;1;16;359;Mortain-Bocage;2942;266;3208
28;Normandie;50;2;04;360;Morville;272;12;284
28;Normandie;50;1;03;361;La Mouche;243;6;249
28;Normandie;50;1;21;362;Moulines;291;5;296
28;Normandie;50;4;09;363;Moyon Villages;1478;37;1515
28;Normandie;50;3;01;364;Muneville-le-Bingard;693;8;701
28;Normandie;50;1;03;365;Muneville-sur-Mer;475;11;486
28;Normandie;50;3;01;368;Nay;70;2;72
28;Normandie;50;2;04;369;Négreville;810;21;831
28;Normandie;50;2;04;370;Néhou;626;11;637
28;Normandie;50;1;16;371;Le Neufbourg;414;12;426
28;Normandie;50;3;11;372;Neufmesnil;193;3;196
28;Normandie;50;2;05;373;Neuville-au-Plain;90;4;94
28;Normandie;50;2;04;374;Neuville-en-Beaumont;35;1;36
28;Normandie;50;3;10;376;Nicorps;409;17;426
28;Normandie;50;3;20;378;Notre-Dame-de-Cenilly;648;9;657
28;Normandie;50;1;15;379;Notre-Dame-de-Livoye;147;3;150
28;Normandie;50;2;08;382;Nouainville;603;17;620
28;Normandie;50;2;26;384;Octeville-l'Avenel;218;3;221
28;Normandie;50;2;04;387;Orglandes;371;0;371
28;Normandie;50;3;10;388;Orval sur Sienne;1150;40;1190
28;Normandie;50;3;20;389;Ouville;448;12;460
28;Normandie;50;2;25;390;Ozeville;155;2;157
28;Normandie;50;1;88;535;Le Parc;911;26;937
28;Normandie;50;4;27;393;Percy-en-Normandie;2583;105;2688
28;Normandie;50;3;01;394;Périers;2259;30;2289
28;Normandie;50;2;26;395;La Pernelle;259;4;263
28;Normandie;50;1;16;397;Perriers-en-Beauficel;216;3;219
28;Normandie;50;4;09;398;Le Perron;207;2;209
28;Normandie;50;1;15;399;Le Petit-Celland;189;4;193
28;Normandie;50;2;86;400;Picauville;3278;39;3317
28;Normandie;50;2;17;401;Pierreville;735;14;749
28;Normandie;50;2;17;402;Les Pieux;3223;89;3312
28;Normandie;50;3;11;403;Pirou;1438;36;1474
28;Normandie;50;3;11;405;Le Plessis-Lastelle;236;8;244
28;Normandie;50;1;19;407;Poilley;882;25;907
28;Normandie;50;4;18;409;Pont-Hébert;1987;210;2197
28;Normandie;50;1;19;408;Pontaubault;555;7;562
28;Normandie;50;1;19;410;Pontorson;4342;78;4420
28;Normandie;50;1;02;411;Ponts;655;16;671
28;Normandie;50;2;81;412;Port-Bail-sur-Mer;2588;69;2657
28;Normandie;50;1;19;413;Précey;550;6;556
28;Normandie;50;2;26;417;Quettehou;1787;26;1813
28;Normandie;50;3;20;419;Quettreville-sur-Sienne;3194;67;3261
28;Normandie;50;4;23;420;Quibou;914;24;938
28;Normandie;50;2;25;421;Quinéville;273;6;279
28;Normandie;50;3;01;422;Raids;192;0;192
28;Normandie;50;4;18;423;Rampan;204;6;210
28;Normandie;50;2;04;425;Rauville-la-Bigot;1153;36;1189
28;Normandie;50;2;04;426;Rauville-la-Place;376;6;382
28;Normandie;50;1;15;428;Reffuveille;509;4;513
28;Normandie;50;3;10;429;Regnéville-sur-Mer;736;34;770
28;Normandie;50;2;04;430;Reigneville-Bocage;38;3;41
28;Normandie;50;4;85;431;Remilly Les Marais;1103;13;1116
28;Normandie;50;2;26;433;Réville;1038;16;1054
28;Normandie;50;2;04;435;Rocheville;604;15;619
28;Normandie;50;1;16;436;Romagny Fontenay;1318;44;1362
28;Normandie;50;3;20;437;Roncey;804;11;815
28;Normandie;50;2;17;442;Le Rozel;252;6;258
28;Normandie;50;1;19;443;Sacey;516;10;526
28;Normandie;50;4;09;444;Saint-Amand-Villages;2529;58;2587
28;Normandie;50;4;05;445;Saint-André-de-Bohon;338;4;342
28;Normandie;50;4;18;446;Saint-André-de-l'Épine;548;13;561
28;Normandie;50;1;21;448;Saint-Aubin-de-Terregatte;683;15;698
28;Normandie;50;1;03;447;Saint-Aubin-des-Préaux;438;13;451
28;Normandie;50;1;16;450;Saint-Barthélemy;332;7;339
28;Normandie;50;1;15;451;Saint-Brice;131;2;133
28;Normandie;50;1;21;452;Saint-Brice-de-Landelles;687;23;710
28;Normandie;50;2;17;454;Saint-Christophe-du-Foc;428;9;437
28;Normandie;50;4;18;455;Saint-Clair-sur-l'Elle;953;20;973
28;Normandie;50;1;16;456;Saint-Clément-Rancoudray;550;8;558
28;Normandie;50;2;25;461;Saint-Cyr;181;12;193
28;Normandie;50;1;16;462;Saint-Cyr-du-Bailleul;399;9;408
28;Normandie;50;3;20;463;Saint-Denis-le-Gast;534;10;544
28;Normandie;50;3;20;464;Saint-Denis-le-Vêtu;620;5;625
28;Normandie;50;2;25;467;Saint-Floxel;491;13;504
28;Normandie;50;4;18;468;Saint-Fromond;769;15;784
28;Normandie;50;4;18;473;Saint-Georges-d'Elle;401;5;406
28;Normandie;50;2;17;471;Saint-Georges-de-la-Rivière;278;11;289
28;Normandie;50;1;15;472;Saint-Georges-de-Livoye;198;7;205
28;Normandie;50;1;16;474;Saint-Georges-de-Rouelley;551;11;562
28;Normandie;50;4;18;475;Saint-Georges-Montcocq;919;44;963
28;Normandie;50;4;18;476;Saint-Germain-d'Elle;224;1;225
28;Normandie;50;2;25;478;Saint-Germain-de-Tournebut;441;8;449
28;Normandie;50;2;05;479;Saint-Germain-de-Varreville;113;4;117
28;Normandie;50;2;17;480;Saint-Germain-le-Gaillard;748;22;770
28;Normandie;50;3;11;481;Saint-Germain-sur-Ay;909;19;928
28;Normandie;50;3;01;482;Saint-Germain-sur-Sèves;165;3;168
28;Normandie;50;4;22;483;Saint-Gilles;923;35;958
28;Normandie;50;1;21;484;Saint-Hilaire-du-Harcouët;6094;373;6467
28;Normandie;50;2;04;486;Saint-Jacques-de-Néhou;608;11;619
28;Normandie;50;1;21;487;Saint-James;4954;114;5068
28;Normandie;50;4;89;492;Saint-Jean-d'Elle;2460;54;2514
28;Normandie;50;4;18;488;Saint-Jean-de-Daye;629;6;635
28;Normandie;50;1;02;489;Saint-Jean-de-la-Haize;521;14;535
28;Normandie;50;2;17;490;Saint-Jean-de-la-Rivière;350;9;359
28;Normandie;50;4;18;491;Saint-Jean-de-Savigny;446;6;452
28;Normandie;50;1;03;493;Saint-Jean-des-Champs;1410;34;1444
28;Normandie;50;1;15;495;Saint-Jean-du-Corail-des-Bois;71;5;76
28;Normandie;50;1;02;496;Saint-Jean-le-Thomas;393;8;401
28;Normandie;50;2;25;498;Saint-Joseph;792;28;820
28;Normandie;50;1;15;499;Saint-Laurent-de-Cuves;483;7;490
28;Normandie;50;1;21;500;Saint-Laurent-de-Terregatte;646;11;657
28;Normandie;50;4;99;502;Saint-Lô;19116;883;19999
28;Normandie;50;4;09;504;Saint-Louet-sur-Vire;205;1;206
28;Normandie;50;1;15;505;Saint-Loup;708;36;744
28;Normandie;50;3;01;506;Saint-Malo-de-la-Lande;479;5;484
28;Normandie;50;2;25;507;Saint-Marcouf;341;6;347
28;Normandie;50;3;01;510;Saint-Martin-d'Aubigny;595;4;599
28;Normandie;50;2;25;511;Saint-Martin-d'Audouville;131;4;135
28;Normandie;50;4;23;512;Saint-Martin-de-Bonfossé;529;9;538
28;Normandie;50;3;20;513;Saint-Martin-de-Cenilly;182;3;185
28;Normandie;50;2;05;517;Saint-Martin-de-Varreville;181;5;186
28;Normandie;50;1;27;518;Saint-Martin-le-Bouillant;318;4;322
28;Normandie;50;2;08;519;Saint-Martin-le-Gréard;515;7;522
28;Normandie;50;1;27;521;Saint-Maur-des-Bois;151;4;155
28;Normandie;50;2;17;522;Saint-Maurice-en-Cotentin;257;7;264
28;Normandie;50;1;15;525;Saint-Michel-de-Montjoie;314;1;315
28;Normandie;50;3;11;528;Saint-Nicolas-de-Pierrepont;306;12;318
28;Normandie;50;1;15;529;Saint-Nicolas-des-Bois;86;2;88
28;Normandie;50;1;19;531;Saint-Ovin;768;28;796
28;Normandie;50;1;13;532;Saint-Pair-sur-Mer;4066;150;4216
28;Normandie;50;3;11;533;Saint-Patrice-de-Claids;176;3;179
28;Normandie;50;2;17;536;Saint-Pierre-d'Arthéglise;140;0;140
28;Normandie;50;3;10;537;Saint-Pierre-de-Coutances;408;19;427
28;Normandie;50;4;18;538;Saint-Pierre-de-Semilly;444;8;452
28;Normandie;50;2;26;539;Saint-Pierre-Église;1803;25;1828
28;Normandie;50;1;02;540;Saint-Pierre-Langers;601;19;620
28;Normandie;50;1;03;541;Saint-Planchers;1350;39;1389
28;Normandie;50;1;27;542;Saint-Pois;511;12;523
28;Normandie;50;1;19;543;Saint-Quentin-sur-le-Homme;1296;30;1326
28;Normandie;50;3;11;548;Saint-Sauveur-de-Pierrepont;128;2;130
28;Normandie;50;1;03;549;Saint-Sauveur-la-Pommeraye;376;6;382
28;Normandie;50;2;04;551;Saint-Sauveur-le-Vicomte;2132;41;2173
28;Normandie;50;3;80;550;Saint-Sauveur-Villages;3588;147;3735
28;Normandie;50;3;01;552;Saint-Sébastien-de-Raids;334;6;340
28;Normandie;50;1;21;553;Saint-Senier-de-Beuvron;368;6;374
28;Normandie;50;1;15;554;Saint-Senier-sous-Avranches;1417;88;1505
28;Normandie;50;2;26;562;Saint-Vaast-la-Hougue;1730;33;1763
28;Normandie;50;4;09;563;Saint-Vigor-des-Monts;285;9;294
28;Normandie;50;4;27;453;Sainte-Cécile;816;19;835
28;Normandie;50;2;04;457;Sainte-Colombe;210;5;215
28;Normandie;50;2;26;469;Sainte-Geneviève;318;6;324
28;Normandie;50;2;05;509;Sainte-Marie-du-Mont;720;17;737
28;Normandie;50;2;05;523;Sainte-Mère-Église;3077;50;3127
28;Normandie;50;4;23;556;Sainte-Suzanne-sur-Vire;685;10;695
28;Normandie;50;1;87;565;Sartilly-Baie-Bocage;2812;56;2868
28;Normandie;50;2;25;567;Saussemesnil;884;21;905
28;Normandie;50;3;10;568;Saussey;467;15;482
28;Normandie;50;3;20;569;Savigny;446;8;454
28;Normandie;50;1;21;570;Savigny-le-Vieux;451;2;453
28;Normandie;50;2;05;571;Sébeville;34;1;35
28;Normandie;50;2;17;572;Sénoville;201;8;209
28;Normandie;50;1;19;574;Servon;278;4;282
28;Normandie;50;2;08;575;Sideville;744;13;757
28;Normandie;50;2;17;576;Siouville-Hague;1033;34;1067
28;Normandie;50;2;25;578;Sortosville;87;1;88
28;Normandie;50;2;17;577;Sortosville-en-Beaumont;313;8;321
28;Normandie;50;2;04;579;Sottevast;1385;29;1414
28;Normandie;50;2;17;580;Sotteville;470;9;479
28;Normandie;50;1;16;582;Sourdeval;3173;63;3236
28;Normandie;50;1;03;584;Subligny;390;6;396
28;Normandie;50;2;17;585;Surtainville;1180;28;1208
28;Normandie;50;2;04;587;Taillepied;21;1;22
28;Normandie;50;2;25;588;Tamerville;659;23;682
28;Normandie;50;1;19;589;Tanis;293;12;305
28;Normandie;50;1;27;590;Le Tanu;396;6;402
28;Normandie;50;1;16;591;Le Teilleul;1683;28;1711
28;Normandie;50;4;05;564;Terre-et-Marais;1295;28;1323
28;Normandie;50;4;09;592;Tessy-Bocage;2357;50;2407
28;Normandie;50;2;26;593;Teurthéville-Bocage;591;8;599
28;Normandie;50;2;08;594;Teurthéville-Hague;1059;21;1080
28;Normandie;50;4;22;239;Thèreval;1800;44;1844
28;Normandie;50;2;26;596;Théville;330;12;342
28;Normandie;50;1;15;597;Tirepied-sur-Sée;947;23;970
28;Normandie;50;2;26;598;Tocqueville;278;5;283
28;Normandie;50;2;08;599;Tollevast;1523;43;1566
28;Normandie;50;4;09;601;Torigny-les-Villes;4352;56;4408
28;Normandie;50;3;10;603;Tourville-sur-Sienne;785;24;809
28;Normandie;50;2;17;604;Tréauville;735;13;748
28;Normandie;50;4;18;606;Tribehou;533;5;538
28;Normandie;50;4;27;607;La Trinité;395;6;401
28;Normandie;50;2;05;609;Turqueville;138;3;141
28;Normandie;50;2;25;610;Urville;210;6;216
28;Normandie;50;1;02;612;Vains;722;67;789
28;Normandie;50;1;19;616;Le Val-Saint-Père;2043;81;2124
28;Normandie;50;2;26;613;Valcanville;416;10;426
28;Normandie;50;2;25;615;Valognes;6803;267;7070
28;Normandie;50;3;11;617;Varenguebec;323;2;325
28;Normandie;50;2;26;618;Varouville;266;6;272
28;Normandie;50;2;26;619;Le Vast;324;10;334
28;Normandie;50;2;25;621;Vaudreville;73;0;73
28;Normandie;50;3;10;624;La Vendelée;464;23;487
28;Normandie;50;3;20;626;Ver;374;10;384
28;Normandie;50;1;15;628;Vernix;158;4;162
28;Normandie;50;3;11;629;Vesly;725;4;729
28;Normandie;50;2;26;633;Le Vicel;121;0;121
28;Normandie;50;2;26;142;Vicq-sur-Mer;1033;13;1046
28;Normandie;50;2;26;634;Videcosville;81;1;82
28;Normandie;50;4;27;637;Villebaudon;310;3;313
28;Normandie;50;4;27;639;Villedieu-les-Poêles-Rouffigny;3878;82;3960
28;Normandie;50;4;18;641;Villiers-Fossard;643;15;658
28;Normandie;50;2;08;643;Virandeville;794;14;808
28;Normandie;50;1;13;647;Yquelon;1091;42;1133
28;Normandie;50;2;25;648;Yvetot-Bocage;1145;30;1175
44;Grand Est;51;4;23;001;Ablancourt;162;1;163
44;Grand Est;51;1;04;003;Aigny;275;5;280
44;Grand Est;51;2;22;004;Allemanche-Launay-et-Soyer;111;4;115
44;Grand Est;51;2;21;005;Allemant;164;3;167
44;Grand Est;51;4;20;006;Alliancelles;142;4;146
44;Grand Est;51;2;07;007;Ambonnay;970;25;995
44;Grand Est;51;4;20;008;Ambrières;226;11;237
44;Grand Est;51;2;22;009;Anglure;879;18;897
44;Grand Est;51;2;22;010;Angluzelles-et-Courcelles;146;4;150
44;Grand Est;51;3;06;012;Anthenay;70;1;71
44;Grand Est;51;3;06;013;Aougny;100;4;104
44;Grand Est;51;3;09;014;Arcis-le-Ponsart;313;9;322
44;Grand Est;51;1;01;015;Argers;117;1;118
44;Grand Est;51;4;20;016;Arrigny;244;4;248
44;Grand Est;51;4;23;017;Arzillières-Neuville;327;6;333
44;Grand Est;51;2;22;018;Athis;887;20;907
44;Grand Est;51;3;10;019;Aubérive;238;8;246
44;Grand Est;51;3;09;020;Aubilly;53;3;56
44;Grand Est;51;4;23;022;Aulnay-l'Aître;181;5;186
44;Grand Est;51;1;04;023;Aulnay-sur-Marne;259;6;265
44;Grand Est;51;3;02;025;Auménancourt;1048;8;1056
44;Grand Est;51;1;01;027;Auve;298;21;319
44;Grand Est;51;2;07;028;Avenay-Val-d'Or;1026;11;1037
44;Grand Est;51;2;08;029;Avize;1740;160;1900
44;Grand Est;51;2;07;030;Aÿ-Champagne;5592;92;5684
44;Grand Est;51;1;10;031;Baconnes;270;10;280
44;Grand Est;51;2;22;032;Bagneux;448;8;456
44;Grand Est;51;2;06;033;Le Baizil;253;3;256
44;Grand Est;51;2;06;034;Bannay;19;0;19
44;Grand Est;51;2;22;035;Bannes;273;3;276
44;Grand Est;51;2;21;036;Barbonne-Fayel;502;6;508
44;Grand Est;51;3;09;037;Baslieux-lès-Fismes;327;2;329
44;Grand Est;51;2;06;038;Baslieux-sous-Châtillon;191;6;197
44;Grand Est;51;4;20;039;Bassu;103;5;108
44;Grand Est;51;4;20;040;Bassuet;257;7;264
44;Grand Est;51;2;22;041;Baudement;110;5;115
44;Grand Est;51;2;06;042;Baye;410;8;418
44;Grand Est;51;3;02;043;Bazancourt;2212;26;2238
44;Grand Est;51;3;10;044;Beaumont-sur-Vesle;825;13;838
44;Grand Est;51;2;06;045;Beaunay;106;0;106
44;Grand Est;51;3;02;046;Beine-Nauroy;1010;15;1025
44;Grand Est;51;1;01;047;Belval-en-Argonne;47;3;50
44;Grand Est;51;2;06;048;Belval-sous-Châtillon;147;6;153
44;Grand Est;51;2;22;049;Bergères-lès-Vertus;615;4;619
44;Grand Est;51;2;21;050;Bergères-sous-Montmirail;123;2;125
44;Grand Est;51;3;02;051;Berméricourt;205;2;207
44;Grand Est;51;3;02;052;Berru;574;4;578
44;Grand Est;51;1;01;053;Berzieux;74;7;81
44;Grand Est;51;3;10;054;Bétheniville;1275;13;1288
44;Grand Est;51;3;15;055;Bétheny;6971;104;7075
44;Grand Est;51;2;21;056;Bethon;281;8;289
44;Grand Est;51;4;20;057;Bettancourt-la-Longue;78;2;80
44;Grand Est;51;3;14;058;Bezannes;2121;58;2179
44;Grand Est;51;4;23;059;Bignicourt-sur-Marne;343;12;355
44;Grand Est;51;4;20;060;Bignicourt-sur-Saulx;190;2;192
44;Grand Est;51;3;10;061;Billy-le-Grand;121;2;123
44;Grand Est;51;1;01;062;Binarville;99;3;102
44;Grand Est;51;2;06;063;Binson-et-Orquigny;169;2;171
44;Grand Est;51;4;23;065;Blacy;657;12;669
44;Grand Est;51;4;23;066;Blaise-sous-Arzillières;342;6;348
44;Grand Est;51;2;22;612;Blancs-Coteaux;3325;176;3501
44;Grand Est;51;4;20;068;Blesme;214;2;216
44;Grand Est;51;3;06;069;Bligny;122;1;123
44;Grand Est;51;2;21;070;Boissy-le-Repos;220;1;221
44;Grand Est;51;2;21;071;Bouchy-Saint-Genest;193;7;200
44;Grand Est;51;3;09;072;Bouilly;203;3;206
44;Grand Est;51;3;09;073;Bouleuse;212;3;215
44;Grand Est;51;3;02;074;Boult-sur-Suippe;1705;26;1731
44;Grand Est;51;3;02;075;Bourgogne-Fresne;1396;32;1428
44;Grand Est;51;2;06;076;Boursault;451;9;460
44;Grand Est;51;3;09;077;Bouvancourt;193;7;200
44;Grand Est;51;1;10;078;Bouy;567;13;580
44;Grand Est;51;2;07;079;Bouzy;921;25;946
44;Grand Est;51;4;20;080;Brandonvillers;184;1;185
44;Grand Est;51;3;09;081;Branscourt;309;5;314
44;Grand Est;51;1;01;083;Braux-Saint-Remy;86;1;87
44;Grand Est;51;1;01;082;Braux-Sainte-Cohière;96;6;102
44;Grand Est;51;4;23;084;Bréban;81;1;82
44;Grand Est;51;2;06;085;Le Breuil;387;4;391
44;Grand Est;51;3;09;086;Breuil-sur-Vesle;342;11;353
44;Grand Est;51;1;05;087;Breuvery-sur-Coole;217;8;225
44;Grand Est;51;3;02;088;Brimont;432;7;439
44;Grand Est;51;3;06;089;Brouillet;77;4;81
44;Grand Est;51;2;22;090;Broussy-le-Grand;312;12;324
44;Grand Est;51;2;21;091;Broussy-le-Petit;129;3;132
44;Grand Est;51;2;21;092;Broyes;361;4;365
44;Grand Est;51;2;08;093;Brugny-Vaudancourt;450;14;464
44;Grand Est;51;4;20;094;Brusson;184;7;191
44;Grand Est;51;4;20;095;Le Buisson;92;3;95
44;Grand Est;51;1;01;097;Bussy-le-Château;171;4;175
44;Grand Est;51;4;20;098;Bussy-le-Repos;135;4;139
44;Grand Est;51;1;05;099;Bussy-Lettrée;341;10;351
44;Grand Est;51;2;06;100;La Caure;103;2;105
44;Grand Est;51;3;02;101;Caurel;655;8;663
44;Grand Est;51;3;02;102;Cauroy-lès-Hermonville;491;8;499
44;Grand Est;51;2;22;103;La Celle-sous-Chantemerle;143;1;144
44;Grand Est;51;1;01;104;Cernay-en-Dormois;150;4;154
44;Grand Est;51;3;18;105;Cernay-lès-Reims;1426;23;1449
44;Grand Est;51;1;05;106;Cernon;128;5;133
44;Grand Est;51;2;22;107;Chaintrix-Bierges;329;3;332
44;Grand Est;51;1;97;108;Châlons-en-Champagne;44753;1244;45997
44;Grand Est;51;3;09;109;Châlons-sur-Vesle;192;2;194
44;Grand Est;51;2;22;110;Chaltrait;58;1;59
44;Grand Est;51;3;06;111;Chambrecy;148;8;156
44;Grand Est;51;3;09;112;Chamery;416;6;422
44;Grand Est;51;2;06;113;Champaubert;121;4;125
44;Grand Est;51;3;14;115;Champfleury;551;4;555
44;Grand Est;51;2;21;116;Champguyon;274;3;277
44;Grand Est;51;1;04;117;Champigneul-Champagne;314;5;319
44;Grand Est;51;3;14;118;Champigny;1493;22;1515
44;Grand Est;51;2;07;119;Champillon;505;8;513
44;Grand Est;51;2;06;120;Champlat-et-Boujacourt;165;0;165
44;Grand Est;51;2;06;121;Champvoisy;249;6;255
44;Grand Est;51;4;20;122;Changy;118;5;123
44;Grand Est;51;2;21;124;Chantemerle;44;5;49
44;Grand Est;51;4;23;125;Chapelaine;49;1;50
44;Grand Est;51;1;01;126;La Chapelle-Felcourt;50;4;54
44;Grand Est;51;2;22;127;La Chapelle-Lasson;85;2;87
44;Grand Est;51;2;06;128;La Chapelle-sous-Orbais;54;2;56
44;Grand Est;51;2;21;129;Charleville;238;9;247
44;Grand Est;51;4;20;130;Charmont;227;5;232
44;Grand Est;51;1;01;132;Les Charmontois;118;1;119
44;Grand Est;51;1;01;133;Le Châtelier;60;0;60
44;Grand Est;51;4;23;134;Châtelraould-Saint-Louvent;233;8;241
44;Grand Est;51;4;20;135;Châtillon-sur-Broué;77;0;77
44;Grand Est;51;2;06;136;Châtillon-sur-Marne;668;90;758
44;Grand Est;51;2;21;137;Châtillon-sur-Morin;217;3;220
44;Grand Est;51;1;01;138;Châtrices;34;2;36
44;Grand Est;51;1;01;139;Chaudefontaine;320;13;333
44;Grand Est;51;3;06;140;Chaumuzy;378;1;379
44;Grand Est;51;4;23;141;La Chaussée-sur-Marne;781;15;796
44;Grand Est;51;2;08;142;Chavot-Courcourt;343;11;354
44;Grand Est;51;1;01;143;Le Chemin;50;0;50
44;Grand Est;51;4;20;144;Cheminon;609;9;618
44;Grand Est;51;3;09;145;Chenay;227;6;233
44;Grand Est;51;1;05;146;Cheniers;107;4;111
44;Grand Est;51;1;01;147;La Cheppe;335;10;345
44;Grand Est;51;1;05;148;Cheppes-la-Prairie;177;1;178
44;Grand Est;51;1;05;149;Chepy;429;13;442
44;Grand Est;51;1;04;150;Cherville;81;1;82
44;Grand Est;51;2;21;151;Chichey;175;2;177
44;Grand Est;51;3;10;152;Chigny-les-Roses;556;14;570
44;Grand Est;51;2;08;153;Chouilly;1019;30;1049
44;Grand Est;51;2;22;154;Clamanges;206;10;216
44;Grand Est;51;2;22;155;Clesles;623;10;633
44;Grand Est;51;4;20;156;Cloyes-sur-Marne;129;1;130
44;Grand Est;51;2;06;157;Coizard-Joches;75;1;76
44;Grand Est;51;1;03;160;Compertrix;1490;47;1537
44;Grand Est;51;1;04;161;Condé-sur-Marne;805;16;821
44;Grand Est;51;2;22;162;Conflans-sur-Seine;641;7;648
44;Grand Est;51;2;06;163;Congy;262;2;264
44;Grand Est;51;2;22;164;Connantray-Vaurefroy;159;4;163
44;Grand Est;51;2;22;165;Connantre;1084;31;1115
44;Grand Est;51;1;01;166;Contault;66;2;68
44;Grand Est;51;4;23;167;Coole;145;1;146
44;Grand Est;51;1;03;168;Coolus;222;8;230
44;Grand Est;51;4;23;169;Corbeil;92;1;93
44;Grand Est;51;2;21;170;Corfélix;112;2;114
44;Grand Est;51;3;02;171;Cormicy;1476;26;1502
44;Grand Est;51;3;18;172;Cormontreuil;6524;90;6614
44;Grand Est;51;2;06;173;Cormoyeux;117;3;120
44;Grand Est;51;2;06;174;Corribert;60;0;60
44;Grand Est;51;2;21;175;Corrobert;205;7;212
44;Grand Est;51;2;22;176;Corroy;163;5;168
44;Grand Est;51;3;09;177;Coulommes-la-Montagne;208;4;212
44;Grand Est;51;1;05;178;Coupetz;78;2;80
44;Grand Est;51;1;05;179;Coupéville;161;1;162
44;Grand Est;51;3;09;181;Courcelles-Sapicourt;378;5;383
44;Grand Est;51;2;22;182;Courcemain;104;3;107
44;Grand Est;51;3;02;183;Courcy;1053;17;1070
44;Grand Est;51;4;23;184;Courdemanges;392;12;404
44;Grand Est;51;2;21;185;Courgivaux;328;10;338
44;Grand Est;51;2;06;186;Courjeonnet;46;0;46
44;Grand Est;51;3;09;187;Courlandon;288;4;292
44;Grand Est;51;3;09;188;Courmas;209;7;216
44;Grand Est;51;3;09;190;Courtagnon;63;0;63
44;Grand Est;51;1;01;191;Courtémont;61;1;62
44;Grand Est;51;2;06;192;Courthiézy;360;5;365
44;Grand Est;51;1;01;193;Courtisols;2425;94;2519
44;Grand Est;51;3;09;194;Courville;455;6;461
44;Grand Est;51;4;23;195;Couvrot;848;23;871
44;Grand Est;51;2;08;196;Cramant;894;13;907
44;Grand Est;51;1;01;197;La Croix-en-Champagne;78;2;80
44;Grand Est;51;3;09;198;Crugny;647;5;652
44;Grand Est;51;2;06;199;Cuchery;405;10;415
44;Grand Est;51;2;08;200;Cuis;386;13;399
44;Grand Est;51;3;06;201;Cuisles;133;4;137
44;Grand Est;51;2;07;202;Cumières;759;13;772
44;Grand Est;51;1;01;203;Cuperly;228;2;230
44;Grand Est;51;2;06;204;Damery;1438;26;1464
44;Grand Est;51;1;10;205;Dampierre-au-Temple;273;6;279
44;Grand Est;51;1;01;206;Dampierre-le-Château;106;2;108
44;Grand Est;51;1;05;208;Dampierre-sur-Moivre;113;2;115
44;Grand Est;51;2;07;210;Dizy;1524;37;1561
44;Grand Est;51;1;01;211;Dommartin-Dampierre;69;0;69
44;Grand Est;51;1;05;212;Dommartin-Lettrée;153;1;154
44;Grand Est;51;1;01;213;Dommartin-sous-Hans;57;2;59
44;Grand Est;51;1;01;214;Dommartin-Varimont;138;8;146
44;Grand Est;51;4;20;215;Dompremy;146;3;149
44;Grand Est;51;3;10;216;Dontrien;272;2;274
44;Grand Est;51;2;06;217;Dormans;2921;55;2976
44;Grand Est;51;4;20;219;Drosnay;216;1;217
44;Grand Est;51;4;23;220;Drouilly;135;1;136
44;Grand Est;51;1;01;222;Éclaires;96;4;100
44;Grand Est;51;4;20;223;Écollemont;53;0;53
44;Grand Est;51;4;20;224;Écriennes;174;2;176
44;Grand Est;51;3;09;225;Écueil;304;2;306
44;Grand Est;51;2;22;226;Écury-le-Repos;59;1;60
44;Grand Est;51;1;05;227;Écury-sur-Coole;501;14;515
44;Grand Est;51;1;01;228;Élise-Daucourt;96;0;96
44;Grand Est;51;1;01;229;Épense;124;6;130
44;Grand Est;51;2;98;230;Épernay;22671;449;23120
44;Grand Est;51;1;05;231;L' Épine;644;15;659
44;Grand Est;51;3;10;232;Époye;430;6;436
44;Grand Est;51;2;21;233;Escardes;78;3;81
44;Grand Est;51;2;22;234;Esclavolles-Lurey;589;19;608
44;Grand Est;51;2;21;236;Les Essarts-le-Vicomte;143;2;145
44;Grand Est;51;2;21;235;Les Essarts-lès-Sézanne;255;10;265
44;Grand Est;51;2;21;237;Esternay;1871;31;1902
44;Grand Est;51;2;06;238;Étoges;469;8;477
44;Grand Est;51;2;22;239;Étréchy;108;3;111
44;Grand Est;51;4;20;240;Étrepy;139;1;140
44;Grand Est;51;2;22;241;Euvy;83;1;84
44;Grand Est;51;1;03;242;Fagnières;4834;108;4942
44;Grand Est;51;2;22;243;Faux-Fresnay;318;8;326
44;Grand Est;51;1;05;244;Faux-Vésigneul;244;6;250
44;Grand Est;51;3;09;245;Faverolles-et-Coëmy;566;8;574
44;Grand Est;51;4;20;246;Favresse;224;6;230
44;Grand Est;51;2;22;248;Fère-Champenoise;2145;43;2188
44;Grand Est;51;2;06;247;Fèrebrianges;151;3;154
44;Grand Est;51;2;06;249;Festigny;399;5;404
44;Grand Est;51;3;09;250;Fismes;5487;49;5536
44;Grand Est;51;2;08;251;Flavigny;165;5;170
44;Grand Est;51;2;06;252;Fleury-la-Rivière;516;7;523
44;Grand Est;51;1;01;253;Florent-en-Argonne;235;5;240
44;Grand Est;51;2;21;254;Fontaine-Denis-Nuisy;234;1;235
44;Grand Est;51;1;01;255;Fontaine-en-Dormois;13;0;13
44;Grand Est;51;2;07;256;Fontaine-sur-Ay;343;8;351
44;Grand Est;51;2;21;258;La Forestière;217;14;231
44;Grand Est;51;1;05;259;Francheville;207;4;211
44;Grand Est;51;1;05;260;Le Fresne;77;0;77
44;Grand Est;51;4;23;262;Frignicourt;1876;38;1914
44;Grand Est;51;2;21;263;Fromentières;377;7;384
44;Grand Est;51;2;21;264;Le Gault-Soigny;529;15;544
44;Grand Est;51;2;21;265;Gaye;588;12;600
44;Grand Est;51;2;07;266;Germaine;514;15;529
44;Grand Est;51;3;09;267;Germigny;180;2;182
44;Grand Est;51;2;22;268;Germinon;174;4;178
44;Grand Est;51;4;20;269;Giffaumont-Champaubert;272;1;273
44;Grand Est;51;4;20;270;Gigny-Bussy;228;5;233
44;Grand Est;51;1;01;272;Givry-en-Argonne;448;5;453
44;Grand Est;51;2;22;273;Givry-lès-Loisy;72;4;76
44;Grand Est;51;1;01;274;Gizaucourt;115;3;118
44;Grand Est;51;4;23;275;Glannes;189;3;192
44;Grand Est;51;2;22;276;Gourgançon;149;7;156
44;Grand Est;51;1;04;278;Les Grandes-Loges;274;5;279
44;Grand Est;51;2;22;279;Granges-sur-Aube;184;1;185
44;Grand Est;51;1;01;280;Gratreuil;28;0;28
44;Grand Est;51;2;08;281;Grauves;619;13;632
44;Grand Est;51;3;09;282;Gueux;1687;51;1738
44;Grand Est;51;1;01;283;Hans;146;6;152
44;Grand Est;51;4;20;284;Haussignémont;286;1;287
44;Grand Est;51;1;05;285;Haussimont;140;5;145
44;Grand Est;51;4;20;286;Hauteville;241;8;249
44;Grand Est;51;2;07;287;Hautvillers;695;18;713
44;Grand Est;51;4;20;290;Heiltz-l'Évêque;301;5;306
44;Grand Est;51;4;20;288;Heiltz-le-Hutier;234;8;242
44;Grand Est;51;4;20;289;Heiltz-le-Maurupt;420;8;428
44;Grand Est;51;3;02;291;Hermonville;1417;31;1448
44;Grand Est;51;1;01;292;Herpont;136;5;141
44;Grand Est;51;3;02;293;Heutrégiville;444;6;450
44;Grand Est;51;3;09;294;Hourges;81;1;82
44;Grand Est;51;4;23;295;Huiron;302;2;304
44;Grand Est;51;4;23;296;Humbauville;79;1;80
44;Grand Est;51;2;06;298;Igny-Comblizy;412;3;415
44;Grand Est;51;4;20;300;Isle-sur-Marne;99;2;101
44;Grand Est;51;3;02;299;Isles-sur-Suippe;898;14;912
44;Grand Est;51;1;04;301;Isse;115;8;123
44;Grand Est;51;2;08;302;Les Istres-et-Bury;97;1;98
44;Grand Est;51;1;04;303;Jâlons;561;10;571
44;Grand Est;51;2;21;304;Janvilliers;167;4;171
44;Grand Est;51;3;09;305;Janvry;131;2;133
44;Grand Est;51;2;21;306;Joiselle;100;3;103
44;Grand Est;51;1;01;307;Jonchery-sur-Suippe;222;3;225
44;Grand Est;51;3;09;308;Jonchery-sur-Vesle;1860;50;1910
44;Grand Est;51;3;06;309;Jonquery;114;4;118
44;Grand Est;51;3;09;310;Jouy-lès-Reims;220;2;222
44;Grand Est;51;4;20;311;Jussecourt-Minecourt;208;2;210
44;Grand Est;51;1;04;312;Juvigny;925;28;953
44;Grand Est;51;2;21;313;Lachy;331;5;336
44;Grand Est;51;3;06;314;Lagery;217;3;220
44;Grand Est;51;4;20;315;Landricourt;148;2;150
44;Grand Est;51;4;20;316;Larzicourt;279;5;284
44;Grand Est;51;1;01;317;Laval-sur-Tourbe;58;0;58
44;Grand Est;51;3;02;318;Lavannes;592;16;608
44;Grand Est;51;1;05;319;Lenharrée;95;3;98
44;Grand Est;51;2;06;320;Leuvrigny;338;9;347
44;Grand Est;51;3;06;321;Lhéry;83;3;86
44;Grand Est;51;4;23;322;Lignon;127;0;127
44;Grand Est;51;2;21;323;Linthelles;108;6;114
44;Grand Est;51;2;21;324;Linthes;117;0;117
44;Grand Est;51;4;20;325;Lisse-en-Champagne;122;2;124
44;Grand Est;51;1;10;326;Livry-Louvercy;1102;14;1116
44;Grand Est;51;2;22;327;Loisy-en-Brie;200;2;202
44;Grand Est;51;4;23;328;Loisy-sur-Marne;1097;24;1121
44;Grand Est;51;3;02;329;Loivre;1283;17;1300
44;Grand Est;51;3;10;333;Ludes;640;7;647
44;Grand Est;51;4;20;334;Luxémont-et-Villotte;450;10;460
44;Grand Est;51;1;01;336;Maffrécourt;57;1;58
44;Grand Est;51;2;07;663;Magenta;1708;17;1725
44;Grand Est;51;3;09;337;Magneux;279;3;282
44;Grand Est;51;3;10;338;Mailly-Champagne;661;17;678
44;Grand Est;51;1;05;339;Mairy-sur-Marne;546;12;558
44;Grand Est;51;4;23;340;Maisons-en-Champagne;532;13;545
44;Grand Est;51;1;01;341;Malmy;33;2;35
44;Grand Est;51;2;08;342;Mancy;253;5;258
44;Grand Est;51;2;22;343;Marcilly-sur-Seine;639;15;654
44;Grand Est;51;2;07;344;Mardeuil;1501;22;1523
44;Grand Est;51;2;06;345;Mareuil-en-Brie;275;2;277
44;Grand Est;51;2;06;346;Mareuil-le-Port;1166;18;1184
44;Grand Est;51;3;06;348;Marfaux;123;1;124
44;Grand Est;51;4;23;349;Margerie-Hancourt;181;5;186
44;Grand Est;51;2;06;350;Margny;121;6;127
44;Grand Est;51;2;22;351;Marigny;107;1;108
44;Grand Est;51;4;23;352;Marolles;894;18;912
44;Grand Est;51;2;22;353;Marsangis;48;1;49
44;Grand Est;51;1;05;354;Marson;290;8;298
44;Grand Est;51;1;01;355;Massiges;49;0;49
44;Grand Est;51;4;20;356;Matignicourt-Goncourt;146;4;150
44;Grand Est;51;1;04;357;Matougues;591;15;606
44;Grand Est;51;4;20;358;Maurupt-le-Montois;582;10;592
44;Grand Est;51;2;21;359;Mécringes;204;3;207
44;Grand Est;51;2;21;360;Le Meix-Saint-Epoing;282;2;284
44;Grand Est;51;4;23;361;Le Meix-Tiercelin;175;1;176
44;Grand Est;51;3;02;362;Merfy;605;20;625
44;Grand Est;51;4;20;363;Merlaut;237;6;243
44;Grand Est;51;3;09;364;Méry-Prémecy;61;1;62
44;Grand Est;51;3;09;365;Les Mesneux;861;20;881
44;Grand Est;51;2;22;367;Le Mesnil-sur-Oger;1109;15;1124
44;Grand Est;51;1;01;368;Minaucourt-le-Mesnil-lès-Hurlus;50;3;53
44;Grand Est;51;1;01;370;Moiremont;199;10;209
44;Grand Est;51;1;05;371;Moivre;62;1;63
44;Grand Est;51;4;20;373;Moncetz-l'Abbaye;95;4;99
44;Grand Est;51;1;05;372;Moncetz-Longevas;535;9;544
44;Grand Est;51;2;21;374;Mondement-Montgivroux;29;0;29
44;Grand Est;51;3;09;382;Mont-sur-Courville;127;4;131
44;Grand Est;51;3;10;375;Montbré;278;4;282
44;Grand Est;51;1;05;377;Montépreux;45;0;45
44;Grand Est;51;2;21;376;Montgenost;154;3;157
44;Grand Est;51;2;08;378;Monthelon;353;6;359
44;Grand Est;51;3;09;379;Montigny-sur-Vesle;516;8;524
44;Grand Est;51;2;21;380;Montmirail;3598;50;3648
44;Grand Est;51;2;06;381;Montmort-Lucy;608;9;617
44;Grand Est;51;2;08;384;Morangis;389;7;396
44;Grand Est;51;2;21;386;Morsains;133;3;136
44;Grand Est;51;2;22;387;Moslins;308;3;311
44;Grand Est;51;1;10;388;Mourmelon-le-Grand;5085;47;5132
44;Grand Est;51;1;10;389;Mourmelon-le-Petit;813;13;826
44;Grand Est;51;2;08;390;Moussy;761;13;774
44;Grand Est;51;3;09;391;Muizon;2161;64;2225
44;Grand Est;51;2;07;392;Mutigny;188;5;193
44;Grand Est;51;2;21;369;Mœurs-Verdey;319;8;327
44;Grand Est;51;2;07;393;Nanteuil-la-Forêt;282;7;289
44;Grand Est;51;2;21;395;Nesle-la-Reposte;104;3;107
44;Grand Est;51;2;06;396;Nesle-le-Repons;150;3;153
44;Grand Est;51;1;01;399;La Neuville-au-Pont;546;11;557
44;Grand Est;51;1;01;397;La Neuville-aux-Bois;143;2;145
44;Grand Est;51;2;06;398;La Neuville-aux-Larris;170;2;172
44;Grand Est;51;2;21;402;Neuvy;255;7;262
44;Grand Est;51;3;02;403;Nogent-l'Abbesse;537;5;542
44;Grand Est;51;1;01;404;Noirlieu;106;6;112
44;Grand Est;51;4;20;406;Norrois;149;1;150
44;Grand Est;51;2;21;407;La Noue;407;5;412
44;Grand Est;51;1;05;409;Nuisement-sur-Coole;358;9;367
44;Grand Est;51;2;22;412;Ognes;63;2;65
44;Grand Est;51;2;08;413;Oiry;833;17;850
44;Grand Est;51;3;06;414;Olizy;160;5;165
44;Grand Est;51;1;05;415;Omey;211;0;211
44;Grand Est;51;2;06;416;Orbais-l'Abbaye;561;3;564
44;Grand Est;51;4;20;417;Orconte;384;5;389
44;Grand Est;51;3;09;418;Ormes;436;3;439
44;Grand Est;51;4;20;419;Outines;134;5;139
44;Grand Est;51;4;20;420;Outrepont;84;2;86
44;Grand Est;51;2;21;421;Oyes;86;3;89
44;Grand Est;51;3;09;422;Pargny-lès-Reims;462;10;472
44;Grand Est;51;4;20;423;Pargny-sur-Saulx;1855;21;1876
44;Grand Est;51;1;01;424;Passavant-en-Argonne;209;1;210
44;Grand Est;51;2;06;425;Passy-Grigny;380;14;394
44;Grand Est;51;2;21;426;Péas;67;3;70
44;Grand Est;51;3;10;428;Les Petites-Loges;482;7;489
44;Grand Est;51;3;09;429;Pévy;204;3;207
44;Grand Est;51;2;22;430;Pierre-Morains;91;2;93
44;Grand Est;51;2;08;431;Pierry;1181;26;1207
44;Grand Est;51;2;22;432;Pleurs;856;19;875
44;Grand Est;51;4;20;433;Plichancourt;244;3;247
44;Grand Est;51;2;08;434;Plivot;748;21;769
44;Grand Est;51;2;22;435;Pocancy;168;2;170
44;Grand Est;51;1;05;436;Pogny;916;18;934
44;Grand Est;51;3;06;437;Poilly;96;3;99
44;Grand Est;51;1;01;438;Poix;71;1;72
44;Grand Est;51;3;02;439;Pomacle;454;7;461
44;Grand Est;51;3;10;440;Pontfaverger-Moronvilliers;1753;18;1771
44;Grand Est;51;4;20;441;Ponthion;109;1;110
44;Grand Est;51;4;20;442;Possesse;159;0;159
44;Grand Est;51;2;22;443;Potangis;131;0;131
44;Grand Est;51;3;02;444;Pouillon;494;8;502
44;Grand Est;51;3;06;445;Pourcy;193;1;194
44;Grand Est;51;4;23;446;Pringy;417;8;425
44;Grand Est;51;3;10;447;Prosnes;490;2;492
44;Grand Est;51;3;09;448;Prouilly;560;4;564
44;Grand Est;51;3;18;449;Prunay;1032;26;1058
44;Grand Est;51;3;18;450;Puisieulx;415;8;423
44;Grand Est;51;2;21;451;Queudes;100;2;102
44;Grand Est;51;1;01;452;Rapsécourt;36;1;37
44;Grand Est;51;1;04;453;Recy;1031;30;1061
44;Grand Est;51;3;99;454;Reims;182460;3116;185576
44;Grand Est;51;4;20;455;Reims-la-Brûlée;228;3;231
44;Grand Est;51;1;01;456;Remicourt;57;1;58
44;Grand Est;51;2;06;457;Reuil;277;19;296
44;Grand Est;51;2;21;458;Reuves;71;0;71
44;Grand Est;51;2;21;459;Réveillon;106;1;107
44;Grand Est;51;2;21;460;Rieux;198;5;203
44;Grand Est;51;3;10;461;Rilly-la-Montagne;988;21;1009
44;Grand Est;51;4;23;463;Les Rivières-Henruel;180;3;183
44;Grand Est;51;3;09;464;Romain;315;18;333
44;Grand Est;51;2;06;465;Romery;157;2;159
44;Grand Est;51;3;06;466;Romigny;213;5;218
44;Grand Est;51;3;09;468;Rosnay;354;9;363
44;Grand Est;51;2;22;469;Rouffy;113;6;119
44;Grand Est;51;1;01;470;Rouvroy-Ripont;8;0;8
44;Grand Est;51;3;09;471;Sacy;371;3;374
44;Grand Est;51;4;20;472;Saint-Amand-sur-Fion;1024;17;1041
44;Grand Est;51;2;21;473;Saint-Bon;113;4;117
44;Grand Est;51;3;15;474;Saint-Brice-Courcelles;3522;51;3573
44;Grand Est;51;4;23;475;Saint-Chéron;60;3;63
44;Grand Est;51;1;05;476;Saint-Étienne-au-Temple;812;12;824
44;Grand Est;51;3;02;477;Saint-Étienne-sur-Suippe;316;4;320
44;Grand Est;51;4;20;478;Saint-Eulien;440;12;452
44;Grand Est;51;3;09;479;Saint-Euphraise-et-Clairizet;234;5;239
44;Grand Est;51;1;05;482;Saint-Germain-la-Ville;671;13;684
44;Grand Est;51;1;04;483;Saint-Gibrien;538;7;545
44;Grand Est;51;3;09;484;Saint-Gilles;293;4;297
44;Grand Est;51;1;10;485;Saint-Hilaire-au-Temple;342;6;348
44;Grand Est;51;1;01;486;Saint-Hilaire-le-Grand;363;4;367
44;Grand Est;51;3;10;487;Saint-Hilaire-le-Petit;339;7;346
44;Grand Est;51;2;07;488;Saint-Imoges;320;25;345
44;Grand Est;51;4;20;489;Saint-Jean-devant-Possesse;31;3;34
44;Grand Est;51;1;05;490;Saint-Jean-sur-Moivre;210;3;213
44;Grand Est;51;1;01;491;Saint-Jean-sur-Tourbe;92;3;95
44;Grand Est;51;2;22;492;Saint-Just-Sauvage;1461;39;1500
44;Grand Est;51;3;18;493;Saint-Léonard;106;3;109
44;Grand Est;51;2;21;495;Saint-Loup;87;1;88
44;Grand Est;51;4;20;496;Saint-Lumier-en-Champagne;263;5;268
44;Grand Est;51;4;20;497;Saint-Lumier-la-Populeuse;49;0;49
44;Grand Est;51;2;22;499;Saint-Mard-lès-Rouffy;163;7;170
44;Grand Est;51;1;01;498;Saint-Mard-sur-Auve;64;1;65
44;Grand Est;51;1;01;500;Saint-Mard-sur-le-Mont;118;0;118
44;Grand Est;51;1;05;502;Saint-Martin-aux-Champs;104;0;104
44;Grand Est;51;2;06;002;Saint-Martin-d'Ablois;1426;23;1449
44;Grand Est;51;3;10;503;Saint-Martin-l'Heureux;85;1;86
44;Grand Est;51;1;04;504;Saint-Martin-sur-le-Pré;797;32;829
44;Grand Est;51;3;10;505;Saint-Masmes;458;8;466
44;Grand Est;51;1;05;506;Saint-Memmie;5511;78;5589
44;Grand Est;51;4;23;508;Saint-Ouen-Domprot;205;6;211
44;Grand Est;51;1;04;509;Saint-Pierre;301;8;309
44;Grand Est;51;2;22;511;Saint-Quentin-le-Verger;121;2;123
44;Grand Est;51;4;20;510;Saint-Quentin-les-Marais;139;2;141
44;Grand Est;51;1;05;512;Saint-Quentin-sur-Coole;104;1;105
44;Grand Est;51;4;20;513;Saint-Remy-en-Bouzemont-Saint-Genest-et-Isson;518;6;524
44;Grand Est;51;2;21;514;Saint-Remy-sous-Broyes;105;2;107
44;Grand Est;51;1;01;515;Saint-Remy-sur-Bussy;343;8;351
44;Grand Est;51;2;22;516;Saint-Saturnin;59;0;59
44;Grand Est;51;3;10;517;Saint-Souplet-sur-Py;125;4;129
44;Grand Est;51;3;02;518;Saint-Thierry;627;23;650
44;Grand Est;51;1;01;519;Saint-Thomas-en-Argonne;40;2;42
44;Grand Est;51;4;23;520;Saint-Utin;79;1;80
44;Grand Est;51;4;20;521;Saint-Vrain;233;2;235
44;Grand Est;51;2;06;480;Sainte-Gemme;139;3;142
44;Grand Est;51;1;01;501;Sainte-Marie-à-Py;198;5;203
44;Grand Est;51;4;20;277;Sainte-Marie-du-Lac-Nuisement;268;2;270
44;Grand Est;51;1;01;507;Sainte-Menehould;4120;114;4234
44;Grand Est;51;4;20;522;Sapignicourt;410;4;414
44;Grand Est;51;3;06;523;Sarcy;254;4;258
44;Grand Est;51;2;22;524;Saron-sur-Aube;304;6;310
44;Grand Est;51;1;05;525;Sarry;2046;86;2132
44;Grand Est;51;2;21;526;Saudoy;369;10;379
44;Grand Est;51;3;09;527;Savigny-sur-Ardres;270;4;274
44;Grand Est;51;4;20;528;Scrupt;132;0;132
44;Grand Est;51;3;10;529;Selles;405;1;406
44;Grand Est;51;3;10;530;Sept-Saulx;615;11;626
44;Grand Est;51;4;20;531;Sermaize-les-Bains;1906;35;1941
44;Grand Est;51;3;09;532;Sermiers;561;14;575
44;Grand Est;51;1;01;533;Servon-Melzicourt;108;1;109
44;Grand Est;51;3;09;534;Serzy-et-Prin;207;4;211
44;Grand Est;51;2;21;535;Sézanne;4834;108;4942
44;Grand Est;51;3;18;536;Sillery;1724;37;1761
44;Grand Est;51;1;01;537;Sivry-Ante;182;5;187
44;Grand Est;51;1;05;538;Sogny-aux-Moulins;111;2;113
44;Grand Est;51;4;20;539;Sogny-en-l'Angle;62;0;62
44;Grand Est;51;2;21;542;Soizy-aux-Bois;184;1;185
44;Grand Est;51;1;01;543;Somme-Bionne;80;8;88
44;Grand Est;51;1;01;546;Somme-Suippe;475;164;639
44;Grand Est;51;1;01;547;Somme-Tourbe;143;3;146
44;Grand Est;51;1;01;548;Somme-Vesle;430;245;675
44;Grand Est;51;1;01;549;Somme-Yèvre;117;3;120
44;Grand Est;51;1;01;544;Sommepy-Tahure;623;16;639
44;Grand Est;51;1;05;545;Sommesous;533;14;547
44;Grand Est;51;4;23;550;Sompuis;291;12;303
44;Grand Est;51;4;23;551;Somsois;196;6;202
44;Grand Est;51;4;23;552;Songy;263;4;267
44;Grand Est;51;1;01;553;Souain-Perthes-lès-Hurlus;238;5;243
44;Grand Est;51;1;05;555;Soudé;183;0;183
44;Grand Est;51;1;05;556;Soudron;301;5;306
44;Grand Est;51;4;23;557;Soulanges;470;9;479
44;Grand Est;51;2;22;558;Soulières;142;1;143
44;Grand Est;51;1;01;559;Suippes;3913;47;3960
44;Grand Est;51;2;06;560;Suizy-le-Franc;107;3;110
44;Grand Est;51;3;18;562;Taissy;2199;36;2235
44;Grand Est;51;2;06;563;Talus-Saint-Prix;108;4;112
44;Grand Est;51;2;22;565;Thaas;99;0;99
44;Grand Est;51;1;04;566;Thibie;291;2;293
44;Grand Est;51;4;20;567;Thiéblemont-Farémont;541;6;547
44;Grand Est;51;3;02;568;Thil;296;4;300
44;Grand Est;51;3;09;569;Thillois;449;68;517
44;Grand Est;51;2;21;570;Le Thoult-Trosnay;103;2;105
44;Grand Est;51;1;01;572;Tilloy-et-Bellay;219;10;229
44;Grand Est;51;3;14;573;Tinqueux;10030;139;10169
44;Grand Est;51;1;05;574;Togny-aux-Bœufs;137;2;139
44;Grand Est;51;2;07;576;Tours-sur-Marne;1382;14;1396
44;Grand Est;51;3;06;577;Tramery;151;3;154
44;Grand Est;51;2;22;578;Trécon;82;1;83
44;Grand Est;51;2;21;579;Tréfols;168;3;171
44;Grand Est;51;3;10;580;Trépail;431;5;436
44;Grand Est;51;3;09;581;Treslon;242;1;243
44;Grand Est;51;3;09;582;Trigny;543;9;552
44;Grand Est;51;4;20;583;Trois-Fontaines-l'Abbaye;198;5;203
44;Grand Est;51;3;18;584;Trois-Puits;153;2;155
44;Grand Est;51;2;06;585;Troissy;829;93;922
44;Grand Est;51;3;09;586;Unchair;166;4;170
44;Grand Est;51;1;10;587;Vadenay;241;6;247
44;Grand Est;51;2;07;564;Val de Livre;633;17;650
44;Grand Est;51;3;10;571;Val-de-Vesle;912;10;922
44;Grand Est;51;4;20;218;Val-de-Vière;129;2;131
44;Grand Est;51;2;22;158;Val-des-Marais;567;11;578
44;Grand Est;51;1;01;588;Valmy;294;5;299
44;Grand Est;51;4;20;589;Vanault-le-Châtel;178;1;179
44;Grand Est;51;4;20;590;Vanault-les-Dames;363;8;371
44;Grand Est;51;3;09;591;Vandeuil;196;3;199
44;Grand Est;51;2;06;592;Vandières;307;6;313
44;Grand Est;51;1;05;594;Vassimont-et-Chapelaine;61;1;62
44;Grand Est;51;1;05;595;Vatry;158;2;160
44;Grand Est;51;2;21;596;Vauchamps;360;10;370
44;Grand Est;51;2;06;597;Vauciennes;332;7;339
44;Grand Est;51;4;20;598;Vauclerc;494;21;515
44;Grand Est;51;3;10;599;Vaudemange;309;5;314
44;Grand Est;51;3;10;600;Vaudesincourt;92;1;93
44;Grand Est;51;4;20;601;Vavray-le-Grand;161;3;164
44;Grand Est;51;4;20;602;Vavray-le-Petit;66;3;69
44;Grand Est;51;2;22;603;Vélye;196;2;198
44;Grand Est;51;3;09;604;Ventelay;259;6;265
44;Grand Est;51;2;06;605;Venteuil;529;10;539
44;Grand Est;51;2;21;607;Verdon;209;2;211
44;Grand Est;51;4;20;608;Vernancourt;88;4;92
44;Grand Est;51;2;06;609;Verneuil;840;20;860
44;Grand Est;51;1;01;610;Verrières;402;6;408
44;Grand Est;51;2;22;611;Vert-Toulon;291;4;295
44;Grand Est;51;3;10;613;Verzenay;1052;8;1060
44;Grand Est;51;3;10;614;Verzy;974;23;997
44;Grand Est;51;1;05;616;Vésigneul-sur-Marne;237;3;240
44;Grand Est;51;1;04;617;La Veuve;614;11;625
44;Grand Est;51;2;21;618;Le Vézier;191;3;194
44;Grand Est;51;1;01;619;Le Vieil-Dampierre;115;3;118
44;Grand Est;51;1;01;620;Vienne-la-Ville;173;7;180
44;Grand Est;51;1;01;621;Vienne-le-Château;520;7;527
44;Grand Est;51;3;09;622;Ville-Dommange;401;8;409
44;Grand Est;51;3;10;623;Ville-en-Selve;279;46;325
44;Grand Est;51;3;06;624;Ville-en-Tardenois;657;6;663
44;Grand Est;51;2;06;639;La Ville-sous-Orbais;49;1;50
44;Grand Est;51;1;01;640;Ville-sur-Tourbe;219;1;220
44;Grand Est;51;2;21;625;Villeneuve-la-Lionne;285;3;288
44;Grand Est;51;2;21;626;La Villeneuve-lès-Charleville;113;1;114
44;Grand Est;51;2;22;627;Villeneuve-Renneville-Chevigny;316;6;322
44;Grand Est;51;2;21;628;Villeneuve-Saint-Vistre-et-Villevotte;123;5;128
44;Grand Est;51;3;10;629;Villers-Allerand;885;18;903
44;Grand Est;51;2;22;630;Villers-aux-Bois;326;5;331
44;Grand Est;51;3;14;631;Villers-aux-Nœuds;188;4;192
44;Grand Est;51;1;01;632;Villers-en-Argonne;232;6;238
44;Grand Est;51;3;02;633;Villers-Franqueux;297;16;313
44;Grand Est;51;1;04;634;Villers-le-Château;254;8;262
44;Grand Est;51;4;20;635;Villers-le-Sec;117;1;118
44;Grand Est;51;3;10;636;Villers-Marmery;524;11;535
44;Grand Est;51;2;06;637;Villers-sous-Châtillon;215;0;215
44;Grand Est;51;2;22;638;Villeseneux;221;5;226
44;Grand Est;51;2;06;641;Villevenard;215;2;217
44;Grand Est;51;2;22;642;Villiers-aux-Corneilles;109;4;113
44;Grand Est;51;2;08;643;Vinay;589;5;594
44;Grand Est;51;2;06;644;Vincelles;290;3;293
44;Grand Est;51;2;21;645;Vindey;116;2;118
44;Grand Est;51;1;01;646;Virginy;84;3;87
44;Grand Est;51;4;20;647;Vitry-en-Perthois;828;24;852
44;Grand Est;51;1;05;648;Vitry-la-Ville;377;9;386
44;Grand Est;51;4;23;649;Vitry-le-François;12133;283;12416
44;Grand Est;51;1;01;650;Voilemont;44;5;49
44;Grand Est;51;2;22;652;Vouarces;60;0;60
44;Grand Est;51;4;20;654;Vouillers;258;6;264
44;Grand Est;51;2;22;655;Vouzy;293;5;298
44;Grand Est;51;1;04;656;Vraux;460;8;468
44;Grand Est;51;3;09;657;Vrigny;232;0;232
44;Grand Est;51;4;20;658;Vroil;104;0;104
44;Grand Est;51;1;01;659;Wargemoulin-Hurlus;46;1;47
44;Grand Est;51;3;02;660;Warmeriville;2468;26;2494
44;Grand Est;51;3;02;662;Witry-lès-Reims;5020;55;5075
44;Grand Est;51;2;06;410;Œuilly;648;10;658
44;Grand Est;52;1;11;001;Ageville;309;8;317
44;Grand Est;52;2;02;002;Aigremont;20;0;20
44;Grand Est;52;1;12;003;Aillianville;165;2;167
44;Grand Est;52;3;12;004;Aingoulaincourt;13;0;13
44;Grand Est;52;1;04;005;Aizanville;34;4;38
44;Grand Est;52;3;13;006;Allichamps;347;4;351
44;Grand Est;52;3;09;007;Ambonville;82;2;84
44;Grand Est;52;1;01;008;Andelot-Blancheville;870;10;880
44;Grand Est;52;2;11;009;Andilly-en-Bassigny;108;1;109
44;Grand Est;52;1;01;011;Annéville-la-Prairie;86;0;86
44;Grand Est;52;3;12;012;Annonville;32;1;33
44;Grand Est;52;2;03;013;Anrosey;121;5;126
44;Grand Est;52;2;16;014;Aprey;187;6;193
44;Grand Est;52;2;03;015;Arbigny-sous-Varennes;89;0;89
44;Grand Est;52;2;16;016;Arbot;70;2;72
44;Grand Est;52;1;04;017;Arc-en-Barrois;743;13;756
44;Grand Est;52;3;09;019;Arnancourt;91;4;95
44;Grand Est;52;3;17;021;Attancourt;260;4;264
44;Grand Est;52;1;04;022;Aubepierre-sur-Aube;188;3;191
44;Grand Est;52;2;16;023;Auberive;169;5;174
44;Grand Est;52;1;12;025;Audeloncourt;87;2;89
44;Grand Est;52;2;16;027;Aujeurres;83;2;85
44;Grand Est;52;2;16;028;Aulnoy-sur-Aube;51;0;51
44;Grand Est;52;3;09;029;Autigny-le-Grand;149;2;151
44;Grand Est;52;3;09;030;Autigny-le-Petit;63;2;65
44;Grand Est;52;1;04;031;Autreville-sur-la-Renne;382;9;391
44;Grand Est;52;2;02;033;Avrecourt;114;4;118
44;Grand Est;52;3;17;034;Bailly-aux-Forges;143;5;148
44;Grand Est;52;2;16;035;Baissey;193;3;196
44;Grand Est;52;2;11;037;Bannes;374;3;377
44;Grand Est;52;1;12;038;Bassoncourt;67;0;67
44;Grand Est;52;3;09;039;Baudrecourt;92;0;92
44;Grand Est;52;2;16;040;Bay-sur-Aube;52;1;53
44;Grand Est;52;3;08;265;Bayard-sur-Marne;1322;27;1349
44;Grand Est;52;2;10;042;Beauchemin;104;1;105
44;Grand Est;52;2;03;043;Belmont;57;1;58
44;Grand Est;52;3;15;045;Bettancourt-la-Ferrée;1697;37;1734
44;Grand Est;52;3;09;047;Beurville;104;0;104
44;Grand Est;52;1;11;050;Biesles;1352;31;1383
44;Grand Est;52;2;03;051;Bize;92;1;93
44;Grand Est;52;1;04;053;Blaisy;75;1;76
44;Grand Est;52;3;09;055;Blécourt;112;2;114
44;Grand Est;52;1;04;056;Blessonville;196;6;202
44;Grand Est;52;3;09;057;Blumeray;109;7;116
44;Grand Est;52;1;01;058;Bologne;1899;38;1937
44;Grand Est;52;2;11;059;Bonnecourt;135;0;135
44;Grand Est;52;2;02;060;Bourbonne-les-Bains;2073;54;2127
44;Grand Est;52;1;01;061;Bourdons-sur-Rognon;285;2;287
44;Grand Est;52;2;16;062;Bourg;156;5;161
44;Grand Est;52;1;12;063;Bourg-Sainte-Marie;101;1;102
44;Grand Est;52;1;12;064;Bourmont-entre-Meuse-et-Mouzon;803;30;833
44;Grand Est;52;3;09;065;Bouzancourt;65;1;66
44;Grand Est;52;3;09;066;Brachay;61;3;64
44;Grand Est;52;1;12;067;Brainville-sur-Meuse;78;0;78
44;Grand Est;52;1;04;069;Braux-le-Châtel;145;1;146
44;Grand Est;52;2;16;070;Brennes;133;3;136
44;Grand Est;52;1;05;072;Brethenay;368;10;378
44;Grand Est;52;1;12;074;Breuvannes-en-Bassigny;678;20;698
44;Grand Est;52;1;01;075;Briaucourt;181;6;187
44;Grand Est;52;1;04;076;Bricon;449;14;463
44;Grand Est;52;3;17;079;Brousseval;694;9;703
44;Grand Est;52;1;04;082;Bugnières;153;5;158
44;Grand Est;52;1;12;084;Busson;39;0;39
44;Grand Est;52;1;02;085;Buxières-lès-Clefmont;26;2;28
44;Grand Est;52;1;06;087;Buxières-lès-Villiers;195;20;215
44;Grand Est;52;3;17;088;Ceffonds;635;16;651
44;Grand Est;52;2;02;089;Celles-en-Bassigny;83;1;84
44;Grand Est;52;2;03;090;Celsoy;105;1;106
44;Grand Est;52;3;01;091;Cerisières;83;7;90
44;Grand Est;52;2;16;092;Chalancey;105;2;107
44;Grand Est;52;2;03;093;Chalindrey;2407;41;2448
44;Grand Est;52;1;12;095;Chalvraines;187;2;189
44;Grand Est;52;1;06;125;Chamarandes-Choignes;1034;172;1206
44;Grand Est;52;1;12;097;Chambroncourt;49;1;50
44;Grand Est;52;3;08;099;Chamouilley;806;10;816
44;Grand Est;52;1;12;101;Champigneulles-en-Bassigny;44;1;45
44;Grand Est;52;2;10;102;Champigny-lès-Langres;426;13;439
44;Grand Est;52;2;03;103;Champigny-sous-Varennes;115;2;117
44;Grand Est;52;2;03;083;Champsevraine;734;16;750
44;Grand Est;52;3;15;104;Chancenay;1087;27;1114
44;Grand Est;52;2;11;105;Changey;304;11;315
44;Grand Est;52;2;10;106;Chanoy;127;2;129
44;Grand Est;52;1;01;107;Chantraines;222;5;227
44;Grand Est;52;2;11;108;Charmes;146;4;150
44;Grand Est;52;3;09;109;Charmes-en-l'Angle;10;0;10
44;Grand Est;52;3;09;110;Charmes-la-Grande;156;6;162
44;Grand Est;52;2;16;113;Chassigny;253;2;255
44;Grand Est;52;1;04;114;Châteauvillain;1584;17;1601
44;Grand Est;52;2;02;400;Le Châtelet-sur-Meuse;150;0;150
44;Grand Est;52;2;10;115;Chatenay-Mâcheron;105;2;107
44;Grand Est;52;2;10;116;Chatenay-Vaudin;52;2;54
44;Grand Est;52;3;09;118;Chatonrupt-Sommermont;298;6;304
44;Grand Est;52;2;03;119;Chaudenay;345;7;352
44;Grand Est;52;2;02;120;Chauffourt;204;4;208
44;Grand Est;52;1;98;121;Chaumont;21945;1227;23172
44;Grand Est;52;1;12;122;Chaumont-la-Ville;116;1;117
44;Grand Est;52;3;08;123;Chevillon;1313;20;1333
44;Grand Est;52;2;03;124;Chézeaux;72;0;72
44;Grand Est;52;2;16;126;Choilley-Dardenay;162;4;166
44;Grand Est;52;1;02;127;Choiseul;78;4;82
44;Grand Est;52;1;01;128;Cirey-lès-Mareilles;140;3;143
44;Grand Est;52;3;09;129;Cirey-sur-Blaise;119;1;120
44;Grand Est;52;1;04;130;Cirfontaines-en-Azois;186;1;187
44;Grand Est;52;3;12;131;Cirfontaines-en-Ornois;77;1;78
44;Grand Est;52;1;02;132;Clefmont;176;3;179
44;Grand Est;52;1;12;133;Clinchamp;77;3;80
44;Grand Est;52;2;16;134;Cohons;233;5;238
44;Grand Est;52;2;03;135;Coiffy-le-Bas;92;0;92
44;Grand Est;52;2;02;136;Coiffy-le-Haut;116;0;116
44;Grand Est;52;2;16;137;Colmier-le-Bas;22;0;22
44;Grand Est;52;2;16;138;Colmier-le-Haut;59;1;60
44;Grand Est;52;1;04;140;Colombey les Deux Églises;714;22;736
44;Grand Est;52;1;05;141;Condes;304;6;310
44;Grand Est;52;1;01;142;Consigny;69;1;70
44;Grand Est;52;2;16;145;Coublanc;117;5;122
44;Grand Est;52;1;04;146;Coupray;146;2;148
44;Grand Est;52;1;04;151;Cour-l'Évêque;159;2;161
44;Grand Est;52;2;16;147;Courcelles-en-Montagne;90;0;90
44;Grand Est;52;3;09;149;Courcelles-sur-Blaise;98;1;99
44;Grand Est;52;2;03;155;Culmont;539;10;549
44;Grand Est;52;3;08;156;Curel;412;6;418
44;Grand Est;52;1;04;157;Curmont;12;1;13
44;Grand Est;52;2;16;158;Cusey;282;4;286
44;Grand Est;52;1;11;159;Cuves;25;1;26
44;Grand Est;52;1;01;160;Daillancourt;67;2;69
44;Grand Est;52;1;02;161;Daillecourt;74;0;74
44;Grand Est;52;2;02;162;Dammartin-sur-Meuse;198;2;200
44;Grand Est;52;2;11;163;Dampierre;387;4;391
44;Grand Est;52;2;02;164;Damrémont;197;4;201
44;Grand Est;52;1;04;165;Dancevoir;189;9;198
44;Grand Est;52;1;01;167;Darmannes;260;3;263
44;Grand Est;52;1;04;168;Dinteville;56;3;59
44;Grand Est;52;3;08;169;Domblain;80;2;82
44;Grand Est;52;2;16;170;Dommarien;161;7;168
44;Grand Est;52;3;17;171;Dommartin-le-Franc;248;2;250
44;Grand Est;52;3;09;172;Dommartin-le-Saint-Père;276;7;283
44;Grand Est;52;3;01;173;Domremy-Landéville;78;4;82
44;Grand Est;52;1;12;174;Doncourt-sur-Meuse;39;1;40
44;Grand Est;52;3;09;175;Donjeux;386;4;390
44;Grand Est;52;3;01;177;Doulaincourt-Saucourt;816;44;860
44;Grand Est;52;3;09;178;Doulevant-le-Château;363;13;376
44;Grand Est;52;3;17;179;Doulevant-le-Petit;26;3;29
44;Grand Est;52;3;12;181;Échenay;92;2;94
44;Grand Est;52;3;13;182;Éclaron-Braucourt-Sainte-Livière;2019;44;2063
44;Grand Est;52;1;01;183;Ecot-la-Combe;37;1;38
44;Grand Est;52;3;12;184;Effincourt;61;5;66
44;Grand Est;52;2;02;185;Enfonvelle;68;1;69
44;Grand Est;52;3;12;187;Épizon;168;4;172
44;Grand Est;52;1;11;190;Esnouveaux;296;5;301
44;Grand Est;52;1;05;193;Euffigneix;302;13;315
44;Grand Est;52;3;08;194;Eurville-Bienville;2065;32;2097
44;Grand Est;52;2;03;195;Farincourt;39;0;39
44;Grand Est;52;2;10;196;Faverolles;101;4;105
44;Grand Est;52;2;03;197;Fayl-Billot;1323;123;1446
44;Grand Est;52;3;08;198;Fays;73;3;76
44;Grand Est;52;3;09;199;Ferrière-et-Lafolie;50;2;52
44;Grand Est;52;2;16;200;Flagey;83;3;86
44;Grand Est;52;3;09;201;Flammerécourt;69;0;69
44;Grand Est;52;3;08;203;Fontaines-sur-Marne;148;2;150
44;Grand Est;52;1;11;204;Forcey;64;4;68
44;Grand Est;52;1;07;205;Foulain;697;17;714
44;Grand Est;52;3;17;206;Frampas;161;4;165
44;Grand Est;52;2;02;207;Frécourt;96;3;99
44;Grand Est;52;2;02;208;Fresnes-sur-Apance;148;2;150
44;Grand Est;52;1;01;211;Froncles;1521;24;1545
44;Grand Est;52;3;09;212;Fronville;323;3;326
44;Grand Est;52;2;03;213;Genevrières;132;5;137
44;Grand Est;52;1;01;214;La Genevroye;32;1;33
44;Grand Est;52;2;16;216;Germaines;41;1;42
44;Grand Est;52;1;12;217;Germainvilliers;89;4;93
44;Grand Est;52;3;12;218;Germay;45;2;47
44;Grand Est;52;3;12;219;Germisay;18;0;18
44;Grand Est;52;1;04;220;Giey-sur-Aujon;130;1;131
44;Grand Est;52;1;04;221;Gillancourt;120;3;123
44;Grand Est;52;3;12;222;Gillaumé;37;0;37
44;Grand Est;52;2;03;223;Gilley;67;3;70
44;Grand Est;52;1;12;227;Graffigny-Chemin;232;6;238
44;Grand Est;52;2;03;228;Grandchamp;74;1;75
44;Grand Est;52;2;03;229;Grenant;148;2;150
44;Grand Est;52;3;09;230;Gudmont-Villiers;291;5;296
44;Grand Est;52;3;09;231;Guindrecourt-aux-Ormes;93;2;95
44;Grand Est;52;1;01;232;Guindrecourt-sur-Blaise;59;0;59
44;Grand Est;52;2;03;233;Guyonvelle;107;1;108
44;Grand Est;52;1;12;234;Hâcourt;39;0;39
44;Grand Est;52;3;13;235;Hallignicourt;285;3;288
44;Grand Est;52;1;12;237;Harréville-les-Chanteurs;292;10;302
44;Grand Est;52;2;03;242;Haute-Amance;956;15;971
44;Grand Est;52;2;03;240;Heuilley-le-Grand;209;7;216
44;Grand Est;52;1;12;243;Huilliécourt;118;1;119
44;Grand Est;52;3;13;244;Humbécourt;780;10;790
44;Grand Est;52;1;12;245;Humberville;67;5;72
44;Grand Est;52;2;10;246;Humes-Jorquenay;570;15;585
44;Grand Est;52;1;12;247;Illoud;220;9;229
44;Grand Est;52;1;02;248;Is-en-Bassigny;542;13;555
44;Grand Est;52;2;16;249;Isômes;150;6;156
44;Grand Est;52;3;09;250;Joinville;3069;68;3137
44;Grand Est;52;1;05;251;Jonchery;1014;35;1049
44;Grand Est;52;1;04;253;Juzennecourt;213;3;216
44;Grand Est;52;1;04;254;Lachapelle-en-Blaisy;81;3;84
44;Grand Est;52;1;12;256;Lafauche;77;4;81
44;Grand Est;52;2;03;257;Laferté-sur-Amance;107;1;108
44;Grand Est;52;1;04;258;Laferté-sur-Aube;331;2;333
44;Grand Est;52;1;01;260;Lamancine;124;3;127
44;Grand Est;52;2;02;264;Laneuvelle;65;2;67
44;Grand Est;52;3;17;266;Laneuville-à-Rémy;66;0;66
44;Grand Est;52;3;13;267;Laneuville-au-Pont;209;3;212
44;Grand Est;52;2;10;269;Langres;7731;415;8146
44;Grand Est;52;1;11;271;Lanques-sur-Rognon;186;2;188
44;Grand Est;52;1;04;272;Lanty-sur-Aube;121;2;123
44;Grand Est;52;2;02;273;Larivière-Arnoncourt;117;1;118
44;Grand Est;52;1;04;274;Latrecey-Ormoy-sur-Aube;295;9;304
44;Grand Est;52;2;02;275;Lavernoy;76;0;76
44;Grand Est;52;1;06;276;Laville-aux-Bois;205;9;214
44;Grand Est;52;2;02;277;Lavilleneuve;60;1;61
44;Grand Est;52;1;04;278;Lavilleneuve-au-Roi;78;0;78
44;Grand Est;52;2;10;280;Lecey;210;3;213
44;Grand Est;52;1;04;282;Leffonds;349;9;358
44;Grand Est;52;3;09;284;Leschères-sur-le-Blaiseron;101;0;101
44;Grand Est;52;2;16;285;Leuchey;85;1;86
44;Grand Est;52;1;12;286;Leurville;84;0;84
44;Grand Est;52;1;12;287;Levécourt;87;1;88
44;Grand Est;52;3;12;288;Lezéville;125;0;125
44;Grand Est;52;1;12;289;Liffol-le-Petit;320;8;328
44;Grand Est;52;2;03;290;Les Loges;137;6;143
44;Grand Est;52;1;12;291;Longchamp;71;0;71
44;Grand Est;52;2;16;292;Longeau-Percey;743;19;762
44;Grand Est;52;3;13;294;Louvemont;701;10;711
44;Grand Est;52;1;11;295;Louvières;97;0;97
44;Grand Est;52;1;07;297;Luzy-sur-Marne;258;10;268
44;Grand Est;52;2;16;298;Maâtz;75;0;75
44;Grand Est;52;3;08;300;Magneux;167;2;169
44;Grand Est;52;1;12;301;Maisoncelles;58;1;59
44;Grand Est;52;3;08;302;Maizières;198;3;201
44;Grand Est;52;2;03;303;Maizières-sur-Amance;98;1;99
44;Grand Est;52;1;12;304;Malaincourt-sur-Meuse;57;1;58
44;Grand Est;52;1;11;305;Mandres-la-Côte;538;5;543
44;Grand Est;52;1;12;306;Manois;451;9;460
44;Grand Est;52;2;10;307;Marac;214;4;218
44;Grand Est;52;1;04;308;Maranville;410;4;414
44;Grand Est;52;1;01;310;Marbéville;98;2;100
44;Grand Est;52;2;02;311;Marcilly-en-Bassigny;218;4;222
44;Grand Est;52;2;10;312;Mardor;47;3;50
44;Grand Est;52;1;01;313;Mareilles;155;1;156
44;Grand Est;52;1;11;315;Marnay-sur-Marne;325;1;326
44;Grand Est;52;3;09;316;Mathons;65;2;67
44;Grand Est;52;2;02;318;Melay;258;6;264
44;Grand Est;52;1;12;319;Mennouveaux;70;1;71
44;Grand Est;52;1;12;320;Merrey;100;3;103
44;Grand Est;52;3;09;321;Mertrud;177;7;184
44;Grand Est;52;1;01;322;Meures;131;4;135
44;Grand Est;52;1;12;325;Millières;114;5;119
44;Grand Est;52;1;01;326;Mirbel;42;0;42
44;Grand Est;52;3;13;327;Moëslains;425;12;437
44;Grand Est;52;2;02;328;Montcharvot;33;1;34
44;Grand Est;52;1;04;330;Montheries;65;2;67
44;Grand Est;52;1;01;335;Montot-sur-Rognon;131;2;133
44;Grand Est;52;3;17;336;Montreuil-sur-Blaise;165;2;167
44;Grand Est;52;3;12;337;Montreuil-sur-Thonnance;62;0;62
44;Grand Est;52;2;16;405;Le Montsaugeonnais;1265;26;1291
44;Grand Est;52;3;17;341;Morancourt;134;2;136
44;Grand Est;52;1;12;342;Morionvilliers;29;0;29
44;Grand Est;52;2;16;344;Mouilleron;35;2;37
44;Grand Est;52;3;09;346;Mussey-sur-Marne;372;6;378
44;Grand Est;52;3;08;347;Narcy;247;5;252
44;Grand Est;52;2;11;348;Neuilly-l'Évêque;591;19;610
44;Grand Est;52;1;07;349;Neuilly-sur-Suize;311;9;320
44;Grand Est;52;2;02;350;Neuvelle-lès-Voisey;72;0;72
44;Grand Est;52;1;11;352;Ninville;79;5;84
44;Grand Est;52;1;11;353;Nogent;3752;63;3815
44;Grand Est;52;2;03;354;Noidant-Chatenoy;82;0;82
44;Grand Est;52;2;16;355;Noidant-le-Rocheux;160;4;164
44;Grand Est;52;3;09;356;Nomécourt;110;4;114
44;Grand Est;52;3;12;357;Noncourt-sur-le-Rongeant;176;2;178
44;Grand Est;52;1;02;358;Noyers;83;0;83
44;Grand Est;52;3;09;359;Nully;161;4;165
44;Grand Est;52;2;16;360;Occey;157;3;160
44;Grand Est;52;2;11;362;Orbigny-au-Mont;133;4;137
44;Grand Est;52;2;11;363;Orbigny-au-Val;96;7;103
44;Grand Est;52;2;16;364;Orcevaux;99;3;102
44;Grand Est;52;1;04;365;Orges;354;3;357
44;Grand Est;52;2;10;366;Ormancey;79;1;80
44;Grand Est;52;1;01;367;Ormoy-lès-Sexfontaines;43;1;44
44;Grand Est;52;1;12;369;Orquevaux;80;0;80
44;Grand Est;52;3;08;370;Osne-le-Val;257;6;263
44;Grand Est;52;1;01;371;Oudincourt;143;2;145
44;Grand Est;52;1;12;372;Outremécourt;90;6;96
44;Grand Est;52;1;12;373;Ozières;39;1;40
44;Grand Est;52;2;03;374;Le Pailly;284;5;289
44;Grand Est;52;2;03;375;Palaiseul;59;0;59
44;Grand Est;52;3;12;376;Pansey;97;3;100
44;Grand Est;52;2;02;377;Parnoy-en-Bassigny;299;8;307
44;Grand Est;52;3;12;378;Paroy-sur-Saulx;47;2;49
44;Grand Est;52;2;10;380;Peigney;376;2;378
44;Grand Est;52;2;10;383;Perrancey-les-Vieux-Moulins;293;7;300
44;Grand Est;52;2;16;384;Perrogney-les-Fontaines;114;0;114
44;Grand Est;52;1;02;385;Perrusse;31;2;33
44;Grand Est;52;3;13;386;Perthes;526;4;530
44;Grand Est;52;2;03;388;Pierremont-sur-Amance;143;0;143
44;Grand Est;52;2;03;390;Pisseloup;51;0;51
44;Grand Est;52;3;17;391;Planrupt;304;6;310
44;Grand Est;52;2;11;392;Plesnoy;115;2;117
44;Grand Est;52;2;16;393;Poinsenot;52;0;52
44;Grand Est;52;2;03;394;Poinson-lès-Fayl;222;9;231
44;Grand Est;52;2;16;395;Poinson-lès-Grancey;45;0;45
44;Grand Est;52;1;11;396;Poinson-lès-Nogent;143;3;146
44;Grand Est;52;2;11;397;Poiseul;71;1;72
44;Grand Est;52;3;12;398;Poissons;667;15;682
44;Grand Est;52;1;04;399;Pont-la-Ville;120;8;128
44;Grand Est;52;3;17;331;La Porte du Der;2278;65;2343
44;Grand Est;52;1;11;401;Poulangy;386;12;398
44;Grand Est;52;2;16;403;Praslay;74;1;75
44;Grand Est;52;2;03;406;Pressigny;200;5;205
44;Grand Est;52;1;12;407;Prez-sous-Lafauche;296;7;303
44;Grand Est;52;3;08;414;Rachecourt-sur-Marne;779;11;790
44;Grand Est;52;3;17;413;Rachecourt-Suzémont;105;2;107
44;Grand Est;52;1;02;416;Rangecourt;64;1;65
44;Grand Est;52;2;02;415;Rançonnières;106;1;107
44;Grand Est;52;1;04;419;Rennepont;136;5;141
44;Grand Est;52;1;01;420;Reynel;119;2;121
44;Grand Est;52;1;05;421;Riaucourt;473;9;482
44;Grand Est;52;1;04;422;Richebourg;274;5;279
44;Grand Est;52;1;01;423;Rimaucourt;671;8;679
44;Grand Est;52;3;17;411;Rives Dervoises;1371;53;1424
44;Grand Est;52;2;16;425;Rivière-les-Fosses;199;4;203
44;Grand Est;52;2;03;424;Rivières-le-Bois;73;0;73
44;Grand Est;52;1;04;426;Rizaucourt-Buchey;125;1;126
44;Grand Est;52;1;01;428;Rochefort-sur-la-Côte;64;1;65
44;Grand Est;52;3;01;044;Roches-Bettaincourt;570;13;583
44;Grand Est;52;3;08;429;Roches-sur-Marne;557;3;560
44;Grand Est;52;2;16;431;Rochetaillée;167;2;169
44;Grand Est;52;2;11;432;Rolampont;1478;30;1508
44;Grand Est;52;1;12;433;Romain-sur-Meuse;104;2;106
44;Grand Est;52;3;01;436;Rouécourt;47;3;50
44;Grand Est;52;2;16;437;Rouelles;25;0;25
44;Grand Est;52;2;03;438;Rougeux;110;2;112
44;Grand Est;52;2;16;439;Rouvres-sur-Aube;96;1;97
44;Grand Est;52;3;09;440;Rouvroy-sur-Marne;384;7;391
44;Grand Est;52;3;09;442;Rupt;338;6;344
44;Grand Est;52;3;12;443;Sailly;33;0;33
44;Grand Est;52;1;12;444;Saint-Blin;381;10;391
44;Grand Est;52;2;03;445;Saint-Broingt-le-Bois;71;2;73
44;Grand Est;52;2;16;446;Saint-Broingt-les-Fosses;232;4;236
44;Grand Est;52;2;10;447;Saint-Ciergues;189;2;191
44;Grand Est;52;3;99;448;Saint-Dizier;24012;558;24570
44;Grand Est;52;2;16;450;Saint-Loup-sur-Aujon;142;4;146
44;Grand Est;52;2;10;452;Saint-Martin-lès-Langres;111;4;115
44;Grand Est;52;2;10;453;Saint-Maurice;135;1;136
44;Grand Est;52;1;12;455;Saint-Thiébault;238;7;245
44;Grand Est;52;3;09;456;Saint-Urbain-Maconcourt;643;11;654
44;Grand Est;52;2;03;457;Saint-Vallier-sur-Marne;176;3;179
44;Grand Est;52;2;10;449;Saints-Geosmes;1129;33;1162
44;Grand Est;52;1;11;459;Sarcey;113;1;114
44;Grand Est;52;2;02;461;Sarrey;376;10;386
44;Grand Est;52;3;12;463;Saudron;46;1;47
44;Grand Est;52;2;03;464;Saulles;46;1;47
44;Grand Est;52;2;02;465;Saulxures;128;0;128
44;Grand Est;52;2;03;467;Savigny;59;2;61
44;Grand Est;52;1;12;468;Semilly;108;4;112
44;Grand Est;52;1;07;469;Semoutiers-Montsaon;769;15;784
44;Grand Est;52;2;02;470;Serqueux;413;13;426
44;Grand Est;52;1;01;472;Sexfontaines;133;0;133
44;Grand Est;52;1;01;473;Signéville;89;1;90
44;Grand Est;52;1;04;474;Silvarouvres;39;0;39
44;Grand Est;52;3;08;475;Sommancourt;68;1;69
44;Grand Est;52;1;12;476;Sommerécourt;78;4;82
44;Grand Est;52;3;17;479;Sommevoire;693;19;712
44;Grand Est;52;1;01;480;Soncourt-sur-Marne;371;8;379
44;Grand Est;52;1;12;482;Soulaucourt-sur-Mouzon;98;2;100
44;Grand Est;52;2;03;483;Soyers;62;1;63
44;Grand Est;52;3;09;484;Suzannecourt;370;14;384
44;Grand Est;52;2;16;486;Ternat;63;0;63
44;Grand Est;52;3;17;487;Thilleux;76;3;79
44;Grand Est;52;1;11;488;Thivet;272;0;272
44;Grand Est;52;1;12;489;Thol-lès-Millières;34;1;35
44;Grand Est;52;3;09;490;Thonnance-lès-Joinville;717;21;738
44;Grand Est;52;3;12;491;Thonnance-les-Moulins;114;5;119
44;Grand Est;52;2;03;492;Torcenay;551;15;566
44;Grand Est;52;2;03;493;Tornay;32;0;32
44;Grand Est;52;1;05;494;Treix;230;6;236
44;Grand Est;52;3;09;495;Trémilly;86;2;88
44;Grand Est;52;3;08;497;Troisfontaines-la-Ville;429;9;438
44;Grand Est;52;2;16;499;Vaillant;42;1;43
44;Grand Est;52;2;16;189;Le Val-d'Esnoms;389;11;400
44;Grand Est;52;2;02;332;Val-de-Meuse;1861;54;1915
44;Grand Est;52;3;13;500;Valcourt;621;9;630
44;Grand Est;52;3;08;502;Valleret;61;0;61
44;Grand Est;52;2;03;503;Valleroy;23;0;23
44;Grand Est;52;2;16;094;Vals-des-Tilles;167;1;168
44;Grand Est;52;2;03;504;Varennes-sur-Amance;269;4;273
44;Grand Est;52;1;12;505;Vaudrecourt;35;0;35
44;Grand Est;52;1;04;506;Vaudrémont;102;3;105
44;Grand Est;52;3;17;510;Vaux-sur-Blaise;376;7;383
44;Grand Est;52;3;09;511;Vaux-sur-Saint-Urbain;57;2;59
44;Grand Est;52;2;16;507;Vauxbons;60;0;60
44;Grand Est;52;3;09;512;Vecqueville;529;15;544
44;Grand Est;52;2;03;513;Velles;66;1;67
44;Grand Est;52;1;07;514;Verbiesles;332;10;342
44;Grand Est;52;2;16;515;Verseilles-le-Bas;102;4;106
44;Grand Est;52;2;16;516;Verseilles-le-Haut;48;1;49
44;Grand Est;52;1;12;517;Vesaignes-sous-Lafauche;128;1;129
44;Grand Est;52;1;11;518;Vesaignes-sur-Marne;104;2;106
44;Grand Est;52;2;16;519;Vesvres-sous-Chalancey;47;0;47
44;Grand Est;52;2;02;520;Vicq;151;6;157
44;Grand Est;52;1;01;522;Viéville;338;10;348
44;Grand Est;52;1;01;523;Vignes-la-Côte;64;4;68
44;Grand Est;52;1;01;524;Vignory;243;2;245
44;Grand Est;52;1;04;525;Villars-en-Azois;66;1;67
44;Grand Est;52;2;16;526;Villars-Santenoge;84;1;85
44;Grand Est;52;3;17;528;Ville-en-Blaisois;151;1;152
44;Grand Est;52;2;16;529;Villegusien-le-Lac;1002;17;1019
44;Grand Est;52;3;13;534;Villiers-en-Lieu;1529;33;1562
44;Grand Est;52;1;06;535;Villiers-le-Sec;711;11;722
44;Grand Est;52;2;16;536;Villiers-lès-Aprey;45;0;45
44;Grand Est;52;1;04;538;Villiers-sur-Suize;263;2;265
44;Grand Est;52;2;03;539;Violot;67;2;69
44;Grand Est;52;2;16;540;Vitry-en-Montagne;23;0;23
44;Grand Est;52;1;11;541;Vitry-lès-Nogent;186;4;190
44;Grand Est;52;2;16;542;Vivey;55;1;56
44;Grand Est;52;3;17;543;Voillecomte;532;10;542
44;Grand Est;52;2;02;544;Voisey;288;2;290
44;Grand Est;52;2;16;545;Voisines;101;2;103
44;Grand Est;52;2;03;546;Voncourt;16;0;16
44;Grand Est;52;1;01;547;Vouécourt;207;1;208
44;Grand Est;52;1;01;548;Vraincourt;92;2;94
44;Grand Est;52;1;12;549;Vroncourt-la-Côte;25;0;25
44;Grand Est;52;3;17;550;Wassy;2905;126;3031
52;Pays de la Loire;53;2;08;001;Ahuillé;1806;35;1841
52;Pays de la Loire;53;3;14;002;Alexain;601;9;610
52;Pays de la Loire;53;3;07;003;Ambrières-les-Vallées;2739;70;2809
52;Pays de la Loire;53;3;05;005;Andouillé;2300;49;2349
52;Pays de la Loire;53;2;02;007;Argentré;2814;94;2908
52;Pays de la Loire;53;3;09;008;Aron;1803;49;1852
52;Pays de la Loire;53;1;15;009;Arquenay;638;17;655
52;Pays de la Loire;53;3;06;010;Assé-le-Bérenger;450;13;463
52;Pays de la Loire;53;1;04;011;Astillé;870;14;884
52;Pays de la Loire;53;1;04;012;Athée;495;20;515
52;Pays de la Loire;53;3;17;013;Averton;585;16;601
52;Pays de la Loire;53;3;05;015;La Baconnière;1923;44;1967
52;Pays de la Loire;53;3;06;016;Bais;1239;21;1260
52;Pays de la Loire;53;1;04;018;Ballots;1281;31;1312
52;Pays de la Loire;53;1;15;019;Bannes;120;3;123
52;Pays de la Loire;53;3;09;021;La Bazoge-Montpinçon;1015;27;1042
52;Pays de la Loire;53;1;15;022;La Bazouge-de-Chemeré;516;10;526
52;Pays de la Loire;53;3;06;023;La Bazouge-des-Alleux;544;6;550
52;Pays de la Loire;53;1;15;025;Bazougers;1106;13;1119
52;Pays de la Loire;53;2;13;026;Beaulieu-sur-Oudon;519;9;528
52;Pays de la Loire;53;1;15;027;Beaumont-Pied-de-Bœuf;190;3;193
52;Pays de la Loire;53;3;09;028;Belgeard;616;8;624
52;Pays de la Loire;53;1;01;029;Bierné-les-Villages;1249;28;1277
52;Pays de la Loire;53;1;15;030;Le Bignon-du-Maine;336;8;344
52;Pays de la Loire;53;3;05;031;La Bigottière;498;2;500
52;Pays de la Loire;53;3;15;228;Blandouet-Saint Jean;605;19;624
52;Pays de la Loire;53;1;04;033;La Boissière;117;5;122
52;Pays de la Loire;53;2;02;034;Bonchamp-lès-Laval;6037;193;6230
52;Pays de la Loire;53;1;03;035;Bouchamps-lès-Craon;564;9;573
52;Pays de la Loire;53;1;15;036;Bouère;1090;20;1110
52;Pays de la Loire;53;1;15;037;Bouessay;736;19;755
52;Pays de la Loire;53;3;17;038;Boulay-les-Ifs;156;3;159
52;Pays de la Loire;53;2;13;039;Le Bourgneuf-la-Forêt;1778;37;1815
52;Pays de la Loire;53;2;13;040;Bourgon;640;10;650
52;Pays de la Loire;53;1;04;041;Brains-sur-les-Marches;269;5;274
52;Pays de la Loire;53;3;07;042;Brecé;824;13;837
52;Pays de la Loire;53;3;06;043;Brée;535;6;541
52;Pays de la Loire;53;2;13;045;La Brûlatte;697;18;715
52;Pays de la Loire;53;1;15;046;Le Buret;309;3;312
52;Pays de la Loire;53;3;07;047;Carelles;267;4;271
52;Pays de la Loire;53;3;05;048;Chailland;1171;34;1205
52;Pays de la Loire;53;2;02;049;Châlons-du-Maine;708;8;716
52;Pays de la Loire;53;3;09;051;Champéon;585;6;591
52;Pays de la Loire;53;3;17;052;Champfrémont;309;7;316
52;Pays de la Loire;53;3;06;053;Champgenéteux;515;20;535
52;Pays de la Loire;53;2;16;054;Changé;6020;191;6211
52;Pays de la Loire;53;3;07;055;Chantrigné;618;21;639
52;Pays de la Loire;53;2;02;056;La Chapelle-Anthenaise;1014;14;1028
52;Pays de la Loire;53;3;09;057;La Chapelle-au-Riboul;501;10;511
52;Pays de la Loire;53;1;04;058;La Chapelle-Craonnaise;352;8;360
52;Pays de la Loire;53;3;15;059;La Chapelle-Rainsouin;412;6;418
52;Pays de la Loire;53;3;09;061;Charchigné;481;6;487
52;Pays de la Loire;53;1;88;062;Château-Gontier-sur-Mayenne;16776;648;17424
52;Pays de la Loire;53;1;01;063;Châtelain;469;13;482
52;Pays de la Loire;53;3;07;064;Châtillon-sur-Colmont;1024;25;1049
52;Pays de la Loire;53;1;01;066;Chemazé;1361;32;1393
52;Pays de la Loire;53;1;15;067;Chémeré-le-Roi;402;11;413
52;Pays de la Loire;53;1;03;068;Chérancé;164;2;166
52;Pays de la Loire;53;3;17;069;Chevaigné-du-Maine;173;7;180
52;Pays de la Loire;53;3;07;071;Colombiers-du-Plessis;485;18;503
52;Pays de la Loire;53;3;09;072;Commer;1201;26;1227
52;Pays de la Loire;53;1;04;073;Congrier;896;25;921
52;Pays de la Loire;53;3;14;074;Contest;840;33;873
52;Pays de la Loire;53;1;04;075;Cosmes;282;7;289
52;Pays de la Loire;53;1;15;076;Cossé-en-Champagne;323;10;333
52;Pays de la Loire;53;1;04;077;Cossé-le-Vivien;3134;75;3209
52;Pays de la Loire;53;1;01;078;Coudray;855;16;871
52;Pays de la Loire;53;3;07;079;Couesmes-Vaucé;370;12;382
52;Pays de la Loire;53;3;17;080;Couptrain;131;2;133
52;Pays de la Loire;53;1;04;082;Courbeveille;640;5;645
52;Pays de la Loire;53;3;17;083;Courcité;906;21;927
52;Pays de la Loire;53;1;03;084;Craon;4507;178;4685
52;Pays de la Loire;53;3;17;085;Crennes-sur-Fraubée;193;2;195
52;Pays de la Loire;53;3;05;086;La Croixille;688;16;704
52;Pays de la Loire;53;1;15;087;La Cropte;211;4;215
52;Pays de la Loire;53;1;04;088;Cuillé;871;30;901
52;Pays de la Loire;53;1;01;089;Daon;502;5;507
52;Pays de la Loire;53;1;03;090;Denazé;162;5;167
52;Pays de la Loire;53;3;07;091;Désertines;466;14;480
52;Pays de la Loire;53;3;07;093;La Dorée;282;5;287
52;Pays de la Loire;53;2;08;094;Entrammes;2256;42;2298
52;Pays de la Loire;53;3;05;096;Ernée;5731;98;5829
52;Pays de la Loire;53;3;06;097;Évron;8671;232;8903
52;Pays de la Loire;53;1;04;098;Fontaine-Couverte;441;6;447
52;Pays de la Loire;53;2;08;099;Forcé;1099;32;1131
52;Pays de la Loire;53;3;07;100;Fougerolles-du-Plessis;1205;15;1220
52;Pays de la Loire;53;1;01;101;Fromentières;831;11;842
52;Pays de la Loire;53;1;04;102;Gastines;166;2;168
52;Pays de la Loire;53;2;13;103;Le Genest-Saint-Isle;2135;57;2192
52;Pays de la Loire;53;1;01;104;Gennes-Longuefuye;1327;24;1351
52;Pays de la Loire;53;3;15;105;Gesnes;228;5;233
52;Pays de la Loire;53;3;17;106;Gesvres;519;11;530
52;Pays de la Loire;53;3;07;107;Gorron;2560;55;2615
52;Pays de la Loire;53;2;13;108;La Gravelle;546;6;552
52;Pays de la Loire;53;3;09;109;Grazay;615;18;633
52;Pays de la Loire;53;1;15;110;Grez-en-Bouère;1011;19;1030
52;Pays de la Loire;53;3;09;111;La Haie-Traversaine;472;13;485
52;Pays de la Loire;53;3;17;112;Le Ham;395;8;403
52;Pays de la Loire;53;3;06;113;Hambers;609;14;623
52;Pays de la Loire;53;3;09;114;Hardanges;203;1;204
52;Pays de la Loire;53;3;07;115;Hercé;312;12;324
52;Pays de la Loire;53;3;09;116;Le Horps;744;20;764
52;Pays de la Loire;53;1;01;117;Houssay;491;5;496
52;Pays de la Loire;53;3;09;118;Le Housseau-Brétignolles;247;1;248
52;Pays de la Loire;53;2;08;119;L' Huisserie;4244;153;4397
52;Pays de la Loire;53;3;06;120;Izé;458;9;467
52;Pays de la Loire;53;3;17;121;Javron-les-Chapelles;1378;29;1407
52;Pays de la Loire;53;3;09;122;Jublains;734;16;750
52;Pays de la Loire;53;3;05;123;Juvigné;1456;14;1470
52;Pays de la Loire;53;3;07;125;Landivy;1149;22;1171
52;Pays de la Loire;53;3;05;126;Larchamp;1110;17;1127
52;Pays de la Loire;53;3;09;127;Lassay-les-Châteaux;2253;62;2315
52;Pays de la Loire;53;1;04;128;Laubrières;356;4;360
52;Pays de la Loire;53;2;13;129;Launay-Villiers;385;5;390
52;Pays de la Loire;53;2;99;130;Laval;49728;2556;52284
52;Pays de la Loire;53;3;07;131;Lesbois;194;2;196
52;Pays de la Loire;53;3;07;132;Levaré;289;11;300
52;Pays de la Loire;53;3;17;133;Lignières-Orgères;742;16;758
52;Pays de la Loire;53;3;06;134;Livet;158;1;159
52;Pays de la Loire;53;1;04;135;Livré-la-Touche;745;20;765
52;Pays de la Loire;53;2;13;137;Loiron-Ruillé;2667;61;2728
52;Pays de la Loire;53;3;17;139;Loupfougères;408;6;414
52;Pays de la Loire;53;2;02;140;Louverné;4302;94;4396
52;Pays de la Loire;53;2;08;141;Louvigné;1146;21;1167
52;Pays de la Loire;53;3;17;142;Madré;293;6;299
52;Pays de la Loire;53;1;15;143;Maisoncelles-du-Maine;517;10;527
52;Pays de la Loire;53;3;09;144;Marcillé-la-Ville;798;24;822
52;Pays de la Loire;53;1;03;145;Marigné-Peuton;548;14;562
52;Pays de la Loire;53;3;09;146;Martigné-sur-Mayenne;1853;28;1881
52;Pays de la Loire;53;3;14;147;Mayenne;12841;710;13551
52;Pays de la Loire;53;1;03;148;Mée;226;1;227
52;Pays de la Loire;53;1;01;150;Ménil;939;29;968
52;Pays de la Loire;53;1;04;151;Méral;1098;15;1113
52;Pays de la Loire;53;1;15;152;Meslay-du-Maine;2875;70;2945
52;Pays de la Loire;53;3;06;153;Mézangers;657;13;670
52;Pays de la Loire;53;3;07;154;Montaudin;908;15;923
52;Pays de la Loire;53;3;05;155;Montenay;1361;24;1385
52;Pays de la Loire;53;2;02;156;Montflours;253;8;261
52;Pays de la Loire;53;2;08;157;Montigné-le-Brillant;1277;51;1328
52;Pays de la Loire;53;2;13;158;Montjean;1036;20;1056
52;Pays de la Loire;53;3;09;160;Montreuil-Poulay;371;11;382
52;Pays de la Loire;53;3;89;161;Montsûrs;3227;61;3288
52;Pays de la Loire;53;3;09;162;Moulay;963;17;980
52;Pays de la Loire;53;3;06;163;Neau;774;3;777
52;Pays de la Loire;53;3;17;164;Neuilly-le-Vendin;346;8;354
52;Pays de la Loire;53;1;03;165;Niafles;350;7;357
52;Pays de la Loire;53;2;08;168;Nuillé-sur-Vicoin;1210;26;1236
52;Pays de la Loire;53;3;07;170;Oisseau;1184;25;1209
52;Pays de la Loire;53;2;13;169;Olivet;417;10;427
52;Pays de la Loire;53;1;01;172;Origné;423;5;428
52;Pays de la Loire;53;3;17;173;La Pallu;193;6;199
52;Pays de la Loire;53;3;14;174;Parigné-sur-Braye;847;18;865
52;Pays de la Loire;53;2;08;175;Parné-sur-Roc;1348;29;1377
52;Pays de la Loire;53;3;07;176;Le Pas;548;11;559
52;Pays de la Loire;53;3;05;177;La Pellerine;340;5;345
52;Pays de la Loire;53;1;03;178;Peuton;227;10;237
52;Pays de la Loire;53;3;14;179;Placé;340;8;348
52;Pays de la Loire;53;1;03;180;Pommerieux;652;28;680
52;Pays de la Loire;53;3;07;181;Pontmain;825;13;838
52;Pays de la Loire;53;2;13;182;Port-Brillet;1801;28;1829
52;Pays de la Loire;53;3;17;185;Pré-en-Pail-Saint-Samson;2331;78;2409
52;Pays de la Loire;53;1;15;184;Préaux;166;7;173
52;Pays de la Loire;53;1;03;124;Prée-d'Anjou;1421;45;1466
52;Pays de la Loire;53;1;04;186;Quelaines-Saint-Gault;2157;65;2222
52;Pays de la Loire;53;3;17;187;Ravigny;233;12;245
52;Pays de la Loire;53;1;04;188;Renazé;2541;33;2574
52;Pays de la Loire;53;3;09;189;Rennes-en-Grenouilles;107;2;109
52;Pays de la Loire;53;3;09;190;Le Ribay;460;10;470
52;Pays de la Loire;53;1;01;136;La Roche-Neuville;1167;38;1205
52;Pays de la Loire;53;1;04;191;La Roë;245;2;247
52;Pays de la Loire;53;1;04;192;La Rouaudière;328;4;332
52;Pays de la Loire;53;1;15;193;Ruillé-Froid-Fonds;569;12;581
52;Pays de la Loire;53;3;02;195;Sacé;499;8;507
52;Pays de la Loire;53;3;17;196;Saint-Aignan-de-Couptrain;374;10;384
52;Pays de la Loire;53;1;04;197;Saint-Aignan-sur-Roë;894;24;918
52;Pays de la Loire;53;3;17;198;Saint-Aubin-du-Désert;240;7;247
52;Pays de la Loire;53;3;07;199;Saint-Aubin-Fosse-Louvain;217;6;223
52;Pays de la Loire;53;3;14;200;Saint-Baudelle;1119;43;1162
52;Pays de la Loire;53;2;16;201;Saint-Berthevin;7344;241;7585
52;Pays de la Loire;53;3;07;202;Saint-Berthevin-la-Tannière;332;3;335
52;Pays de la Loire;53;1;15;203;Saint-Brice;528;13;541
52;Pays de la Loire;53;3;17;204;Saint-Calais-du-Désert;387;7;394
52;Pays de la Loire;53;1;15;206;Saint-Charles-la-Forêt;203;10;213
52;Pays de la Loire;53;3;17;208;Saint-Cyr-en-Pail;490;17;507
52;Pays de la Loire;53;2;13;209;Saint-Cyr-le-Gravelais;544;14;558
52;Pays de la Loire;53;1;01;210;Saint-Denis-d'Anjou;1558;29;1587
52;Pays de la Loire;53;3;05;211;Saint-Denis-de-Gastines;1509;35;1544
52;Pays de la Loire;53;1;15;212;Saint-Denis-du-Maine;428;9;437
52;Pays de la Loire;53;3;07;213;Saint-Ellier-du-Maine;510;8;518
52;Pays de la Loire;53;1;04;214;Saint-Erblon;172;4;176
52;Pays de la Loire;53;3;09;216;Saint-Fraimbault-de-Prières;1001;26;1027
52;Pays de la Loire;53;3;14;219;Saint-Georges-Buttavent;1443;39;1482
52;Pays de la Loire;53;3;15;220;Saint-Georges-le-Fléchard;418;12;430
52;Pays de la Loire;53;3;06;221;Saint-Georges-sur-Erve;385;10;395
52;Pays de la Loire;53;3;14;222;Saint-Germain-d'Anxure;388;9;397
52;Pays de la Loire;53;3;17;223;Saint-Germain-de-Coulamer;348;11;359
52;Pays de la Loire;53;2;16;224;Saint-Germain-le-Fouilloux;1166;31;1197
52;Pays de la Loire;53;3;05;225;Saint-Germain-le-Guillaume;495;10;505
52;Pays de la Loire;53;3;05;226;Saint-Hilaire-du-Maine;863;24;887
52;Pays de la Loire;53;2;16;229;Saint-Jean-sur-Mayenne;1653;49;1702
52;Pays de la Loire;53;3;09;230;Saint-Julien-du-Terroux;235;9;244
52;Pays de la Loire;53;3;15;232;Saint-Léger;308;3;311
52;Pays de la Loire;53;1;15;233;Saint-Loup-du-Dorat;364;2;366
52;Pays de la Loire;53;3;07;234;Saint-Loup-du-Gast;365;13;378
52;Pays de la Loire;53;3;17;236;Saint-Mars-du-Désert;166;1;167
52;Pays de la Loire;53;3;07;237;Saint-Mars-sur-Colmont;469;13;482
52;Pays de la Loire;53;3;07;238;Saint-Mars-sur-la-Futaie;538;10;548
52;Pays de la Loire;53;3;06;239;Saint-Martin-de-Connée;421;8;429
52;Pays de la Loire;53;1;04;240;Saint-Martin-du-Limet;444;6;450
52;Pays de la Loire;53;1;04;242;Saint-Michel-de-la-Roë;265;9;274
52;Pays de la Loire;53;2;13;243;Saint-Ouën-des-Toits;1749;35;1784
52;Pays de la Loire;53;3;05;245;Saint-Pierre-des-Landes;928;27;955
52;Pays de la Loire;53;3;17;246;Saint-Pierre-des-Nids;1990;27;2017
52;Pays de la Loire;53;2;13;247;Saint-Pierre-la-Cour;2170;43;2213
52;Pays de la Loire;53;3;15;248;Saint-Pierre-sur-Erve;142;1;143
52;Pays de la Loire;53;3;06;249;Saint-Pierre-sur-Orthe;463;10;473
52;Pays de la Loire;53;1;04;250;Saint-Poix;405;6;411
52;Pays de la Loire;53;1;03;251;Saint-Quentin-les-Anges;435;7;442
52;Pays de la Loire;53;1;04;253;Saint-Saturnin-du-Limet;508;13;521
52;Pays de la Loire;53;3;06;256;Saint-Thomas-de-Courceriers;185;4;189
52;Pays de la Loire;53;3;06;218;Sainte-Gemmes-le-Robert;851;27;878
52;Pays de la Loire;53;3;09;235;Sainte-Marie-du-Bois;217;4;221
52;Pays de la Loire;53;3;15;255;Sainte-Suzanne-et-Chammes;1280;31;1311
52;Pays de la Loire;53;3;15;257;Saulges;318;4;322
52;Pays de la Loire;53;1;04;258;La Selle-Craonnaise;941;29;970
52;Pays de la Loire;53;1;04;259;Senonnes;357;8;365
52;Pays de la Loire;53;1;04;260;Simplé;452;4;456
52;Pays de la Loire;53;3;07;261;Soucé;164;3;167
52;Pays de la Loire;53;2;08;262;Soulgé-sur-Ouette;1084;31;1115
52;Pays de la Loire;53;3;15;264;Thorigné-en-Charnie;195;3;198
52;Pays de la Loire;53;3;09;263;Thubœuf;289;8;297
52;Pays de la Loire;53;3;15;265;Torcé-Viviers-en-Charnie;756;15;771
52;Pays de la Loire;53;3;06;266;Trans;232;4;236
52;Pays de la Loire;53;3;15;267;Vaiges;1167;13;1180
52;Pays de la Loire;53;1;15;017;Val-du-Maine;929;28;957
52;Pays de la Loire;53;3;05;269;Vautorte;599;5;604
52;Pays de la Loire;53;3;07;270;Vieuvy;118;8;126
52;Pays de la Loire;53;3;17;271;Villaines-la-Juhel;2808;43;2851
52;Pays de la Loire;53;3;17;272;Villepail;177;1;178
52;Pays de la Loire;53;1;15;273;Villiers-Charlemagne;1122;23;1145
52;Pays de la Loire;53;3;06;274;Vimarcé;237;1;238
52;Pays de la Loire;53;3;06;276;Voutré;910;14;924
44;Grand Est;54;3;02;001;Abaucourt;299;4;303
44;Grand Est;54;1;17;002;Abbéville-lès-Conflans;226;4;230
44;Grand Est;54;4;10;003;Aboncourt;103;2;105
44;Grand Est;54;1;17;004;Affléville;179;2;181
44;Grand Est;54;3;10;005;Affracourt;110;1;111
44;Grand Est;54;3;03;006;Agincourt;438;7;445
44;Grand Est;54;4;16;007;Aingeray;543;4;547
44;Grand Est;54;4;10;008;Allain;478;14;492
44;Grand Est;54;1;04;009;Allamont;158;3;161
44;Grand Est;54;4;10;010;Allamps;510;14;524
44;Grand Est;54;1;11;011;Allondrelle-la-Malmaison;644;2;646
44;Grand Est;54;3;03;012;Amance;340;5;345
44;Grand Est;54;2;01;013;Amenoncourt;77;3;80
44;Grand Est;54;2;01;014;Ancerviller;282;15;297
44;Grand Est;54;1;17;015;Anderny;254;6;260
44;Grand Est;54;4;16;016;Andilly;286;7;293
44;Grand Est;54;2;01;017;Angomont;78;1;79
44;Grand Est;54;1;17;018;Anoux;265;8;273
44;Grand Est;54;4;16;019;Ansauville;82;1;83
44;Grand Est;54;2;08;020;Anthelupt;461;5;466
44;Grand Est;54;3;02;021;Armaucourt;225;2;227
44;Grand Est;54;4;18;022;Arnaville;565;7;572
44;Grand Est;54;2;01;023;Arracourt;246;2;248
44;Grand Est;54;3;02;024;Arraye-et-Han;359;7;366
44;Grand Est;54;3;03;025;Art-sur-Meurthe;1470;243;1713
44;Grand Est;54;2;01;026;Athienville;176;3;179
44;Grand Est;54;3;18;027;Atton;832;12;844
44;Grand Est;54;1;04;028;Auboué;2514;29;2543
44;Grand Est;54;1;17;029;Audun-le-Roman;2462;50;2512
44;Grand Est;54;2;01;030;Autrepierre;82;0;82
44;Grand Est;54;3;02;031;Autreville-sur-Moselle;277;5;282
44;Grand Est;54;3;10;032;Autrey;186;2;188
44;Grand Est;54;1;17;033;Avillers;123;0;123
44;Grand Est;54;4;16;034;Avrainville;219;10;229
44;Grand Est;54;2;01;035;Avricourt;386;3;389
44;Grand Est;54;1;17;036;Avril;1131;15;1146
44;Grand Est;54;3;05;037;Azelot;422;2;424
44;Grand Est;54;2;01;038;Azerailles;771;18;789
44;Grand Est;54;2;01;039;Baccarat;4330;62;4392
44;Grand Est;54;2;01;040;Badonviller;1551;31;1582
44;Grand Est;54;4;10;041;Bagneux;160;5;165
44;Grand Est;54;3;10;042;Bainville-aux-Miroirs;305;1;306
44;Grand Est;54;3;15;043;Bainville-sur-Madon;1396;13;1409
44;Grand Est;54;2;01;044;Barbas;191;2;193
44;Grand Est;54;2;09;045;Barbonville;437;7;444
44;Grand Est;54;4;10;046;Barisey-au-Plain;399;7;406
44;Grand Est;54;4;10;047;Barisey-la-Côte;226;3;229
44;Grand Est;54;1;17;048;Les Baroches;351;14;365
44;Grand Est;54;1;11;049;Baslieux;581;15;596
44;Grand Est;54;2;01;050;Bathelémont;64;1;65
44;Grand Est;54;1;04;051;Batilly;1261;19;1280
44;Grand Est;54;4;10;052;Battigny;142;2;144
44;Grand Est;54;2;08;053;Bauzemont;154;6;160
44;Grand Est;54;2;09;054;Bayon;1610;16;1626
44;Grand Est;54;4;18;055;Bayonville-sur-Mad;301;5;306
44;Grand Est;54;1;11;056;Bazailles;142;2;144
44;Grand Est;54;4;16;057;Beaumont;72;0;72
44;Grand Est;54;1;17;058;Béchamps;86;2;88
44;Grand Est;54;3;02;059;Belleau;746;9;755
44;Grand Est;54;3;02;060;Belleville;1441;17;1458
44;Grand Est;54;2;01;061;Bénaménil;583;11;594
44;Grand Est;54;3;10;062;Benney;650;11;661
44;Grand Est;54;4;16;063;Bernécourt;179;5;184
44;Grand Est;54;2;01;064;Bertrambois;308;6;314
44;Grand Est;54;2;01;065;Bertrichamps;1094;23;1117
44;Grand Est;54;1;17;066;Bettainvillers;391;2;393
44;Grand Est;54;1;11;067;Beuveille;760;11;771
44;Grand Est;54;4;10;068;Beuvezin;96;2;98
44;Grand Est;54;1;17;069;Beuvillers;424;8;432
44;Grand Est;54;3;02;070;Bey-sur-Seille;169;0;169
44;Grand Est;54;2;01;071;Bezange-la-Grande;158;1;159
44;Grand Est;54;3;02;072;Bezaumont;263;5;268
44;Grand Est;54;4;20;073;Bicqueley;902;16;918
44;Grand Est;54;2;08;074;Bienville-la-Petite;34;0;34
44;Grand Est;54;2;01;075;Bionville;116;4;120
44;Grand Est;54;2;09;076;Blainville-sur-l'Eau;4035;24;4059
44;Grand Est;54;2;01;077;Blâmont;1072;12;1084
44;Grand Est;54;2;01;078;Blémerey;63;1;64
44;Grand Est;54;3;18;079;Blénod-lès-Pont-à-Mousson;4601;47;4648
44;Grand Est;54;4;10;080;Blénod-lès-Toul;1078;20;1098
44;Grand Est;54;4;16;557;Bois-de-Haye;2257;102;2359
44;Grand Est;54;1;11;081;Boismont;415;6;421
44;Grand Est;54;1;04;082;Boncourt;174;3;177
44;Grand Est;54;2;08;083;Bonviller;183;3;186
44;Grand Est;54;2;09;085;Borville;97;2;99
44;Grand Est;54;4;16;086;Boucq;356;11;367
44;Grand Est;54;4;16;087;Bouillonville;156;3;159
44;Grand Est;54;4;16;088;Bouvron;241;1;242
44;Grand Est;54;3;03;089;Bouxières-aux-Chênes;1422;20;1442
44;Grand Est;54;3;02;090;Bouxières-aux-Dames;4216;39;4255
44;Grand Est;54;3;18;091;Bouxières-sous-Froidmont;369;4;373
44;Grand Est;54;3;10;092;Bouzanville;62;0;62
44;Grand Est;54;1;04;093;Brainville;160;2;162
44;Grand Est;54;3;10;094;Bralleville;174;3;177
44;Grand Est;54;3;02;095;Bratte;44;0;44
44;Grand Est;54;1;23;096;Bréhain-la-Ville;412;5;417
44;Grand Est;54;2;01;097;Bréménil;109;5;114
44;Grand Est;54;2;09;098;Brémoncourt;167;3;170
44;Grand Est;54;3;02;100;Brin-sur-Seille;783;11;794
44;Grand Est;54;2;01;101;Brouville;132;1;133
44;Grand Est;54;4;16;102;Bruley;610;6;616
44;Grand Est;54;1;04;103;Bruville;226;5;231
44;Grand Est;54;3;03;104;Buissoncourt;265;2;267
44;Grand Est;54;4;10;105;Bulligny;531;15;546
44;Grand Est;54;2;01;106;Bures;62;2;64
44;Grand Est;54;2;01;107;Buriville;74;3;77
44;Grand Est;54;3;05;108;Burthecourt-aux-Chênes;113;3;116
44;Grand Est;54;3;10;109;Ceintrey;925;9;934
44;Grand Est;54;3;03;110;Cerville;566;12;578
44;Grand Est;54;3;15;111;Chaligny;2858;23;2881
44;Grand Est;54;1;04;112;Chambley-Bussières;695;9;704
44;Grand Est;54;3;03;113;Champenoux;1415;16;1431
44;Grand Est;54;3;18;114;Champey-sur-Moselle;343;4;347
44;Grand Est;54;3;21;115;Champigneulles;6745;70;6815
44;Grand Est;54;2;09;116;Chanteheux;2143;42;2185
44;Grand Est;54;3;10;117;Chaouilley;112;1;113
44;Grand Est;54;1;11;118;Charency-Vezin;616;9;625
44;Grand Est;54;4;16;119;Charey;82;3;85
44;Grand Est;54;4;20;120;Charmes-la-Côte;335;8;343
44;Grand Est;54;2;09;121;Charmois;190;1;191
44;Grand Est;54;4;20;122;Chaudeney-sur-Moselle;709;17;726
44;Grand Est;54;3;15;123;Chavigny;1843;14;1857
44;Grand Est;54;2;01;124;Chazelles-sur-Albe;44;0;44
44;Grand Est;54;2;01;125;Chenevières;495;9;504
44;Grand Est;54;3;02;126;Chenicourt;227;1;228
44;Grand Est;54;1;07;127;Chenières;632;17;649
44;Grand Est;54;4;20;128;Choloy-Ménillot;736;10;746
44;Grand Est;54;2;01;129;Cirey-sur-Vezouze;1644;26;1670
44;Grand Est;54;2;09;130;Clayeures;187;1;188
44;Grand Est;54;3;02;131;Clémery;495;14;509
44;Grand Est;54;3;10;132;Clérey-sur-Brenon;67;2;69
44;Grand Est;54;2;01;133;Coincourt;128;4;132
44;Grand Est;54;1;11;134;Colmey;250;7;257
44;Grand Est;54;4;10;135;Colombey-les-Belles;1459;21;1480
44;Grand Est;54;1;04;136;Conflans-en-Jarnisy;2359;34;2393
44;Grand Est;54;1;11;137;Cons-la-Grandville;523;17;540
44;Grand Est;54;1;11;138;Cosnes-et-Romain;2690;55;2745
44;Grand Est;54;2;08;139;Courbesseaux;337;3;340
44;Grand Est;54;4;10;140;Courcelles;104;3;107
44;Grand Est;54;3;05;141;Coyviller;141;1;142
44;Grand Est;54;3;10;142;Crantenoy;152;2;154
44;Grand Est;54;4;10;143;Crépey;394;7;401
44;Grand Est;54;3;10;144;Crévéchamps;393;2;395
44;Grand Est;54;2;08;145;Crévic;913;12;925
44;Grand Est;54;4;10;146;Crézilles;282;3;285
44;Grand Est;54;2;08;147;Crion;96;0;96
44;Grand Est;54;2;08;148;Croismare;640;8;648
44;Grand Est;54;1;23;149;Crusnes;1579;12;1591
44;Grand Est;54;3;02;150;Custines;3079;26;3105
44;Grand Est;54;1;07;151;Cutry;1033;28;1061
44;Grand Est;54;2;09;152;Damelevières;3217;44;3261
44;Grand Est;54;1;04;153;Dampvitoux;58;0;58
44;Grand Est;54;2;01;154;Deneuvre;522;15;537
44;Grand Est;54;2;08;155;Deuxville;423;7;430
44;Grand Est;54;3;10;156;Diarville;539;5;544
44;Grand Est;54;3;02;157;Dieulouard;4763;44;4807
44;Grand Est;54;4;10;158;Dolcourt;129;2;131
44;Grand Est;54;3;08;159;Dombasle-sur-Meurthe;9734;192;9926
44;Grand Est;54;4;16;160;Domèvre-en-Haye;385;9;394
44;Grand Est;54;2;01;161;Domèvre-sur-Vezouze;296;10;306
44;Grand Est;54;4;20;162;Domgermain;1185;13;1198
44;Grand Est;54;2;01;163;Domjevin;256;2;258
44;Grand Est;54;3;10;164;Dommarie-Eulmont;87;2;89
44;Grand Est;54;3;19;165;Dommartemont;585;28;613
44;Grand Est;54;4;16;166;Dommartin-la-Chaussée;34;2;36
44;Grand Est;54;4;20;167;Dommartin-lès-Toul;1984;39;2023
44;Grand Est;54;3;03;168;Dommartin-sous-Amance;278;2;280
44;Grand Est;54;1;17;169;Domprix;87;3;90
44;Grand Est;54;2;09;170;Domptail-en-l'Air;71;1;72
44;Grand Est;54;1;04;171;Doncourt-lès-Conflans;1185;21;1206
44;Grand Est;54;1;11;172;Doncourt-lès-Longuyon;298;7;305
44;Grand Est;54;2;08;173;Drouville;205;4;209
44;Grand Est;54;4;20;174;Écrouves;4376;52;4428
44;Grand Est;54;2;09;175;Einvaux;363;3;366
44;Grand Est;54;2;08;176;Einville-au-Jard;1183;23;1206
44;Grand Est;54;2;01;177;Emberménil;260;3;263
44;Grand Est;54;1;11;178;Épiez-sur-Chiers;185;3;188
44;Grand Est;54;3;02;179;Éply;300;8;308
44;Grand Est;54;3;03;180;Erbéviller-sur-Amezule;76;2;78
44;Grand Est;54;1;23;181;Errouville;724;17;741
44;Grand Est;54;4;16;182;Essey-et-Maizerais;360;11;371
44;Grand Est;54;2;09;183;Essey-la-Côte;81;0;81
44;Grand Est;54;3;19;184;Essey-lès-Nancy;8823;160;8983
44;Grand Est;54;3;10;185;Étreval;61;1;62
44;Grand Est;54;3;03;186;Eulmont;1080;20;1100
44;Grand Est;54;4;16;187;Euvezin;111;1;112
44;Grand Est;54;3;02;188;Faulx;1344;10;1354
44;Grand Est;54;4;10;189;Favières;591;9;600
44;Grand Est;54;4;10;190;Fécocourt;109;2;111
44;Grand Est;54;2;01;191;Fenneviller;95;2;97
44;Grand Est;54;3;09;192;Ferrières;296;4;300
44;Grand Est;54;3;18;193;Fey-en-Haye;78;1;79
44;Grand Est;54;1;23;194;Fillières;510;8;518
44;Grand Est;54;2;08;195;Flainval;204;0;204
44;Grand Est;54;3;15;196;Flavigny-sur-Moselle;1743;130;1873
44;Grand Est;54;3;05;197;Fléville-devant-Nancy;2263;27;2290
44;Grand Est;54;1;17;198;Fléville-Lixières;320;3;323
44;Grand Est;54;2;01;199;Flin;378;11;389
44;Grand Est;54;4;16;200;Flirey;151;1;152
44;Grand Est;54;2;01;201;Fontenoy-la-Joûte;315;5;320
44;Grand Est;54;4;16;202;Fontenoy-sur-Moselle;374;5;379
44;Grand Est;54;3;10;203;Forcelles-Saint-Gorgon;143;3;146
44;Grand Est;54;3;10;204;Forcelles-sous-Gugney;94;2;96
44;Grand Est;54;4;20;205;Foug;2663;29;2692
44;Grand Est;54;2;09;206;Fraimbois;386;6;392
44;Grand Est;54;3;10;207;Fraisnes-en-Saintois;104;2;106
44;Grand Est;54;4;16;208;Francheville;281;2;283
44;Grand Est;54;2;09;209;Franconville;85;0;85
44;Grand Est;54;2;01;210;Fréménil;216;4;220
44;Grand Est;54;2;01;211;Frémonville;187;2;189
44;Grand Est;54;1;11;212;Fresnois-la-Montagne;409;14;423
44;Grand Est;54;1;04;213;Friauville;367;5;372
44;Grand Est;54;3;15;214;Frolois;708;8;716
44;Grand Est;54;3;21;215;Frouard;6563;74;6637
44;Grand Est;54;2;09;216;Froville;125;0;125
44;Grand Est;54;2;01;217;Gélacourt;167;2;169
44;Grand Est;54;4;10;218;Gélaucourt;68;0;68
44;Grand Est;54;3;03;219;Gellenoncourt;77;0;77
44;Grand Est;54;4;10;220;Gémonville;75;0;75
44;Grand Est;54;3;10;221;Gerbécourt-et-Haplemont;230;1;231
44;Grand Est;54;2;09;222;Gerbéviller;1342;26;1368
44;Grand Est;54;4;10;223;Germiny;219;7;226
44;Grand Est;54;3;10;224;Germonville;115;1;116
44;Grand Est;54;4;16;225;Gézoncourt;177;3;180
44;Grand Est;54;4;10;226;Gibeaumeix;164;3;167
44;Grand Est;54;1;04;227;Giraumont;1320;17;1337
44;Grand Est;54;2;09;228;Giriviller;70;0;70
44;Grand Est;54;2;01;229;Glonville;359;5;364
44;Grand Est;54;2;01;230;Gogney;46;1;47
44;Grand Est;54;1;17;231;Gondrecourt-Aix;177;3;180
44;Grand Est;54;4;16;232;Gondreville;2801;30;2831
44;Grand Est;54;2;01;233;Gondrexon;43;2;45
44;Grand Est;54;1;11;234;Gorcy;2763;43;2806
44;Grand Est;54;3;10;235;Goviller;425;9;434
44;Grand Est;54;1;11;236;Grand-Failly;334;8;342
44;Grand Est;54;4;10;237;Grimonviller;89;3;92
44;Grand Est;54;3;10;238;Gripport;285;1;286
44;Grand Est;54;4;16;239;Griscourt;132;2;134
44;Grand Est;54;4;16;240;Grosrouvres;63;0;63
44;Grand Est;54;3;10;241;Gugney;76;3;79
44;Grand Est;54;4;20;242;Gye;251;4;255
44;Grand Est;54;2;01;243;Hablainville;219;7;226
44;Grand Est;54;1;04;244;Hagéville;113;3;116
44;Grand Est;54;2;09;245;Haigneville;58;0;58
44;Grand Est;54;2;01;246;Halloville;71;6;77
44;Grand Est;54;3;10;247;Hammeville;177;4;181
44;Grand Est;54;4;16;248;Hamonville;96;1;97
44;Grand Est;54;1;11;602;Han-devant-Pierrepont;152;0;152
44;Grand Est;54;1;04;249;Hannonville-Suzémont;259;5;264
44;Grand Est;54;3;03;250;Haraucourt;734;4;738
44;Grand Est;54;2;01;251;Harbouey;118;1;119
44;Grand Est;54;3;10;252;Haroué;510;6;516
44;Grand Est;54;1;04;253;Hatrize;769;13;782
44;Grand Est;54;1;07;254;Haucourt-Moulaine;3241;42;3283
44;Grand Est;54;2;09;255;Haudonville;87;6;93
44;Grand Est;54;2;09;256;Haussonville;303;8;311
44;Grand Est;54;3;05;257;Heillecourt;5527;84;5611
44;Grand Est;54;2;08;258;Hénaménil;147;3;150
44;Grand Est;54;2;01;259;Herbéviller;236;2;238
44;Grand Est;54;2;09;260;Hériménil;956;18;974
44;Grand Est;54;1;07;261;Herserange;4390;47;4437
44;Grand Est;54;2;08;262;Hoéville;198;0;198
44;Grand Est;54;1;04;263;Homécourt;6176;54;6230
44;Grand Est;54;3;10;264;Houdelmont;212;1;213
44;Grand Est;54;3;05;265;Houdemont;2108;67;2175
44;Grand Est;54;3;10;266;Houdreville;425;10;435
44;Grand Est;54;3;10;268;Housséville;158;3;161
44;Grand Est;54;2;08;269;Hudiviller;356;5;361
44;Grand Est;54;1;23;270;Hussigny-Godbrange;3571;63;3634
44;Grand Est;54;2;01;271;Igney;124;6;130
44;Grand Est;54;4;16;272;Jaillon;478;6;484
44;Grand Est;54;1;04;273;Jarny;8283;185;8468
44;Grand Est;54;3;05;274;Jarville-la-Malgrange;9264;259;9523
44;Grand Est;54;4;16;275;Jaulny;203;6;209
44;Grand Est;54;3;02;276;Jeandelaincourt;811;6;817
44;Grand Est;54;1;04;277;Jeandelize;374;5;379
44;Grand Est;54;3;10;278;Jevoncourt;99;1;100
44;Grand Est;54;3;18;279;Jezainville;960;22;982
44;Grand Est;54;2;08;281;Jolivet;904;18;922
44;Grand Est;54;1;17;282;Joppécourt;160;6;166
44;Grand Est;54;1;04;283;Jouaville;298;9;307
44;Grand Est;54;1;17;284;Joudreville;1170;13;1183
44;Grand Est;54;2;01;285;Juvrecourt;58;1;59
44;Grand Est;54;1;17;280;Jœuf;6549;56;6605
44;Grand Est;54;1;04;286;Labry;1566;29;1595
44;Grand Est;54;2;01;287;Lachapelle;266;1;267
44;Grand Est;54;4;16;288;Lagney;506;5;511
44;Grand Est;54;3;03;289;Laître-sous-Amance;397;11;408
44;Grand Est;54;1;23;290;Laix;208;3;211
44;Grand Est;54;3;10;291;Lalœuf;291;3;294
44;Grand Est;54;2;09;292;Lamath;201;1;202
44;Grand Est;54;2;09;293;Landécourt;88;4;92
44;Grand Est;54;3;02;294;Landremont;146;1;147
44;Grand Est;54;1;17;295;Landres;974;110;1084
44;Grand Est;54;3;03;296;Laneuvelotte;437;4;441
44;Grand Est;54;2;01;297;Laneuveville-aux-Bois;319;3;322
44;Grand Est;54;4;20;298;Laneuveville-derrière-Foug;149;4;153
44;Grand Est;54;3;10;299;Laneuveville-devant-Bayon;226;6;232
44;Grand Est;54;3;03;300;Laneuveville-devant-Nancy;6541;110;6651
44;Grand Est;54;3;02;301;Lanfroicourt;130;1;131
44;Grand Est;54;1;17;302;Lantéfontaine;765;18;783
44;Grand Est;54;2;01;303;Laronxe;371;3;374
44;Grand Est;54;3;06;304;Laxou;14444;214;14658
44;Grand Est;54;3;02;305;Lay-Saint-Christophe;2441;68;2509
44;Grand Est;54;4;20;306;Lay-Saint-Remy;352;5;357
44;Grand Est;54;3;10;307;Lebeuville;175;4;179
44;Grand Est;54;2;01;308;Leintrey;142;3;145
44;Grand Est;54;3;10;309;Lemainville;374;4;378
44;Grand Est;54;3;10;310;Leménil-Mitry;3;0;3
44;Grand Est;54;3;03;311;Lenoncourt;592;9;601
44;Grand Est;54;3;18;312;Lesménils;494;10;504
44;Grand Est;54;3;02;313;Létricourt;235;1;236
44;Grand Est;54;1;07;314;Lexy;3725;66;3791
44;Grand Est;54;3;02;315;Leyr;916;6;922
44;Grand Est;54;4;16;316;Limey-Remenauville;285;5;290
44;Grand Est;54;4;16;317;Lironville;129;5;134
44;Grand Est;54;4;16;318;Liverdun;6087;61;6148
44;Grand Est;54;3;18;320;Loisy;325;4;329
44;Grand Est;54;1;23;321;Longlaville;2486;39;2525
44;Grand Est;54;1;11;322;Longuyon;5320;61;5381
44;Grand Est;54;1;07;323;Longwy;14378;291;14669
44;Grand Est;54;2;09;324;Lorey;99;0;99
44;Grand Est;54;2;09;325;Loromontzey;87;3;90
44;Grand Est;54;1;17;326;Lubey;228;4;232
44;Grand Est;54;4;16;327;Lucey;633;9;642
44;Grand Est;54;3;05;328;Ludres;6216;100;6316
44;Grand Est;54;2;98;329;Lunéville;18287;396;18683
44;Grand Est;54;3;05;330;Lupcourt;448;9;457
44;Grand Est;54;2;09;331;Magnières;286;6;292
44;Grand Est;54;3;18;332;Maidières;1547;24;1571
44;Grand Est;54;3;02;333;Mailly-sur-Seille;244;3;247
44;Grand Est;54;1;17;334;Mairy-Mainville;566;11;577
44;Grand Est;54;2;08;335;Maixe;413;4;417
44;Grand Est;54;3;15;336;Maizières;959;12;971
44;Grand Est;54;1;17;337;Malavillers;133;3;136
44;Grand Est;54;3;02;338;Malleloy;981;14;995
44;Grand Est;54;3;19;339;Malzéville;8125;268;8393
44;Grand Est;54;4;16;340;Mamey;339;5;344
44;Grand Est;54;4;16;343;Mandres-aux-Quatre-Tours;187;5;192
44;Grand Est;54;3;10;344;Mangonville;226;3;229
44;Grand Est;54;3;05;345;Manoncourt-en-Vermois;342;5;347
44;Grand Est;54;4;16;346;Manoncourt-en-Woëvre;245;4;249
44;Grand Est;54;4;16;348;Manonville;240;8;248
44;Grand Est;54;2;01;349;Manonviller;166;2;168
44;Grand Est;54;2;01;350;Marainviller;684;8;692
44;Grand Est;54;3;21;351;Marbache;1704;14;1718
44;Grand Est;54;3;15;352;Maron;831;10;841
44;Grand Est;54;1;04;353;Mars-la-Tour;965;18;983
44;Grand Est;54;3;10;354;Marthemont;42;0;42
44;Grand Est;54;4;16;355;Martincourt;96;2;98
44;Grand Est;54;2;09;356;Mattexey;67;2;69
44;Grand Est;54;3;21;357;Maxéville;9814;121;9935
44;Grand Est;54;3;03;358;Mazerulles;271;4;275
44;Grand Est;54;2;09;359;Méhoncourt;240;3;243
44;Grand Est;54;4;16;360;Ménil-la-Tour;336;2;338
44;Grand Est;54;1;17;362;Mercy-le-Bas;1278;6;1284
44;Grand Est;54;1;17;363;Mercy-le-Haut;273;6;279
44;Grand Est;54;3;15;364;Méréville;1345;20;1365
44;Grand Est;54;2;01;365;Merviller;337;9;346
44;Grand Est;54;3;15;366;Messein;1863;20;1883
44;Grand Est;54;1;07;367;Mexy;2283;50;2333
44;Grand Est;54;2;01;368;Mignéville;187;3;190
44;Grand Est;54;3;02;369;Millery;622;8;630
44;Grand Est;54;4;16;370;Minorville;230;1;231
44;Grand Est;54;1;04;371;Moineville;1083;15;1098
44;Grand Est;54;3;02;372;Moivrons;500;2;502
44;Grand Est;54;2;09;373;Moncel-lès-Lunéville;626;5;631
44;Grand Est;54;3;03;374;Moncel-sur-Seille;523;7;530
44;Grand Est;54;1;17;084;Mont-Bonvillers;948;14;962
44;Grand Est;54;4;10;379;Mont-l'Étroit;92;0;92
44;Grand Est;54;4;10;380;Mont-le-Vignoble;419;10;429
44;Grand Est;54;1;11;382;Mont-Saint-Martin;8807;110;8917
44;Grand Est;54;2;09;383;Mont-sur-Meurthe;1114;11;1125
44;Grand Est;54;3;18;375;Montauville;1056;16;1072
44;Grand Est;54;3;02;376;Montenoy;414;6;420
44;Grand Est;54;2;01;377;Montigny;155;0;155
44;Grand Est;54;1;11;378;Montigny-sur-Chiers;482;8;490
44;Grand Est;54;2;01;381;Montreux;62;2;64
44;Grand Est;54;1;23;385;Morfontaine;1092;25;1117
44;Grand Est;54;2;09;386;Moriviller;93;1;94
44;Grand Est;54;3;02;387;Morville-sur-Seille;147;0;147
44;Grand Est;54;2;01;388;Mouacourt;72;2;74
44;Grand Est;54;1;17;389;Mouaville;97;2;99
44;Grand Est;54;3;18;390;Mousson;104;3;107
44;Grand Est;54;1;04;391;Moutiers;1563;24;1587
44;Grand Est;54;4;10;392;Moutrot;303;2;305
44;Grand Est;54;2;09;393;Moyen;550;7;557
44;Grand Est;54;1;17;394;Murville;243;6;249
44;Grand Est;54;3;99;395;Nancy;104286;1457;105743
44;Grand Est;54;2;01;396;Neufmaisons;234;8;242
44;Grand Est;54;3;15;397;Neuves-Maisons;6729;66;6795
44;Grand Est;54;2;01;398;Neuviller-lès-Badonviller;94;2;96
44;Grand Est;54;3;10;399;Neuviller-sur-Moselle;235;1;236
44;Grand Est;54;3;02;400;Nomeny;1174;22;1196
44;Grand Est;54;2;01;401;Nonhigny;122;5;127
44;Grand Est;54;1;17;402;Norroy-le-Sec;417;12;429
44;Grand Est;54;3;18;403;Norroy-lès-Pont-à-Mousson;1194;15;1209
44;Grand Est;54;4;16;404;Noviant-aux-Prés;260;5;265
44;Grand Est;54;4;10;405;Ochey;518;4;522
44;Grand Est;54;2;01;406;Ogéviller;283;7;290
44;Grand Est;54;3;10;407;Ognéville;100;3;103
44;Grand Est;54;1;04;408;Olley;238;3;241
44;Grand Est;54;3;10;409;Omelmont;189;0;189
44;Grand Est;54;1;18;410;Onville;527;3;530
44;Grand Est;54;3;10;411;Ormes-et-Ville;227;2;229
44;Grand Est;54;1;11;412;Othe;33;3;36
44;Grand Est;54;1;17;413;Ozerailles;151;1;152
44;Grand Est;54;4;20;414;Pagney-derrière-Barine;631;8;639
44;Grand Est;54;3;18;415;Pagny-sur-Moselle;4140;53;4193
44;Grand Est;54;4;16;416;Pannes;177;4;181
44;Grand Est;54;3;10;417;Parey-Saint-Césaire;243;3;246
44;Grand Est;54;2;01;418;Parroy;166;1;167
44;Grand Est;54;2;01;419;Parux;71;0;71
44;Grand Est;54;1;11;420;Petit-Failly;86;1;87
44;Grand Est;54;2;01;421;Petitmont;321;4;325
44;Grand Est;54;2;01;422;Pettonville;67;0;67
44;Grand Est;54;2;01;423;Pexonne;365;2;367
44;Grand Est;54;3;02;424;Phlin;42;1;43
44;Grand Est;54;1;17;425;Piennes;2498;30;2528
44;Grand Est;54;4;20;426;Pierre-la-Treiche;492;2;494
44;Grand Est;54;2;01;427;Pierre-Percée;92;1;93
44;Grand Est;54;1;11;428;Pierrepont;870;10;880
44;Grand Est;54;3;10;429;Pierreville;308;2;310
44;Grand Est;54;3;21;430;Pompey;4884;54;4938
44;Grand Est;54;3;18;431;Pont-à-Mousson;14228;218;14446
44;Grand Est;54;3;15;432;Pont-Saint-Vincent;1903;43;1946
44;Grand Est;54;3;02;433;Port-sur-Seille;225;7;232
44;Grand Est;54;3;10;434;Praye;268;2;270
44;Grand Est;54;3;18;435;Prény;355;5;360
44;Grand Est;54;1;17;436;Preutin-Higny;134;1;135
44;Grand Est;54;3;15;437;Pulligny;1165;18;1183
44;Grand Est;54;4;10;438;Pulney;59;2;61
44;Grand Est;54;3;03;439;Pulnoy;4962;59;5021
44;Grand Est;54;1;04;440;Puxe;120;0;120
44;Grand Est;54;1;04;441;Puxieux;250;5;255
44;Grand Est;54;3;10;442;Quevilloncourt;95;2;97
44;Grand Est;54;2;01;443;Raon-lès-Leau;38;0;38
44;Grand Est;54;3;02;444;Raucourt;219;2;221
44;Grand Est;54;2;08;445;Raville-sur-Sânon;102;0;102
44;Grand Est;54;2;01;446;Réchicourt-la-Petite;62;2;64
44;Grand Est;54;2;01;447;Réclonville;76;1;77
44;Grand Est;54;2;09;449;Rehainviller;1044;15;1059
44;Grand Est;54;2;01;450;Reherrey;125;1;126
44;Grand Est;54;1;07;451;Réhon;3827;67;3894
44;Grand Est;54;2;01;452;Reillon;87;6;93
44;Grand Est;54;4;16;453;Rembercourt-sur-Mad;158;1;159
44;Grand Est;54;2;09;455;Remenoville;162;4;166
44;Grand Est;54;3;03;456;Réméréville;558;7;565
44;Grand Est;54;2;01;457;Remoncourt;47;1;48
44;Grand Est;54;2;01;458;Repaix;97;1;98
44;Grand Est;54;3;15;459;Richardménil;2355;25;2380
44;Grand Est;54;4;16;460;Rogéville;176;3;179
44;Grand Est;54;2;09;461;Romain;69;2;71
44;Grand Est;54;3;09;462;Rosières-aux-Salines;2858;30;2888
44;Grand Est;54;4;16;463;Rosières-en-Haye;232;2;234
44;Grand Est;54;3;02;464;Rouves;102;0;102
44;Grand Est;54;3;10;465;Roville-devant-Bayon;785;9;794
44;Grand Est;54;4;16;466;Royaumeix;368;4;372
44;Grand Est;54;2;09;467;Rozelieures;191;5;196
44;Grand Est;54;3;09;468;Saffais;116;0;116
44;Grand Est;54;1;04;469;Saint-Ail;424;5;429
44;Grand Est;54;4;16;470;Saint-Baussant;73;2;75
44;Grand Est;54;2;09;471;Saint-Boingt;71;3;74
44;Grand Est;54;2;01;472;Saint-Clément;861;17;878
44;Grand Est;54;3;10;473;Saint-Firmin;275;6;281
44;Grand Est;54;2;09;475;Saint-Germain;158;6;164
44;Grand Est;54;1;11;476;Saint-Jean-lès-Longuyon;421;11;432
44;Grand Est;54;1;04;477;Saint-Julien-lès-Gorze;161;2;163
44;Grand Est;54;1;04;478;Saint-Marcel;151;3;154
44;Grand Est;54;2;09;479;Saint-Mard;87;2;89
44;Grand Est;54;2;01;480;Saint-Martin;58;1;59
44;Grand Est;54;2;01;481;Saint-Maurice-aux-Forges;101;3;104
44;Grand Est;54;3;19;482;Saint-Max;9965;110;10075
44;Grand Est;54;3;05;483;Saint-Nicolas-de-Port;7520;75;7595
44;Grand Est;54;1;11;485;Saint-Pancré;316;6;322
44;Grand Est;54;3;10;486;Saint-Remimont;354;5;359
44;Grand Est;54;2;09;487;Saint-Rémy-aux-Bois;67;0;67
44;Grand Est;54;2;01;488;Saint-Sauveur;39;0;39
44;Grand Est;54;1;11;489;Saint-Supplet;139;9;148
44;Grand Est;54;3;02;474;Sainte-Geneviève;189;0;189
44;Grand Est;54;2;01;484;Sainte-Pôle;191;3;194
44;Grand Est;54;3;16;490;Saizerais;1503;22;1525
44;Grand Est;54;1;17;491;Sancy;318;7;325
44;Grand Est;54;4;16;492;Sanzey;144;2;146
44;Grand Est;54;1;23;493;Saulnes;2413;43;2456
44;Grand Est;54;4;10;494;Saulxerotte;107;1;108
44;Grand Est;54;3;03;495;Saulxures-lès-Nancy;4120;55;4175
44;Grand Est;54;4;10;496;Saulxures-lès-Vannes;373;5;378
44;Grand Est;54;3;10;497;Saxon-Sion;102;3;105
44;Grand Est;54;3;03;498;Seichamps;4952;61;5013
44;Grand Est;54;4;16;499;Seicheprey;113;4;117
44;Grand Est;54;4;10;500;Selaincourt;180;2;182
44;Grand Est;54;2;09;501;Seranville;100;0;100
44;Grand Est;54;2;08;502;Serres;247;1;248
44;Grand Est;54;1;23;504;Serrouville;683;16;699
44;Grand Est;54;4;15;505;Sexey-aux-Forges;705;8;713
44;Grand Est;54;2;08;507;Sionviller;103;2;105
44;Grand Est;54;3;02;508;Sivry;257;11;268
44;Grand Est;54;2;08;509;Sommerviller;990;4;994
44;Grand Est;54;3;03;510;Sornéville;328;6;334
44;Grand Est;54;1;04;511;Sponville;121;4;125
44;Grand Est;54;2;01;512;Tanconville;114;1;115
44;Grand Est;54;3;10;513;Tantonville;641;4;645
44;Grand Est;54;1;11;514;Tellancourt;560;10;570
44;Grand Est;54;3;10;515;Thélod;251;0;251
44;Grand Est;54;3;10;516;They-sous-Vaudemont;14;1;15
44;Grand Est;54;3;02;517;Thézey-Saint-Martin;203;2;205
44;Grand Est;54;4;16;518;Thiaucourt-Regniéville;1132;10;1142
44;Grand Est;54;2;01;519;Thiaville-sur-Meurthe;573;5;578
44;Grand Est;54;2;01;520;Thiébauménil;380;9;389
44;Grand Est;54;1;23;521;Thil;1877;28;1905
44;Grand Est;54;3;10;522;Thorey-Lyautey;143;3;146
44;Grand Est;54;4;10;523;Thuilley-aux-Groseilles;443;2;445
44;Grand Est;54;1;17;524;Thumeréville;72;1;73
44;Grand Est;54;1;23;525;Tiercelet;655;12;667
44;Grand Est;54;3;19;526;Tomblaine;8887;277;9164
44;Grand Est;54;3;09;527;Tonnoy;698;26;724
44;Grand Est;54;4;20;528;Toul;15832;281;16113
44;Grand Est;54;4;10;529;Tramont-Émy;29;0;29
44;Grand Est;54;4;10;530;Tramont-Lassus;87;2;89
44;Grand Est;54;4;10;531;Tramont-Saint-André;57;1;58
44;Grand Est;54;4;16;532;Tremblecourt;171;3;174
44;Grand Est;54;1;17;533;Trieux;2557;32;2589
44;Grand Est;54;4;16;534;Trondes;544;17;561
44;Grand Est;54;1;04;535;Tronville;201;2;203
44;Grand Est;54;1;17;536;Tucquegnieux;2469;28;2497
44;Grand Est;54;1;11;537;Ugny;715;30;745
44;Grand Est;54;4;10;538;Uruffe;401;2;403
44;Grand Est;54;2;01;539;Vacqueville;238;12;250
44;Grand Est;54;1;17;099;Val de Briey;8228;245;8473
44;Grand Est;54;2;01;540;Val-et-Châtillon;597;7;604
44;Grand Est;54;2;08;541;Valhey;170;2;172
44;Grand Est;54;1;04;542;Valleroy;2334;34;2368
44;Grand Est;54;2;09;543;Vallois;157;2;159
44;Grand Est;54;4;18;544;Vandelainville;140;2;142
44;Grand Est;54;4;10;545;Vandeléville;212;5;217
44;Grand Est;54;3;18;546;Vandières;925;8;933
44;Grand Est;54;3;22;547;Vandœuvre-lès-Nancy;30002;271;30273
44;Grand Est;54;4;10;548;Vannes-le-Châtel;569;8;577
44;Grand Est;54;3;08;549;Varangéville;3652;37;3689
44;Grand Est;54;2;09;550;Vathiménil;346;9;355
44;Grand Est;54;2;01;551;Vaucourt;63;2;65
44;Grand Est;54;3;10;552;Vaudémont;63;2;65
44;Grand Est;54;3;10;553;Vaudeville;157;2;159
44;Grand Est;54;3;10;554;Vaudigny;75;1;76
44;Grand Est;54;2;01;555;Vaxainville;99;0;99
44;Grand Est;54;2;01;556;Vého;100;3;103
44;Grand Est;54;3;03;558;Velaine-sous-Amance;280;5;285
44;Grand Est;54;2;09;559;Velle-sur-Moselle;283;6;289
44;Grand Est;54;2;01;560;Veney;50;0;50
44;Grand Est;54;2;09;561;Vennezey;50;1;51
44;Grand Est;54;2;01;562;Verdenal;156;7;163
44;Grand Est;54;3;10;563;Vézelise;1454;14;1468
44;Grand Est;54;4;16;564;Viéville-en-Haye;147;4;151
44;Grand Est;54;2;09;565;Vigneulles;242;2;244
44;Grand Est;54;4;16;566;Vilcey-sur-Trey;163;2;165
44;Grand Est;54;2;09;567;Villacourt;390;12;402
44;Grand Est;54;1;11;568;Ville-au-Montois;269;3;272
44;Grand Est;54;3;02;569;Ville-au-Val;197;4;201
44;Grand Est;54;3;05;571;Ville-en-Vermois;598;7;605
44;Grand Est;54;1;11;572;Ville-Houdlémont;662;5;667
44;Grand Est;54;1;04;581;Ville-sur-Yron;295;8;303
44;Grand Est;54;1;18;570;Villecey-sur-Mad;340;7;347
44;Grand Est;54;4;16;573;Villers-en-Haye;179;0;179
44;Grand Est;54;1;11;574;Villers-la-Chèvre;568;20;588
44;Grand Est;54;1;23;575;Villers-la-Montagne;1501;36;1537
44;Grand Est;54;1;11;576;Villers-le-Rond;107;1;108
44;Grand Est;54;3;02;577;Villers-lès-Moivrons;148;0;148
44;Grand Est;54;3;06;578;Villers-lès-Nancy;14415;315;14730
44;Grand Est;54;3;18;579;Villers-sous-Prény;346;7;353
44;Grand Est;54;1;23;580;Villerupt;9737;106;9843
44;Grand Est;54;1;11;582;Villette;183;1;184
44;Grand Est;54;4;20;583;Villey-le-Sec;405;11;416
44;Grand Est;54;4;16;584;Villey-Saint-Étienne;1061;23;1084
44;Grand Est;54;2;09;585;Virecourt;470;6;476
44;Grand Est;54;3;10;586;Viterne;733;7;740
44;Grand Est;54;3;10;587;Vitrey;203;4;207
44;Grand Est;54;2;08;588;Vitrimont;401;8;409
44;Grand Est;54;3;18;589;Vittonville;126;6;132
44;Grand Est;54;1;11;590;Viviers-sur-Chiers;663;20;683
44;Grand Est;54;3;10;591;Voinémont;331;11;342
44;Grand Est;54;3;10;592;Vroncourt;268;3;271
44;Grand Est;54;1;18;593;Waville;429;4;433
44;Grand Est;54;4;16;594;Xammes;153;1;154
44;Grand Est;54;2;09;595;Xermaménil;556;7;563
44;Grand Est;54;3;10;596;Xeuilley;934;6;940
44;Grand Est;54;3;10;597;Xirocourt;442;3;445
44;Grand Est;54;1;17;598;Xivry-Circourt;272;6;278
44;Grand Est;54;1;04;599;Xonville;127;0;127
44;Grand Est;54;2;01;600;Xousse;127;1;128
44;Grand Est;54;2;01;601;Xures;108;1;109
44;Grand Est;55;2;10;001;Abainville;301;5;306
44;Grand Est;55;3;04;002;Abaucourt-Hautecourt;107;3;110
44;Grand Est;55;3;14;004;Aincreville;69;1;70
44;Grand Est;55;2;10;005;Amanty;40;1;41
44;Grand Est;55;3;08;007;Ambly-sur-Meuse;245;2;247
44;Grand Est;55;3;05;008;Amel-sur-l'Étang;151;5;156
44;Grand Est;55;3;08;009;Ancemont;551;19;570
44;Grand Est;55;1;01;010;Ancerville;2752;64;2816
44;Grand Est;55;1;12;011;Andernay;258;3;261
44;Grand Est;55;2;13;012;Apremont-la-Forêt;397;9;406
44;Grand Est;55;3;05;013;Arrancy-sur-Crusne;491;7;498
44;Grand Est;55;3;06;014;Aubréville;374;7;381
44;Grand Est;55;1;01;015;Aulnois-en-Perthois;506;14;520
44;Grand Est;55;1;08;017;Autrécourt-sur-Aire;115;5;120
44;Grand Est;55;3;14;018;Autréville-Saint-Lambert;40;2;42
44;Grand Est;55;3;09;021;Avillers-Sainte-Croix;61;1;62
44;Grand Est;55;3;11;022;Avioth;144;4;148
44;Grand Est;55;3;06;023;Avocourt;108;2;110
44;Grand Est;55;3;11;024;Azannes-et-Soumazannes;165;3;168
44;Grand Est;55;3;14;025;Baâlon;290;3;293
44;Grand Est;55;2;10;026;Badonvilliers-Gérauvilliers;138;5;143
44;Grand Est;55;2;08;027;Bannoncourt;155;3;158
44;Grand Est;55;3;06;028;Bantheville;119;2;121
44;Grand Est;55;1;98;029;Bar-le-Duc;14985;600;15585
44;Grand Est;55;1;01;031;Baudonvilliers;378;11;389
44;Grand Est;55;2;08;032;Baudrémont;50;1;51
44;Grand Est;55;3;06;033;Baulny;16;1;17
44;Grand Est;55;3;11;034;Bazeilles-sur-Othain;116;3;119
44;Grand Est;55;1;01;035;Bazincourt-sur-Saulx;147;6;153
44;Grand Est;55;3;14;036;Beauclair;90;1;91
44;Grand Est;55;3;14;037;Beaufort-en-Argonne;144;1;145
44;Grand Est;55;1;08;038;Beaulieu-en-Argonne;36;2;38
44;Grand Est;55;3;04;039;Beaumont-en-Verdunois;0;0;0
44;Grand Est;55;1;08;040;Beausite;250;6;256
44;Grand Est;55;1;03;041;Behonne;609;26;635
44;Grand Est;55;3;17;042;Belleray;508;12;520
44;Grand Est;55;3;04;043;Belleville-sur-Meuse;3092;54;3146
44;Grand Est;55;2;08;044;Belrain;36;3;39
44;Grand Est;55;3;17;045;Belrupt-en-Verdunois;572;8;580
44;Grand Est;55;2;13;046;Beney-en-Woëvre;131;4;135
44;Grand Est;55;3;06;047;Béthelainville;171;6;177
44;Grand Est;55;3;06;048;Béthincourt;35;2;37
44;Grand Est;55;1;12;049;Beurey-sur-Saulx;417;0;417
44;Grand Est;55;3;04;050;Bezonvaux;0;0;0
44;Grand Est;55;1;10;051;Biencourt-sur-Orge;123;4;127
44;Grand Est;55;3;05;053;Billy-sous-Mangiennes;373;1;374
44;Grand Est;55;2;13;054;Bislée;61;5;66
44;Grand Est;55;3;04;055;Blanzée;16;1;17
44;Grand Est;55;3;09;057;Boinville-en-Woëvre;73;2;75
44;Grand Est;55;2;07;058;Boncourt-sur-Meuse;328;10;338
44;Grand Est;55;2;10;059;Bonnet;200;7;207
44;Grand Est;55;3;09;060;Bonzée;350;13;363
44;Grand Est;55;1;10;061;Le Bouchon-sur-Saulx;241;5;246
44;Grand Est;55;2;13;062;Bouconville-sur-Madt;111;1;112
44;Grand Est;55;3;05;063;Bouligny;2558;39;2597
44;Grand Est;55;2;08;064;Bouquemont;111;0;111
44;Grand Est;55;3;06;065;Boureuilles;120;0;120
44;Grand Est;55;2;15;066;Bovée-sur-Barboure;142;6;148
44;Grand Est;55;2;15;067;Boviolles;97;2;99
44;Grand Est;55;3;06;068;Brabant-en-Argonne;106;3;109
44;Grand Est;55;1;12;069;Brabant-le-Roi;230;4;234
44;Grand Est;55;3;06;070;Brabant-sur-Meuse;124;6;130
44;Grand Est;55;3;11;071;Brandeville;184;5;189
44;Grand Est;55;3;09;072;Braquis;119;1;120
44;Grand Est;55;3;04;073;Bras-sur-Meuse;698;49;747
44;Grand Est;55;1;10;075;Brauvilliers;171;3;174
44;Grand Est;55;3;11;076;Bréhéville;171;0;171
44;Grand Est;55;3;11;077;Breux;258;9;267
44;Grand Est;55;3;14;078;Brieulles-sur-Meuse;315;8;323
44;Grand Est;55;1;01;079;Brillon-en-Barrois;671;20;691
44;Grand Est;55;2;15;080;Brixey-aux-Chanoines;84;4;88
44;Grand Est;55;1;08;081;Brizeaux;58;1;59
44;Grand Est;55;3;06;082;Brocourt-en-Argonne;47;1;48
44;Grand Est;55;3;14;083;Brouennes;150;4;154
44;Grand Est;55;2;15;084;Broussey-en-Blois;59;1;60
44;Grand Est;55;2;13;085;Broussey-Raulecourt;283;4;287
44;Grand Est;55;1;10;087;Bure;84;7;91
44;Grand Est;55;2;15;088;Burey-en-Vaux;154;4;158
44;Grand Est;55;2;15;089;Burey-la-Côte;87;1;88
44;Grand Est;55;2;13;093;Buxières-sous-les-Côtes;287;3;290
44;Grand Est;55;3;09;094;Buzy-Darmont;559;11;570
44;Grand Est;55;3;14;095;Cesse;114;3;117
44;Grand Est;55;2;13;096;Chaillon;112;0;112
44;Grand Est;55;2;15;097;Chalaines;318;6;324
44;Grand Est;55;3;04;099;Champneuville;120;1;121
44;Grand Est;55;2;15;100;Champougny;83;8;91
44;Grand Est;55;1;10;358;Chanteraine;185;4;189
44;Grand Est;55;1;03;101;Chardogne;304;7;311
44;Grand Est;55;3;04;102;Charny-sur-Meuse;518;22;540
44;Grand Est;55;3;06;103;Charpentry;22;2;24
44;Grand Est;55;2;10;104;Chassey-Beaupré;88;3;91
44;Grand Est;55;3;04;105;Châtillon-sous-les-Côtes;175;4;179
44;Grand Est;55;3;06;106;Chattancourt;182;3;185
44;Grand Est;55;3;11;107;Chaumont-devant-Damvillers;48;1;49
44;Grand Est;55;1;12;108;Chaumont-sur-Aire;126;4;130
44;Grand Est;55;3;11;109;Chauvency-le-Château;248;3;251
44;Grand Est;55;3;11;110;Chauvency-Saint-Hubert;239;6;245
44;Grand Est;55;2;13;111;Chauvoncourt;452;20;472
44;Grand Est;55;3;06;113;Cheppy;149;1;150
44;Grand Est;55;2;07;114;Chonville-Malaumont;212;5;217
44;Grand Est;55;3;06;115;Cierges-sous-Montfaucon;52;0;52
44;Grand Est;55;3;06;116;Le Claon;60;0;60
44;Grand Est;55;3;06;117;Clermont-en-Argonne;1480;34;1514
44;Grand Est;55;3;14;118;Cléry-le-Grand;91;2;93
44;Grand Est;55;3;14;119;Cléry-le-Petit;186;1;187
44;Grand Est;55;1;02;120;Combles-en-Barrois;797;26;823
44;Grand Est;55;3;09;121;Combres-sous-les-Côtes;118;5;123
44;Grand Est;55;2;07;122;Commercy;5536;242;5778
44;Grand Est;55;3;06;124;Consenvoye;307;4;311
44;Grand Est;55;1;12;125;Contrisson;817;19;836
44;Grand Est;55;2;08;127;Courcelles-en-Barrois;38;0;38
44;Grand Est;55;1;12;128;Courcelles-sur-Aire;40;0;40
44;Grand Est;55;2;08;129;Courouvre;35;2;37
44;Grand Est;55;1;01;132;Cousances-les-Forges;1688;32;1720
44;Grand Est;55;2;15;518;Cousances-lès-Triconville;140;0;140
44;Grand Est;55;1;10;133;Couvertpuis;87;6;93
44;Grand Est;55;1;12;134;Couvonges;156;4;160
44;Grand Est;55;3;06;137;Cuisy;46;0;46
44;Grand Est;55;1;15;138;Culey;141;3;144
44;Grand Est;55;3;04;139;Cumières-le-Mort-Homme;0;0;0
44;Grand Est;55;3;06;140;Cunel;14;0;14
44;Grand Est;55;2;15;141;Dagonville;85;1;86
44;Grand Est;55;2;10;142;Dainville-Bertheléville;116;4;120
44;Grand Est;55;3;04;143;Damloup;131;8;139
44;Grand Est;55;1;10;144;Dammarie-sur-Saulx;422;15;437
44;Grand Est;55;3;11;145;Damvillers;651;59;710
44;Grand Est;55;3;06;146;Dannevoux;228;4;232
44;Grand Est;55;2;10;148;Delouze-Rosières;113;4;117
44;Grand Est;55;3;11;149;Delut;125;0;125
44;Grand Est;55;2;10;150;Demange-Baudignécourt;554;13;567
44;Grand Est;55;3;04;153;Dieppe-sous-Douaumont;189;2;191
44;Grand Est;55;3;08;154;Dieue-sur-Meuse;1446;33;1479
44;Grand Est;55;3;06;155;Dombasle-en-Argonne;407;7;414
44;Grand Est;55;3;11;156;Dombras;138;4;142
44;Grand Est;55;3;09;157;Dommartin-la-Montagne;51;0;51
44;Grand Est;55;3;05;158;Dommary-Baroncourt;737;8;745
44;Grand Est;55;2;08;159;Dompcevrin;309;2;311
44;Grand Est;55;2;13;160;Dompierre-aux-Bois;39;0;39
44;Grand Est;55;3;05;162;Domremy-la-Canne;36;0;36
44;Grand Est;55;3;09;163;Doncourt-aux-Templiers;60;3;63
44;Grand Est;55;3;04;537;Douaumont-Vaux;81;0;81
44;Grand Est;55;3;14;165;Doulcon;445;12;457
44;Grand Est;55;3;17;166;Dugny-sur-Meuse;1307;24;1331
44;Grand Est;55;3;14;167;Dun-sur-Meuse;661;8;669
44;Grand Est;55;3;05;168;Duzey;42;3;45
44;Grand Est;55;3;11;169;Écouviez;510;6;516
44;Grand Est;55;3;11;170;Écurey-en-Verdunois;124;0;124
44;Grand Est;55;3;04;171;Eix;249;4;253
44;Grand Est;55;3;09;172;Les Éparges;67;1;68
44;Grand Est;55;2;15;173;Épiez-sur-Meuse;41;1;42
44;Grand Est;55;3;06;174;Épinonville;72;0;72
44;Grand Est;55;1;02;175;Érize-la-Brûlée;188;6;194
44;Grand Est;55;1;12;177;Érize-la-Petite;55;2;57
44;Grand Est;55;1;02;178;Érize-Saint-Dizier;189;6;195
44;Grand Est;55;2;15;179;Erneville-aux-Bois;160;3;163
44;Grand Est;55;3;06;180;Esnes-en-Argonne;136;1;137
44;Grand Est;55;3;09;181;Étain;3580;70;3650
44;Grand Est;55;3;05;182;Éton;209;3;212
44;Grand Est;55;3;11;183;Étraye;39;1;40
44;Grand Est;55;2;07;184;Euville;1665;27;1692
44;Grand Est;55;1;08;185;Èvres;103;6;109
44;Grand Est;55;1;03;186;Fains-Véel;2140;61;2201
44;Grand Est;55;3;11;188;Flassigny;47;1;48
44;Grand Est;55;3;04;189;Fleury-devant-Douaumont;0;0;0
44;Grand Est;55;3;05;191;Foameix-Ornel;247;8;255
44;Grand Est;55;3;14;192;Fontaines-Saint-Clair;55;2;57
44;Grand Est;55;3;06;193;Forges-sur-Meuse;122;2;124
44;Grand Est;55;1;08;194;Foucaucourt-sur-Thabas;57;0;57
44;Grand Est;55;1;10;195;Fouchères-aux-Bois;134;4;138
44;Grand Est;55;2;07;196;Frémeréville-sous-les-Côtes;137;1;138
44;Grand Est;55;2;08;197;Fresnes-au-Mont;171;4;175
44;Grand Est;55;3;09;198;Fresnes-en-Woëvre;673;10;683
44;Grand Est;55;3;06;199;Froidos;98;2;100
44;Grand Est;55;3;06;200;Fromeréville-les-Vallons;209;4;213
44;Grand Est;55;3;09;201;Fromezey;53;0;53
44;Grand Est;55;3;06;202;Futeau;161;3;164
44;Grand Est;55;3;08;204;Génicourt-sur-Meuse;290;5;295
44;Grand Est;55;3;06;206;Gercourt-et-Drillancourt;106;4;110
44;Grand Est;55;1;02;207;Géry;55;1;56
44;Grand Est;55;3;06;208;Gesnes-en-Argonne;59;3;62
44;Grand Est;55;2;07;258;Geville;620;16;636
44;Grand Est;55;2;08;210;Gimécourt;39;0;39
44;Grand Est;55;3;04;211;Gincrey;64;1;65
44;Grand Est;55;2;07;212;Girauvoisin;77;0;77
44;Grand Est;55;1;10;214;Givrauval;290;23;313
44;Grand Est;55;2;10;215;Gondrecourt-le-Château;1085;15;1100
44;Grand Est;55;3;05;216;Gouraincourt;59;0;59
44;Grand Est;55;2;15;217;Goussaincourt;116;6;122
44;Grand Est;55;3;11;218;Gremilly;40;0;40
44;Grand Est;55;3;04;219;Grimaucourt-en-Woëvre;104;2;106
44;Grand Est;55;2;07;220;Grimaucourt-près-Sampigny;85;0;85
44;Grand Est;55;1;01;221;Guerpont;249;5;254
44;Grand Est;55;3;09;222;Gussainville;35;1;36
44;Grand Est;55;1;01;224;Haironville;595;13;608
44;Grand Est;55;3;14;225;Halles-sous-les-Côtes;151;7;158
44;Grand Est;55;3;11;226;Han-lès-Juvigny;121;1;122
44;Grand Est;55;2;13;229;Han-sur-Meuse;277;2;279
44;Grand Est;55;3;09;228;Hannonville-sous-les-Côtes;567;11;578
44;Grand Est;55;3;09;232;Harville;118;0;118
44;Grand Est;55;3;17;236;Haudainville;952;21;973
44;Grand Est;55;3;09;237;Haudiomont;217;4;221
44;Grand Est;55;3;04;239;Haumont-près-Samogneux;0;0;0
44;Grand Est;55;1;12;123;Les Hauts-de-Chée;728;13;741
44;Grand Est;55;3;08;241;Heippes;76;3;79
44;Grand Est;55;3;09;242;Hennemont;111;4;115
44;Grand Est;55;3;09;243;Herbeuville;180;5;185
44;Grand Est;55;3;09;244;Herméville-en-Woëvre;241;1;242
44;Grand Est;55;2;13;245;Heudicourt-sous-les-Côtes;166;8;174
44;Grand Est;55;1;10;246;Hévilliers;146;1;147
44;Grand Est;55;2;10;247;Horville-en-Ornois;57;2;59
44;Grand Est;55;2;10;248;Houdelaincourt;299;8;307
44;Grand Est;55;3;14;250;Inor;185;8;193
44;Grand Est;55;1;08;251;Ippécourt;97;3;100
44;Grand Est;55;3;11;252;Iré-le-Sec;154;2;156
44;Grand Est;55;1;01;296;L' Isle-en-Rigault;481;15;496
44;Grand Est;55;3;06;253;Les Islettes;747;14;761
44;Grand Est;55;3;11;255;Jametz;257;5;262
44;Grand Est;55;2;13;256;Jonville-en-Woëvre;149;0;149
44;Grand Est;55;3;06;257;Jouy-en-Argonne;47;0;47
44;Grand Est;55;3;08;260;Julvécourt;57;2;59
44;Grand Est;55;1;01;261;Juvigny-en-Perthois;137;2;139
44;Grand Est;55;3;11;262;Juvigny-sur-Loison;260;2;262
44;Grand Est;55;2;08;263;Kœur-la-Grande;164;4;168
44;Grand Est;55;2;08;264;Kœur-la-Petite;285;5;290
44;Grand Est;55;3;09;265;Labeuville;135;5;140
44;Grand Est;55;3;06;266;Lachalade;54;0;54
44;Grand Est;55;2;13;267;Lachaussée;271;9;280
44;Grand Est;55;2;13;268;Lacroix-sur-Meuse;720;18;738
44;Grand Est;55;2;08;269;Lahaymeix;74;0;74
44;Grand Est;55;2;13;270;Lahayville;27;1;28
44;Grand Est;55;1;12;271;Laheycourt;405;9;414
44;Grand Est;55;1;12;272;Laimont;461;17;478
44;Grand Est;55;2;13;274;Lamorville;288;6;294
44;Grand Est;55;3;14;275;Lamouilly;91;5;96
44;Grand Est;55;3;08;276;Landrecourt-Lempire;211;1;212
44;Grand Est;55;2;15;278;Laneuville-au-Rupt;198;3;201
44;Grand Est;55;3;14;279;Laneuville-sur-Meuse;436;9;445
44;Grand Est;55;3;05;280;Lanhères;61;0;61
44;Grand Est;55;3;09;281;Latour-en-Woëvre;95;0;95
44;Grand Est;55;2;08;282;Lavallée;92;3;95
44;Grand Est;55;1;01;284;Lavincourt;70;0;70
44;Grand Est;55;1;08;285;Lavoye;153;3;156
44;Grand Est;55;3;08;286;Lemmes;249;3;252
44;Grand Est;55;2;07;288;Lérouville;1433;16;1449
44;Grand Est;55;2;08;289;Levoncourt;57;1;58
44;Grand Est;55;2;08;290;Lignières-sur-Aire;53;1;54
44;Grand Est;55;1;10;291;Ligny-en-Barrois;4052;138;4190
44;Grand Est;55;3;14;292;Liny-devant-Dun;190;5;195
44;Grand Est;55;3;14;293;Lion-devant-Dun;170;4;174
44;Grand Est;55;1;12;295;Lisle-en-Barrois;35;1;36
44;Grand Est;55;3;11;297;Lissey;111;1;112
44;Grand Est;55;1;15;298;Loisey;300;9;309
44;Grand Est;55;3;05;299;Loison;119;3;122
44;Grand Est;55;2;08;301;Longchamps-sur-Aire;122;8;130
44;Grand Est;55;1;10;300;Longeaux;227;6;233
44;Grand Est;55;1;02;302;Longeville-en-Barrois;1160;29;1189
44;Grand Est;55;2;13;303;Loupmont;75;3;78
44;Grand Est;55;1;12;304;Louppy-le-Château;157;4;161
44;Grand Est;55;3;11;306;Louppy-sur-Loison;126;1;127
44;Grand Est;55;3;04;307;Louvemont-Côte-du-Poivre;0;0;0
44;Grand Est;55;3;14;310;Luzy-Saint-Martin;114;4;118
44;Grand Est;55;3;09;311;Maizeray;33;1;34
44;Grand Est;55;2;13;312;Maizey;165;6;171
44;Grand Est;55;3;06;313;Malancourt;64;2;66
44;Grand Est;55;1;10;315;Mandres-en-Barrois;118;4;122
44;Grand Est;55;3;05;316;Mangiennes;395;7;402
44;Grand Est;55;3;09;317;Manheulles;137;7;144
44;Grand Est;55;3;09;320;Marchéville-en-Woëvre;68;2;70
44;Grand Est;55;3;06;321;Marre;161;7;168
44;Grand Est;55;2;15;322;Marson-sur-Barboure;47;1;48
44;Grand Est;55;3;14;323;Martincourt-sur-Meuse;66;1;67
44;Grand Est;55;3;11;324;Marville;504;13;517
44;Grand Est;55;3;04;325;Maucourt-sur-Orne;57;1;58
44;Grand Est;55;1;01;326;Maulan;117;2;119
44;Grand Est;55;2;10;327;Mauvages;259;2;261
44;Grand Est;55;2;15;328;Maxey-sur-Vaise;293;5;298
44;Grand Est;55;2;07;329;Mécrin;224;2;226
44;Grand Est;55;2;15;330;Méligny-le-Grand;95;2;97
44;Grand Est;55;2;15;331;Méligny-le-Petit;80;0;80
44;Grand Est;55;1;10;332;Menaucourt;238;5;243
44;Grand Est;55;2;08;333;Ménil-aux-Bois;42;1;43
44;Grand Est;55;2;15;334;Ménil-la-Horgne;169;3;172
44;Grand Est;55;1;10;335;Ménil-sur-Saulx;256;9;265
44;Grand Est;55;3;11;336;Merles-sur-Loison;150;5;155
44;Grand Est;55;3;14;338;Milly-sur-Bradon;162;5;167
44;Grand Est;55;3;04;339;Mogeville;85;1;86
44;Grand Est;55;1;12;340;Mognéville;381;10;391
44;Grand Est;55;3;11;341;Moirey-Flabas-Crépion;129;2;131
44;Grand Est;55;3;14;345;Mont-devant-Sassey;95;3;98
44;Grand Est;55;3;06;343;Montblainville;61;2;63
44;Grand Est;55;2;15;344;Montbras;19;0;19
44;Grand Est;55;3;06;346;Montfaucon-d'Argonne;307;6;313
44;Grand Est;55;3;08;347;Les Monthairons;374;3;377
44;Grand Est;55;1;10;348;Montiers-sur-Saulx;380;3;383
44;Grand Est;55;3;14;349;Montigny-devant-Sassey;117;6;123
44;Grand Est;55;2;15;350;Montigny-lès-Vaucouleurs;68;0;68
44;Grand Est;55;3;11;351;Montmédy;2136;85;2221
44;Grand Est;55;1;01;352;Montplonne;141;17;158
44;Grand Est;55;2;13;353;Montsec;85;0;85
44;Grand Est;55;3;06;355;Montzéville;155;1;156
44;Grand Est;55;3;04;356;Moranville;108;1;109
44;Grand Est;55;3;05;357;Morgemoulin;111;3;114
44;Grand Est;55;1;10;359;Morley;205;3;208
44;Grand Est;55;3;09;360;Mouilly;113;1;114
44;Grand Est;55;3;04;361;Moulainville;124;6;130
44;Grand Est;55;3;14;362;Moulins-Saint-Hubert;176;3;179
44;Grand Est;55;3;09;363;Moulotte;101;0;101
44;Grand Est;55;3;14;364;Mouzay;692;30;722
44;Grand Est;55;3;14;365;Murvaux;141;3;144
44;Grand Est;55;3;05;367;Muzeray;134;4;138
44;Grand Est;55;2;15;368;Naives-en-Blois;151;10;161
44;Grand Est;55;1;02;369;Naives-Rosières;802;20;822
44;Grand Est;55;1;10;370;Naix-aux-Forges;221;2;223
44;Grand Est;55;1;01;373;Nant-le-Grand;79;5;84
44;Grand Est;55;1;01;374;Nant-le-Petit;78;1;79
44;Grand Est;55;3;06;375;Nantillois;63;1;64
44;Grand Est;55;1;10;376;Nantois;85;4;89
44;Grand Est;55;2;15;371;Nançois-le-Grand;73;4;77
44;Grand Est;55;1;15;372;Nançois-sur-Ornain;384;9;393
44;Grand Est;55;3;14;377;Nepvant;86;1;87
44;Grand Est;55;1;12;378;Nettancourt;252;3;255
44;Grand Est;55;3;06;379;Le Neufour;72;2;74
44;Grand Est;55;2;08;380;Neuville-en-Verdunois;58;2;60
44;Grand Est;55;2;15;381;Neuville-lès-Vaucouleurs;176;8;184
44;Grand Est;55;1;12;382;Neuville-sur-Ornain;362;11;373
44;Grand Est;55;3;06;383;Neuvilly-en-Argonne;216;2;218
44;Grand Est;55;2;08;384;Nicey-sur-Aire;123;4;127
44;Grand Est;55;3;08;385;Nixéville-Blercourt;494;16;510
44;Grand Est;55;2;13;386;Nonsard-Lamarche;210;5;215
44;Grand Est;55;3;05;387;Nouillonpont;238;4;242
44;Grand Est;55;1;12;388;Noyers-Auzécourt;281;7;288
44;Grand Est;55;1;08;389;Nubécourt;249;7;256
44;Grand Est;55;3;14;391;Olizy-sur-Chiers;192;6;198
44;Grand Est;55;3;04;394;Ornes;5;0;5
44;Grand Est;55;3;08;395;Osches;55;3;58
44;Grand Est;55;2;15;396;Ourches-sur-Meuse;221;4;225
44;Grand Est;55;2;15;397;Pagny-la-Blanche-Côte;237;4;241
44;Grand Est;55;2;15;398;Pagny-sur-Meuse;1023;16;1039
44;Grand Est;55;3;09;399;Pareid;119;0;119
44;Grand Est;55;3;09;400;Parfondrupt;45;0;45
44;Grand Est;55;2;13;401;Les Paroches;416;10;426
44;Grand Est;55;3;11;403;Peuvillers;55;2;57
44;Grand Est;55;2;08;404;Pierrefitte-sur-Aire;316;12;328
44;Grand Est;55;3;05;405;Pillon;264;2;266
44;Grand Est;55;3;09;406;Pintheville;110;4;114
44;Grand Est;55;2;07;407;Pont-sur-Meuse;133;6;139
44;Grand Est;55;3;14;408;Pouilly-sur-Meuse;178;5;183
44;Grand Est;55;1;08;409;Pretz-en-Argonne;72;2;74
44;Grand Est;55;3;11;410;Quincy-Landzécourt;140;6;146
44;Grand Est;55;1;02;442;Raival;254;4;258
44;Grand Est;55;3;08;411;Rambluzin-et-Benoite-Vaux;102;1;103
44;Grand Est;55;2;13;412;Rambucourt;189;6;195
44;Grand Est;55;1;12;414;Rancourt-sur-Ornain;191;1;192
44;Grand Est;55;2;13;415;Ranzières;82;1;83
44;Grand Est;55;3;06;416;Rarécourt;222;8;230
44;Grand Est;55;3;06;419;Récicourt;167;4;171
44;Grand Est;55;3;08;420;Récourt-le-Creux;77;0;77
44;Grand Est;55;2;15;421;Reffroy;73;4;77
44;Grand Est;55;3;06;422;Regnéville-sur-Meuse;51;0;51
44;Grand Est;55;1;12;423;Rembercourt-Sommaisne;353;9;362
44;Grand Est;55;1;12;424;Remennecourt;55;0;55
44;Grand Est;55;3;11;425;Remoiville;134;0;134
44;Grand Est;55;1;02;426;Resson;391;14;405
44;Grand Est;55;1;12;427;Revigny-sur-Ornain;2805;51;2856
44;Grand Est;55;3;11;428;Réville-aux-Bois;116;0;116
44;Grand Est;55;3;09;429;Riaville;43;2;45
44;Grand Est;55;1;10;430;Ribeaucourt;72;1;73
44;Grand Est;55;2;13;431;Richecourt;59;0;59
44;Grand Est;55;2;15;433;Rigny-la-Salle;365;12;377
44;Grand Est;55;2;15;434;Rigny-Saint-Martin;53;4;57
44;Grand Est;55;1;12;435;Robert-Espagne;823;24;847
44;Grand Est;55;2;10;436;Les Roises;30;0;30
44;Grand Est;55;3;11;437;Romagne-sous-les-Côtes;118;3;121
44;Grand Est;55;3;06;438;Romagne-sous-Montfaucon;184;4;188
44;Grand Est;55;3;09;439;Ronvaux;88;5;93
44;Grand Est;55;3;05;443;Rouvres-en-Woëvre;604;6;610
44;Grand Est;55;2;13;444;Rouvrois-sur-Meuse;207;1;208
44;Grand Est;55;3;05;445;Rouvrois-sur-Othain;194;8;202
44;Grand Est;55;1;02;446;Rumont;83;0;83
44;Grand Est;55;1;01;447;Rupt-aux-Nonains;371;6;377
44;Grand Est;55;2;08;448;Rupt-devant-Saint-Mihiel;56;0;56
44;Grand Est;55;3;08;449;Rupt-en-Woëvre;299;6;305
44;Grand Est;55;3;11;450;Rupt-sur-Othain;44;2;46
44;Grand Est;55;1;10;452;Saint-Amand-sur-Ornain;53;2;55
44;Grand Est;55;3;08;453;Saint-André-en-Barrois;66;1;67
44;Grand Est;55;2;15;454;Saint-Aubin-sur-Aire;171;1;172
44;Grand Est;55;2;15;456;Saint-Germain-sur-Meuse;257;9;266
44;Grand Est;55;3;09;457;Saint-Hilaire-en-Woëvre;174;6;180
44;Grand Est;55;3;09;458;Saint-Jean-lès-Buzy;370;0;370
44;Grand Est;55;2;10;459;Saint-Joire;239;3;242
44;Grand Est;55;2;07;460;Saint-Julien-sous-les-Côtes;140;2;142
44;Grand Est;55;3;05;461;Saint-Laurent-sur-Othain;506;10;516
44;Grand Est;55;2;13;462;Saint-Maurice-sous-les-Côtes;352;11;363
44;Grand Est;55;2;13;463;Saint-Mihiel;4112;75;4187
44;Grand Est;55;3;05;464;Saint-Pierrevillers;156;8;164
44;Grand Est;55;3;09;465;Saint-Remy-la-Calonne;103;0;103
44;Grand Est;55;1;15;466;Salmagne;301;5;306
44;Grand Est;55;3;04;468;Samogneux;95;0;95
44;Grand Est;55;2;08;467;Sampigny;706;13;719
44;Grand Est;55;3;14;469;Sassey-sur-Meuse;103;0;103
44;Grand Est;55;1;01;470;Saudrupt;198;2;200
44;Grand Est;55;3;14;471;Saulmory-Villefranche;87;0;87
44;Grand Est;55;2;15;472;Saulvaux;115;5;120
44;Grand Est;55;3;09;473;Saulx-lès-Champlon;118;11;129
44;Grand Est;55;2;15;474;Sauvigny;232;7;239
44;Grand Est;55;2;15;475;Sauvoy;62;2;64
44;Grand Est;55;1;02;476;Savonnières-devant-Bar;474;14;488
44;Grand Est;55;1;01;477;Savonnières-en-Perthois;409;10;419
44;Grand Est;55;1;02;479;Seigneulles;173;3;176
44;Grand Est;55;3;05;481;Senon;336;2;338
44;Grand Est;55;3;08;482;Senoncourt-les-Maujouy;95;2;97
44;Grand Est;55;3;06;484;Septsarges;47;1;48
44;Grand Est;55;2;15;485;Sepvigny;74;3;77
44;Grand Est;55;1;08;517;Seuil-d'Argonne;519;4;523
44;Grand Est;55;2;13;487;Seuzey;115;3;118
44;Grand Est;55;1;01;488;Silmont;159;1;160
44;Grand Est;55;3;16;489;Sivry-la-Perche;274;6;280
44;Grand Est;55;3;06;490;Sivry-sur-Meuse;337;11;348
44;Grand Est;55;3;08;492;Sommedieue;977;13;990
44;Grand Est;55;1;12;493;Sommeilles;204;1;205
44;Grand Est;55;1;01;494;Sommelonne;455;22;477
44;Grand Est;55;3;05;495;Sorbey;272;0;272
44;Grand Est;55;2;15;496;Sorcy-Saint-Martin;1105;22;1127
44;Grand Est;55;3;08;497;Les Souhesmes-Rampont;343;12;355
44;Grand Est;55;3;08;498;Souilly;446;5;451
44;Grand Est;55;3;05;500;Spincourt;841;13;854
44;Grand Est;55;1;01;501;Stainville;418;12;430
44;Grand Est;55;3;14;502;Stenay;2597;124;2721
44;Grand Est;55;2;15;503;Taillancourt;127;2;129
44;Grand Est;55;1;01;504;Tannois;403;10;413
44;Grand Est;55;3;04;505;Thierville-sur-Meuse;3118;97;3215
44;Grand Est;55;2;08;506;Thillombois;30;0;30
44;Grand Est;55;3;09;507;Thillot;232;2;234
44;Grand Est;55;3;11;508;Thonne-la-Long;333;2;335
44;Grand Est;55;3;11;509;Thonne-le-Thil;269;3;272
44;Grand Est;55;3;11;510;Thonne-les-Près;135;2;137
44;Grand Est;55;3;11;511;Thonnelle;134;3;137
44;Grand Est;55;3;08;512;Tilly-sur-Meuse;288;4;292
44;Grand Est;55;1;02;514;Trémont-sur-Saulx;607;9;616
44;Grand Est;55;3;09;515;Trésauvaux;70;1;71
44;Grand Est;55;2;10;516;Tréveray;572;9;581
44;Grand Est;55;1;08;254;Les Trois-Domaines;124;2;126
44;Grand Est;55;1;01;519;Tronville-en-Barrois;1438;30;1468
44;Grand Est;55;2;15;520;Troussey;464;11;475
44;Grand Est;55;2;13;521;Troyon;263;7;270
44;Grand Est;55;2;15;522;Ugny-sur-Meuse;109;3;112
44;Grand Est;55;3;04;523;Vacherauville;177;4;181
44;Grand Est;55;3;08;525;Vadelaincourt;80;0;80
44;Grand Est;55;2;07;526;Vadonville;260;5;265
44;Grand Est;55;1;12;366;Val-d'Ornain;988;34;1022
44;Grand Est;55;2;13;530;Valbois;93;1;94
44;Grand Est;55;3;06;527;Varennes-en-Argonne;655;12;667
44;Grand Est;55;2;13;528;Varnéville;54;0;54
44;Grand Est;55;1;12;531;Vassincourt;266;27;293
44;Grand Est;55;1;12;532;Vaubecourt;314;4;318
44;Grand Est;55;2;15;533;Vaucouleurs;1943;23;1966
44;Grand Est;55;2;10;534;Vaudeville-le-Haut;55;0;55
44;Grand Est;55;3;05;535;Vaudoncourt;89;0;89
44;Grand Est;55;3;06;536;Vauquois;17;3;20
44;Grand Est;55;2;13;540;Vaux-lès-Palameix;57;1;58
44;Grand Est;55;1;03;541;Vavincourt;514;10;524
44;Grand Est;55;1;01;543;Velaines;950;21;971
44;Grand Est;55;3;11;544;Velosnes;165;2;167
44;Grand Est;55;3;99;545;Verdun;17475;974;18449
44;Grand Est;55;3;11;546;Verneuil-Grand;203;7;210
44;Grand Est;55;3;11;547;Verneuil-Petit;123;4;127
44;Grand Est;55;3;06;549;Véry;90;1;91
44;Grand Est;55;3;11;552;Vigneul-sous-Montmédy;87;3;90
44;Grand Est;55;2;13;551;Vigneulles-lès-Hattonchâtel;1572;93;1665
44;Grand Est;55;2;07;553;Vignot;1309;33;1342
44;Grand Est;55;2;08;555;Ville-devant-Belrain;35;0;35
44;Grand Est;55;3;11;556;Ville-devant-Chaumont;50;1;51
44;Grand Est;55;3;09;557;Ville-en-Woëvre;123;2;125
44;Grand Est;55;3;08;567;Ville-sur-Cousances;140;2;142
44;Grand Est;55;1;01;568;Ville-sur-Saulx;287;11;298
44;Grand Est;55;3;11;554;Villécloye;265;15;280
44;Grand Est;55;2;15;559;Villeroy-sur-Méholle;37;2;39
44;Grand Est;55;1;12;560;Villers-aux-Vents;132;4;136
44;Grand Est;55;3;14;561;Villers-devant-Dun;52;5;57
44;Grand Est;55;1;10;562;Villers-le-Sec;125;2;127
44;Grand Est;55;3;05;563;Villers-lès-Mangiennes;81;4;85
44;Grand Est;55;3;09;565;Villers-sous-Pareid;79;3;82
44;Grand Est;55;3;08;566;Villers-sur-Meuse;307;2;309
44;Grand Est;55;1;12;569;Villotte-devant-Louppy;164;4;168
44;Grand Est;55;2;08;570;Villotte-sur-Aire;200;8;208
44;Grand Est;55;3;06;571;Vilosnes-Haraumont;221;8;229
44;Grand Est;55;3;11;572;Vittarville;78;1;79
44;Grand Est;55;2;15;573;Void-Vacon;1639;30;1669
44;Grand Est;55;2;10;574;Vouthon-Bas;49;2;51
44;Grand Est;55;2;10;575;Vouthon-Haut;84;0;84
44;Grand Est;55;1;08;577;Waly;60;2;62
44;Grand Est;55;3;09;578;Warcq;196;7;203
44;Grand Est;55;3;09;579;Watronville;105;0;105
44;Grand Est;55;3;11;580;Wavrille;50;3;53
44;Grand Est;55;1;15;581;Willeroncourt;107;4;111
44;Grand Est;55;3;14;582;Wiseppe;97;1;98
44;Grand Est;55;3;09;583;Woël;200;2;202
44;Grand Est;55;2;08;584;Woimbey;122;3;125
44;Grand Est;55;2;13;586;Xivray-et-Marvoisin;99;2;101
53;Bretagne;56;3;04;001;Allaire;3854;125;3979
53;Bretagne;56;3;11;002;Ambon;1817;46;1863
53;Bretagne;56;3;20;003;Arradon;5340;172;5512
53;Bretagne;56;3;11;004;Arzal;1656;31;1687
53;Bretagne;56;3;18;005;Arzon;2073;41;2114
53;Bretagne;56;3;04;006;Augan;1547;32;1579
53;Bretagne;56;1;01;007;Auray;13627;389;14016
53;Bretagne;56;3;20;008;Baden;4340;120;4460
53;Bretagne;56;1;17;009;Bangor;999;24;1023
53;Bretagne;56;2;15;010;Baud;6261;193;6454
53;Bretagne;56;3;04;011;Béganne;1404;27;1431
53;Bretagne;56;3;04;012;Beignon;1863;40;1903
53;Bretagne;56;1;17;013;Belz;3711;56;3767
53;Bretagne;56;2;02;014;Berné;1531;142;1673
53;Bretagne;56;3;16;015;Berric;1904;29;1933
53;Bretagne;56;2;10;017;Bignan;2791;61;2852
53;Bretagne;56;3;11;018;Billiers;959;26;985
53;Bretagne;56;2;10;019;Billio;353;10;363
53;Bretagne;56;3;10;020;Bohal;830;15;845
53;Bretagne;56;3;20;262;Bono;2466;42;2508
53;Bretagne;56;1;14;021;Brandérion;1429;26;1455
53;Bretagne;56;3;03;022;Brandivy;1280;25;1305
53;Bretagne;56;1;14;023;Brech;6637;275;6912
53;Bretagne;56;2;03;024;Bréhan;2305;41;2346
53;Bretagne;56;2;13;025;Brignac;186;4;190
53;Bretagne;56;1;05;026;Bubry;2374;37;2411
53;Bretagne;56;2;10;027;Buléon;534;10;544
53;Bretagne;56;3;16;028;Caden;1630;39;1669
53;Bretagne;56;1;05;029;Calan;1206;23;1229
53;Bretagne;56;3;11;030;Camoël;1007;15;1022
53;Bretagne;56;1;14;031;Camors;3030;61;3091
53;Bretagne;56;2;13;032;Campénéac;1903;54;1957
53;Bretagne;56;3;04;033;Carentoir;3165;60;3225
53;Bretagne;56;1;17;034;Carnac;4251;123;4374
53;Bretagne;56;3;10;035;Caro;1151;30;1181
53;Bretagne;56;1;07;036;Caudan;6838;197;7035
53;Bretagne;56;2;03;039;La Chapelle-Neuve;980;21;1001
53;Bretagne;56;1;05;040;Cléguer;3323;60;3383
53;Bretagne;56;2;02;041;Cléguérec;2906;94;3000
53;Bretagne;56;3;03;042;Colpo;2222;35;2257
53;Bretagne;56;2;13;043;Concoret;734;11;745
53;Bretagne;56;3;04;044;Cournon;761;23;784
53;Bretagne;56;3;16;045;Le Cours;670;10;680
53;Bretagne;56;1;01;046;Crach;3339;92;3431
53;Bretagne;56;2;03;047;Crédin;1559;30;1589
53;Bretagne;56;2;02;048;Le Croisty;709;18;727
53;Bretagne;56;2;13;050;La Croix-Helléan;891;31;922
53;Bretagne;56;2;15;049;Croixanvec;164;3;167
53;Bretagne;56;2;13;051;Cruguel;651;5;656
53;Bretagne;56;3;11;052;Damgan;1702;25;1727
53;Bretagne;56;3;16;053;Elven;6021;116;6137
53;Bretagne;56;1;17;054;Erdeven;3666;79;3745
53;Bretagne;56;1;17;055;Étel;1971;189;2160
53;Bretagne;56;2;03;144;Évellys;3482;64;3546
53;Bretagne;56;2;13;056;Évriguet;181;3;184
53;Bretagne;56;2;02;057;Le Faouët;2803;58;2861
53;Bretagne;56;3;11;058;Férel;3220;71;3291
53;Bretagne;56;2;13;102;Forges de Lanouée;2223;52;2275
53;Bretagne;56;3;04;060;Les Fougerêts;945;35;980
53;Bretagne;56;3;04;061;La Gacilly;3975;80;4055
53;Bretagne;56;1;14;062;Gâvres;675;19;694
53;Bretagne;56;1;05;063;Gestel;2684;83;2767
53;Bretagne;56;2;13;065;Gourhel;702;24;726
53;Bretagne;56;2;02;066;Gourin;3803;149;3952
53;Bretagne;56;3;03;067;Grand-Champ;5404;131;5535
53;Bretagne;56;2;13;068;La Grée-Saint-Laurent;336;9;345
53;Bretagne;56;1;09;069;Groix;2263;57;2320
53;Bretagne;56;2;13;070;Guégon;2287;50;2337
53;Bretagne;56;2;10;071;Guéhenno;796;12;808
53;Bretagne;56;2;15;072;Gueltas;512;13;525
53;Bretagne;56;2;02;073;Guémené-sur-Scorff;1061;15;1076
53;Bretagne;56;2;15;074;Guénin;1769;24;1793
53;Bretagne;56;3;04;075;Guer;6192;285;6477
53;Bretagne;56;2;15;076;Guern;1306;40;1346
53;Bretagne;56;3;11;077;Le Guerno;969;16;985
53;Bretagne;56;1;05;078;Guidel;11550;341;11891
53;Bretagne;56;2;13;079;Guillac;1357;38;1395
53;Bretagne;56;2;13;080;Guilliers;1313;142;1455
53;Bretagne;56;2;02;081;Guiscriff;2088;54;2142
53;Bretagne;56;2;13;082;Helléan;375;7;382
53;Bretagne;56;1;06;083;Hennebont;15678;363;16041
53;Bretagne;56;3;18;084;Le Hézo;813;13;826
53;Bretagne;56;1;17;085;Hœdic;99;6;105
53;Bretagne;56;3;20;087;Île-aux-Moines;606;15;621
53;Bretagne;56;3;20;088;Île-d'Arz;225;8;233
53;Bretagne;56;1;17;086;Île-d'Houat;231;6;237
53;Bretagne;56;1;05;089;Inguiniel;2158;53;2211
53;Bretagne;56;1;05;090;Inzinzac-Lochrist;6526;131;6657
53;Bretagne;56;2;13;091;Josselin;2495;95;2590
53;Bretagne;56;2;15;092;Kerfourn;838;16;854
53;Bretagne;56;2;02;093;Kergrist;723;15;738
53;Bretagne;56;2;02;264;Kernascléden;398;10;408
53;Bretagne;56;1;06;094;Kervignac;6596;204;6800
53;Bretagne;56;1;14;096;Landaul;2298;50;2348
53;Bretagne;56;1;14;097;Landévant;3810;68;3878
53;Bretagne;56;1;07;098;Lanester;22728;491;23219
53;Bretagne;56;2;02;099;Langoëlan;380;6;386
53;Bretagne;56;2;02;100;Langonnet;1757;59;1816
53;Bretagne;56;1;06;101;Languidic;7971;148;8119
53;Bretagne;56;2;13;103;Lantillac;306;4;310
53;Bretagne;56;1;05;104;Lanvaudan;798;10;808
53;Bretagne;56;2;02;105;Lanvénégen;1165;25;1190
53;Bretagne;56;3;20;106;Larmor-Baden;887;19;906
53;Bretagne;56;1;12;107;Larmor-Plage;8299;240;8539
53;Bretagne;56;3;16;108;Larré;1040;20;1060
53;Bretagne;56;3;16;109;Lauzach;1146;9;1155
53;Bretagne;56;2;02;110;Lignol;853;21;874
53;Bretagne;56;3;16;111;Limerzel;1336;22;1358
53;Bretagne;56;3;10;112;Lizio;735;15;750
53;Bretagne;56;2;02;113;Locmalo;904;21;925
53;Bretagne;56;1;17;114;Locmaria;868;27;895
53;Bretagne;56;3;03;115;Locmaria-Grand-Champ;1707;39;1746
53;Bretagne;56;1;01;116;Locmariaquer;1566;45;1611
53;Bretagne;56;2;03;117;Locminé;4332;221;4553
53;Bretagne;56;1;06;118;Locmiquélic;4046;114;4160
53;Bretagne;56;1;17;119;Locoal-Mendon;3416;65;3481
53;Bretagne;56;3;03;120;Locqueltas;1758;37;1795
53;Bretagne;56;1;98;121;Lorient;57149;1468;58617
53;Bretagne;56;2;13;122;Loyat;1624;41;1665
53;Bretagne;56;3;16;123;Malansac;2202;43;2245
53;Bretagne;56;3;10;124;Malestroit;2456;77;2533
53;Bretagne;56;2;02;125;Malguénac;1843;53;1896
53;Bretagne;56;3;11;126;Marzan;2308;26;2334
53;Bretagne;56;2;13;127;Mauron;3082;63;3145
53;Bretagne;56;2;15;128;Melrand;1516;26;1542
53;Bretagne;56;2;13;129;Ménéac;1578;45;1623
53;Bretagne;56;1;14;130;Merlevenez;3207;68;3275
53;Bretagne;56;2;02;131;Meslan;1424;32;1456
53;Bretagne;56;3;21;132;Meucon;2248;52;2300
53;Bretagne;56;3;10;133;Missiriac;1145;27;1172
53;Bretagne;56;2;13;134;Mohon;983;10;993
53;Bretagne;56;3;16;135;Molac;1569;28;1597
53;Bretagne;56;3;04;136;Monteneuf;756;15;771
53;Bretagne;56;3;21;137;Monterblanc;3275;76;3351
53;Bretagne;56;2;13;139;Montertelot;355;10;365
53;Bretagne;56;2;10;140;Moréac;3765;63;3828
53;Bretagne;56;2;03;141;Moustoir-Ac;1804;40;1844
53;Bretagne;56;3;11;143;Muzillac;5015;124;5139
53;Bretagne;56;2;13;145;Néant-sur-Yvel;1087;25;1112
53;Bretagne;56;2;02;146;Neulliac;1412;50;1462
53;Bretagne;56;3;11;147;Nivillac;4612;84;4696
53;Bretagne;56;1;14;148;Nostang;1545;31;1576
53;Bretagne;56;3;11;149;Noyal-Muzillac;2520;53;2573
53;Bretagne;56;2;15;151;Noyal-Pontivy;3639;118;3757
53;Bretagne;56;1;17;152;Le Palais;2571;58;2629
53;Bretagne;56;3;11;153;Péaule;2682;42;2724
53;Bretagne;56;3;04;154;Peillac;1858;51;1909
53;Bretagne;56;3;11;155;Pénestin;1946;24;1970
53;Bretagne;56;2;02;156;Persquen;346;6;352
53;Bretagne;56;3;03;157;Plaudren;1946;33;1979
53;Bretagne;56;3;20;158;Plescop;5854;168;6022
53;Bretagne;56;3;10;159;Pleucadeuc;1804;43;1847
53;Bretagne;56;2;03;160;Pleugriffet;1272;21;1293
53;Bretagne;56;1;17;161;Ploemel;2888;86;2974
53;Bretagne;56;1;12;162;Ploemeur;17853;683;18536
53;Bretagne;56;2;02;163;Ploërdut;1216;28;1244
53;Bretagne;56;3;20;164;Ploeren;6575;209;6784
53;Bretagne;56;2;13;165;Ploërmel;9837;583;10420
53;Bretagne;56;1;05;166;Plouay;5670;127;5797
53;Bretagne;56;3;20;167;Plougoumelen;2439;63;2502
53;Bretagne;56;1;17;168;Plouharnel;2160;48;2208
53;Bretagne;56;1;14;169;Plouhinec;5353;126;5479
53;Bretagne;56;2;02;170;Plouray;1121;33;1154
53;Bretagne;56;3;16;171;Pluherlin;1528;27;1555
53;Bretagne;56;2;10;172;Plumelec;2680;67;2747
53;Bretagne;56;2;15;173;Pluméliau-Bieuzy;4379;97;4476
53;Bretagne;56;2;03;174;Plumelin;2723;68;2791
53;Bretagne;56;1;01;175;Plumergat;4112;93;4205
53;Bretagne;56;1;01;176;Pluneret;5722;133;5855
53;Bretagne;56;1;14;177;Pluvigner;7543;138;7681
53;Bretagne;56;1;05;179;Pont-Scorff;3744;91;3835
53;Bretagne;56;2;15;178;Pontivy;14606;938;15544
53;Bretagne;56;3;04;180;Porcaro;722;16;738
53;Bretagne;56;1;06;181;Port-Louis;2618;81;2699
53;Bretagne;56;2;02;182;Priziac;976;180;1156
53;Bretagne;56;3;16;184;Questembert;7585;272;7857
53;Bretagne;56;1;12;185;Quéven;8676;219;8895
53;Bretagne;56;1;17;186;Quiberon;4741;93;4834
53;Bretagne;56;1;05;188;Quistinic;1431;23;1454
53;Bretagne;56;2;03;189;Radenac;1059;17;1076
53;Bretagne;56;2;03;190;Réguiny;1992;55;2047
53;Bretagne;56;3;04;191;Réminiac;384;7;391
53;Bretagne;56;1;06;193;Riantec;5622;139;5761
53;Bretagne;56;3;04;194;Rieux;2845;75;2920
53;Bretagne;56;3;11;195;La Roche-Bernard;692;11;703
53;Bretagne;56;3;16;196;Rochefort-en-Terre;632;13;645
53;Bretagne;56;2;03;198;Rohan;1636;48;1684
53;Bretagne;56;2;02;199;Roudouallec;710;13;723
53;Bretagne;56;3;10;200;Ruffiac;1410;34;1444
53;Bretagne;56;2;02;201;Le Saint;587;11;598
53;Bretagne;56;3;10;202;Saint-Abraham;536;15;551
53;Bretagne;56;2;02;203;Saint-Aignan;605;13;618
53;Bretagne;56;2;10;204;Saint-Allouestre;627;8;635
53;Bretagne;56;3;18;205;Saint-Armel;886;18;904
53;Bretagne;56;3;21;206;Saint-Avé;11642;303;11945
53;Bretagne;56;2;15;207;Saint-Barthélemy;1164;18;1182
53;Bretagne;56;2;13;208;Saint-Brieuc-de-Mauron;331;10;341
53;Bretagne;56;2;02;210;Saint-Caradec-Trégomel;480;6;486
53;Bretagne;56;3;10;211;Saint-Congard;764;16;780
53;Bretagne;56;3;11;212;Saint-Dolay;2487;39;2526
53;Bretagne;56;2;15;213;Saint-Gérand;1115;29;1144
53;Bretagne;56;3;18;214;Saint-Gildas-de-Rhuys;1576;24;1600
53;Bretagne;56;2;15;215;Saint-Gonnery;1090;24;1114
53;Bretagne;56;3;04;216;Saint-Gorgon;394;4;398
53;Bretagne;56;3;16;218;Saint-Gravé;730;5;735
53;Bretagne;56;3;10;219;Saint-Guyomard;1362;22;1384
53;Bretagne;56;3;04;221;Saint-Jacut-les-Pins;1733;107;1840
53;Bretagne;56;2;10;222;Saint-Jean-Brévelay;2789;131;2920
53;Bretagne;56;3;04;223;Saint-Jean-la-Poterie;1500;50;1550
53;Bretagne;56;3;10;224;Saint-Laurent-sur-Oust;366;8;374
53;Bretagne;56;2;13;225;Saint-Léry;189;7;196
53;Bretagne;56;3;04;226;Saint-Malo-de-Beignon;511;16;527
53;Bretagne;56;2;13;227;Saint-Malo-des-Trois-Fontaines;568;14;582
53;Bretagne;56;3;10;228;Saint-Marcel;1074;47;1121
53;Bretagne;56;3;04;229;Saint-Martin-sur-Oust;1305;19;1324
53;Bretagne;56;3;10;230;Saint-Nicolas-du-Tertre;468;11;479
53;Bretagne;56;3;21;231;Saint-Nolff;3779;120;3899
53;Bretagne;56;3;04;232;Saint-Perreux;1145;43;1188
53;Bretagne;56;1;01;233;Saint-Philibert;1496;42;1538
53;Bretagne;56;1;17;234;Saint-Pierre-Quiberon;2060;38;2098
53;Bretagne;56;2;13;236;Saint-Servant;811;19;830
53;Bretagne;56;2;15;237;Saint-Thuriau;1863;74;1937
53;Bretagne;56;2;02;238;Saint-Tugdual;370;5;375
53;Bretagne;56;3;04;239;Saint-Vincent-sur-Oust;1512;41;1553
53;Bretagne;56;1;01;263;Sainte-Anne-d'Auray;2708;94;2802
53;Bretagne;56;2;02;209;Sainte-Brigitte;177;7;184
53;Bretagne;56;1;14;220;Sainte-Hélène;1247;29;1276
53;Bretagne;56;3;18;240;Sarzeau;8182;163;8345
53;Bretagne;56;1;17;241;Sauzon;988;28;1016
53;Bretagne;56;2;02;242;Séglien;669;18;687
53;Bretagne;56;3;18;243;Séné;8947;252;9199
53;Bretagne;56;3;10;244;Sérent;3048;41;3089
53;Bretagne;56;2;02;245;Silfiac;434;7;441
53;Bretagne;56;2;15;246;Le Sourn;2107;44;2151
53;Bretagne;56;3;16;247;Sulniac;3674;68;3742
53;Bretagne;56;3;18;248;Surzur;4429;91;4520
53;Bretagne;56;2;13;249;Taupont;2198;87;2285
53;Bretagne;56;3;04;250;Théhillac;596;5;601
53;Bretagne;56;3;18;251;Theix-Noyalo;7966;197;8163
53;Bretagne;56;3;18;252;Le Tour-du-Parc;1231;8;1239
53;Bretagne;56;3;04;253;Tréal;640;25;665
53;Bretagne;56;3;16;254;Trédion;1273;17;1290
53;Bretagne;56;3;21;255;Treffléan;2324;55;2379
53;Bretagne;56;2;13;256;Tréhorenteuc;122;1;123
53;Bretagne;56;2;13;257;La Trinité-Porhoët;677;18;695
53;Bretagne;56;1;17;258;La Trinité-sur-Mer;1610;46;1656
53;Bretagne;56;3;18;259;La Trinité-Surzur;1611;21;1632
53;Bretagne;56;2;89;197;Val d'Oust;2705;75;2780
53;Bretagne;56;3;99;260;Vannes;53352;2070;55422
53;Bretagne;56;3;16;261;La Vraie-Croix;1471;30;1501
44;Grand Est;57;7;14;001;Aboncourt;351;3;354
44;Grand Est;57;5;23;002;Aboncourt-sur-Seille;72;2;74
44;Grand Est;57;5;17;003;Abreschviller;1427;22;1449
44;Grand Est;57;5;23;004;Achain;82;2;84
44;Grand Est;57;6;02;006;Achen;1011;28;1039
44;Grand Est;57;3;07;007;Adaincourt;125;1;126
44;Grand Est;57;3;07;008;Adelange;209;7;216
44;Grand Est;57;5;23;009;Ajoncourt;103;1;104
44;Grand Est;57;5;23;010;Alaincourt-la-Côte;149;2;151
44;Grand Est;57;5;23;011;Albestroff;634;23;657
44;Grand Est;57;7;01;012;Algrange;6144;56;6200
44;Grand Est;57;3;25;013;Alsting;2589;46;2635
44;Grand Est;57;3;20;014;Altrippe;382;7;389
44;Grand Est;57;3;19;015;Altviller;586;7;593
44;Grand Est;57;3;04;016;Alzing;392;8;400
44;Grand Est;57;9;18;017;Amanvillers;2161;23;2184
44;Grand Est;57;5;23;018;Amelécourt;154;10;164
44;Grand Est;57;9;18;019;Amnéville;10416;62;10478
44;Grand Est;57;9;07;020;Ancerville;302;2;304
44;Grand Est;57;9;05;021;Ancy-Dornot;1560;33;1593
44;Grand Est;57;7;01;022;Angevillers;1253;29;1282
44;Grand Est;57;9;16;024;Antilly;172;0;172
44;Grand Est;57;3;04;025;Anzeling;521;7;528
44;Grand Est;57;7;04;026;Apach;1032;17;1049
44;Grand Est;57;9;16;028;Argancy;1343;19;1362
44;Grand Est;57;3;07;027;Arraincourt;126;3;129
44;Grand Est;57;3;07;029;Arriance;212;2;214
44;Grand Est;57;9;05;030;Arry;554;4;558
44;Grand Est;57;9;16;031;Ars-Laquenexy;910;15;925
44;Grand Est;57;9;05;032;Ars-sur-Moselle;4723;46;4769
44;Grand Est;57;5;17;033;Arzviller;535;16;551
44;Grand Est;57;5;17;034;Aspach;34;1;35
44;Grand Est;57;5;21;035;Assenoncourt;116;3;119
44;Grand Est;57;5;23;036;Attilloncourt;105;0;105
44;Grand Est;57;9;07;037;Aube;268;5;273
44;Grand Est;57;7;01;038;Audun-le-Tiche;6846;62;6908
44;Grand Est;57;9;05;039;Augny;1996;30;2026
44;Grand Est;57;5;23;040;Aulnois-sur-Seille;278;2;280
44;Grand Est;57;7;01;041;Aumetz;2319;31;2350
44;Grand Est;57;5;21;042;Avricourt;612;8;620
44;Grand Est;57;9;16;043;Ay-sur-Moselle;1491;31;1522
44;Grand Est;57;5;21;044;Azoudange;118;5;123
44;Grand Est;57;5;23;045;Bacourt;109;2;111
44;Grand Est;57;6;02;046;Baerenthal;778;13;791
44;Grand Est;57;3;07;047;Bambiderstroff;1060;20;1080
44;Grand Est;57;9;15;049;Le Ban-Saint-Martin;4341;98;4439
44;Grand Est;57;3;03;048;Bannay;73;2;75
44;Grand Est;57;5;17;050;Barchain;110;2;112
44;Grand Est;57;3;20;051;Baronville;364;8;372
44;Grand Est;57;3;09;052;Barst;579;9;588
44;Grand Est;57;7;14;287;Basse-Ham;2237;51;2288
44;Grand Est;57;7;27;574;Basse-Rentgen;491;10;501
44;Grand Est;57;5;23;053;Bassing;119;5;124
44;Grand Est;57;5;23;054;Baudrecourt;186;1;187
44;Grand Est;57;9;16;055;Bazoncourt;540;2;542
44;Grand Est;57;5;21;056;Bébing;201;4;205
44;Grand Est;57;9;07;057;Béchy;630;5;635
44;Grand Est;57;3;25;058;Behren-lès-Forbach;6562;64;6626
44;Grand Est;57;5;23;059;Bellange;55;2;57
44;Grand Est;57;5;21;086;Belles-Forêts;245;5;250
44;Grand Est;57;5;23;060;Bénestroff;550;7;557
44;Grand Est;57;3;09;061;Béning-lès-Saint-Avold;1140;25;1165
44;Grand Est;57;7;27;062;Berg-sur-Moselle;430;15;445
44;Grand Est;57;3;20;063;Bérig-Vintrange;219;8;227
44;Grand Est;57;5;17;064;Berling;270;4;274
44;Grand Est;57;5;23;065;Bermering;225;6;231
44;Grand Est;57;5;21;066;Berthelming;511;9;520
44;Grand Est;57;7;14;067;Bertrange;2691;54;2745
44;Grand Est;57;3;04;069;Berviller-en-Moselle;471;7;478
44;Grand Est;57;3;03;070;Bettange;242;2;244
44;Grand Est;57;5;21;071;Bettborn;395;5;400
44;Grand Est;57;7;14;072;Bettelainville;625;8;633
44;Grand Est;57;3;09;073;Betting;882;16;898
44;Grand Est;57;6;02;074;Bettviller;831;17;848
44;Grand Est;57;9;07;075;Beux;274;3;277
44;Grand Est;57;7;27;076;Beyren-lès-Sierck;517;17;534
44;Grand Est;57;5;23;077;Bezange-la-Petite;92;3;95
44;Grand Est;57;3;04;079;Bibiche;452;9;461
44;Grand Est;57;5;21;080;Bickenholtz;81;0;81
44;Grand Est;57;5;23;081;Bidestroff;129;1;130
44;Grand Est;57;3;20;082;Biding;324;6;330
44;Grand Est;57;6;02;083;Bining;1173;25;1198
44;Grand Est;57;5;23;084;Bioncourt;307;2;309
44;Grand Est;57;3;03;085;Bionville-sur-Nied;381;9;390
44;Grand Est;57;3;03;087;Bisten-en-Lorraine;246;4;250
44;Grand Est;57;3;20;088;Bistroff;311;7;318
44;Grand Est;57;6;02;089;Bitche;5098;118;5216
44;Grand Est;57;5;23;090;Blanche-Église;113;2;115
44;Grand Est;57;6;22;092;Blies-Ébersing;646;8;654
44;Grand Est;57;6;22;093;Blies-Guersviller;644;12;656
44;Grand Est;57;6;22;091;Bliesbruck;1017;19;1036
44;Grand Est;57;3;07;095;Boucheporn;581;14;595
44;Grand Est;57;7;01;096;Boulange;2494;25;2519
44;Grand Est;57;3;03;097;Boulay-Moselle;5587;71;5658
44;Grand Est;57;5;23;099;Bourdonnay;229;5;234
44;Grand Est;57;5;23;098;Bourgaltroff;245;2;247
44;Grand Est;57;5;17;100;Bourscheid;179;4;183
44;Grand Est;57;3;25;101;Bousbach;1226;24;1250
44;Grand Est;57;7;14;102;Bousse;3174;48;3222
44;Grand Est;57;6;02;103;Bousseviller;125;4;129
44;Grand Est;57;7;27;104;Boust;1228;23;1251
44;Grand Est;57;3;20;105;Boustroff;149;2;151
44;Grand Est;57;3;04;106;Bouzonville;3947;80;4027
44;Grand Est;57;5;23;107;Bréhain;107;0;107
44;Grand Est;57;6;02;108;Breidenbach;328;12;340
44;Grand Est;57;7;27;109;Breistroff-la-Grande;698;15;713
44;Grand Est;57;3;04;110;Brettnach;441;4;445
44;Grand Est;57;9;18;111;Bronvaux;546;3;549
44;Grand Est;57;3;03;112;Brouck;84;1;85
44;Grand Est;57;5;17;113;Brouderdorff;966;23;989
44;Grand Est;57;5;17;114;Brouviller;427;15;442
44;Grand Est;57;3;20;115;Brulange;100;4;104
44;Grand Est;57;9;07;116;Buchy;99;1;100
44;Grand Est;57;7;14;117;Buding;588;5;593
44;Grand Est;57;7;14;118;Budling;176;6;182
44;Grand Est;57;5;21;119;Buhl-Lorraine;1214;31;1245
44;Grand Est;57;5;23;120;Burlioncourt;138;3;141
44;Grand Est;57;9;16;121;Burtoncourt;196;5;201
44;Grand Est;57;3;09;122;Cappel;701;12;713
44;Grand Est;57;3;19;123;Carling;3445;43;3488
44;Grand Est;57;7;27;124;Cattenom;2654;35;2689
44;Grand Est;57;9;16;125;Chailly-lès-Ennery;381;6;387
44;Grand Est;57;5;23;126;Chambrey;337;10;347
44;Grand Est;57;9;07;127;Chanville;133;0;133
44;Grand Est;57;9;16;128;Charleville-sous-Bois;320;3;323
44;Grand Est;57;9;16;129;Charly-Oradour;679;21;700
44;Grand Est;57;5;23;130;Château-Bréhain;76;1;77
44;Grand Est;57;3;04;131;Château-Rouge;292;11;303
44;Grand Est;57;5;23;132;Château-Salins;2464;237;2701
44;Grand Est;57;5;23;133;Château-Voué;101;0;101
44;Grand Est;57;9;05;134;Châtel-Saint-Germain;1873;153;2026
44;Grand Est;57;3;04;136;Chémery-les-Deux;565;6;571
44;Grand Est;57;9;07;137;Cheminot;775;13;788
44;Grand Est;57;5;23;138;Chenois;80;3;83
44;Grand Est;57;9;07;139;Chérisey;305;4;309
44;Grand Est;57;9;16;140;Chesny;594;10;604
44;Grand Est;57;5;23;141;Chicourt;96;2;98
44;Grand Est;57;9;16;142;Chieulles;417;7;424
44;Grand Est;57;7;10;143;Clouange;3495;37;3532
44;Grand Est;57;3;08;144;Cocheren;3478;42;3520
44;Grand Est;57;9;05;146;Coin-lès-Cuvry;726;16;742
44;Grand Est;57;9;05;147;Coin-sur-Seille;338;14;352
44;Grand Est;57;9;16;145;Coincy;313;5;318
44;Grand Est;57;9;16;148;Colligny-Maizery;577;12;589
44;Grand Est;57;3;04;149;Colmen;197;4;201
44;Grand Est;57;3;03;150;Condé-Northen;678;7;685
44;Grand Est;57;5;23;151;Conthil;165;3;168
44;Grand Est;57;7;04;152;Contz-les-Bains;508;10;518
44;Grand Est;57;9;05;153;Corny-sur-Moselle;2219;25;2244
44;Grand Est;57;3;03;154;Coume;662;9;671
44;Grand Est;57;9;16;155;Courcelles-Chaussy;3075;322;3397
44;Grand Est;57;9;16;156;Courcelles-sur-Nied;1190;11;1201
44;Grand Est;57;5;23;158;Craincourt;254;1;255
44;Grand Est;57;3;07;159;Créhange;3868;55;3923
44;Grand Est;57;3;03;160;Creutzwald;13095;235;13330
44;Grand Est;57;5;23;161;Cutting;139;0;139
44;Grand Est;57;9;05;162;Cuvry;847;15;862
44;Grand Est;57;5;17;163;Dabo;2522;41;2563
44;Grand Est;57;3;04;165;Dalem;646;9;655
44;Grand Est;57;5;23;166;Dalhain;110;2;112
44;Grand Est;57;3;04;167;Dalstein;361;6;367
44;Grand Est;57;5;17;168;Danne-et-Quatre-Vents;686;11;697
44;Grand Est;57;5;17;169;Dannelbourg;500;12;512
44;Grand Est;57;5;23;171;Delme;1124;9;1133
44;Grand Est;57;3;03;172;Denting;274;1;275
44;Grand Est;57;5;21;173;Desseling;103;3;106
44;Grand Est;57;3;20;174;Destry;94;1;95
44;Grand Est;57;5;21;175;Diane-Capelle;221;6;227
44;Grand Est;57;3;25;176;Diebling;1643;39;1682
44;Grand Est;57;3;19;765;Diesen;1057;15;1072
44;Grand Est;57;5;23;177;Dieuze;2903;234;3137
44;Grand Est;57;3;20;178;Diffembach-lès-Hellimer;354;6;360
44;Grand Est;57;7;14;179;Distroff;1773;31;1804
44;Grand Est;57;5;21;180;Dolving;352;6;358
44;Grand Est;57;5;23;181;Domnom-lès-Dieuze;81;1;82
44;Grand Est;57;5;23;182;Donjeux;95;3;98
44;Grand Est;57;5;23;183;Donnelay;190;2;192
44;Grand Est;57;3;04;186;Ébersviller;949;20;969
44;Grand Est;57;3;03;187;Éblange;374;6;380
44;Grand Est;57;6;02;188;Éguelshardt;426;80;506
44;Grand Est;57;3;20;189;Eincheville;220;2;222
44;Grand Est;57;3;07;190;Elvange;398;4;402
44;Grand Est;57;7;14;191;Elzange;721;8;729
44;Grand Est;57;6;02;192;Enchenberg;1239;32;1271
44;Grand Est;57;9;16;193;Ennery;2010;24;2034
44;Grand Est;57;7;27;194;Entrange;1241;37;1278
44;Grand Est;57;6;02;195;Epping;570;14;584
44;Grand Est;57;6;02;196;Erching;415;11;426
44;Grand Est;57;6;20;197;Ernestviller;503;5;508
44;Grand Est;57;3;20;198;Erstroff;194;3;197
44;Grand Est;57;7;27;199;Escherange;631;14;645
44;Grand Est;57;9;16;200;Les Étangs;401;10;411
44;Grand Est;57;6;02;201;Etting;747;14;761
44;Grand Est;57;3;25;202;Etzling;1184;17;1201
44;Grand Est;57;7;27;203;Évrange;240;3;243
44;Grand Est;57;9;16;204;Failly;511;10;521
44;Grand Est;57;3;04;205;Falck;2487;32;2519
44;Grand Est;57;7;06;206;Fameck;13931;125;14056
44;Grand Est;57;3;09;207;Farébersviller;5541;59;5600
44;Grand Est;57;3;25;208;Farschviller;1356;34;1390
44;Grand Est;57;3;07;209;Faulquemont;5306;88;5394
44;Grand Est;57;5;21;210;Fénétrange;723;13;736
44;Grand Est;57;9;18;211;Fèves;1118;19;1137
44;Grand Est;57;9;05;212;Féy;738;9;747
44;Grand Est;57;3;04;213;Filstroff;777;17;794
44;Grand Est;57;7;27;214;Fixem;418;7;425
44;Grand Est;57;7;04;215;Flastroff;326;4;330
44;Grand Est;57;5;21;216;Fleisheim;148;5;153
44;Grand Est;57;3;07;217;Flétrange;931;19;950
44;Grand Est;57;9;07;218;Fleury;1223;27;1250
44;Grand Est;57;9;16;219;Flévy;557;6;563
44;Grand Est;57;9;07;220;Flocourt;116;2;118
44;Grand Est;57;7;06;221;Florange;11951;103;12054
44;Grand Est;57;3;25;222;Folkling;1303;37;1340
44;Grand Est;57;3;19;224;Folschviller;3993;72;4065
44;Grand Est;57;5;23;225;Fonteny;143;0;143
44;Grand Est;57;7;01;226;Fontoy;3036;43;3079
44;Grand Est;57;3;08;227;Forbach;21552;306;21858
44;Grand Est;57;5;23;228;Fossieux;219;2;221
44;Grand Est;57;5;21;229;Foulcrey;170;4;174
44;Grand Est;57;3;07;230;Fouligny;195;2;197
44;Grand Est;57;9;23;231;Foville;98;0;98
44;Grand Est;57;5;23;232;Francaltroff;771;12;783
44;Grand Est;57;5;17;233;Fraquelfing;83;1;84
44;Grand Est;57;6;22;234;Frauenberg;591;8;599
44;Grand Est;57;3;04;235;Freistroff;1050;20;1070
44;Grand Est;57;5;23;236;Frémery;77;0;77
44;Grand Est;57;3;20;237;Frémestroff;301;6;307
44;Grand Est;57;5;23;238;Fresnes-en-Saulnois;183;6;189
44;Grand Est;57;3;20;239;Freybouse;432;6;438
44;Grand Est;57;3;09;240;Freyming-Merlebach;12818;142;12960
44;Grand Est;57;5;21;241;Fribourg;165;8;173
44;Grand Est;57;7;10;242;Gandrange;2907;36;2943
44;Grand Est;57;5;17;244;Garrebourg;496;11;507
44;Grand Est;57;7;27;245;Gavisse;569;9;578
44;Grand Est;57;5;23;246;Gelucourt;217;4;221
44;Grand Est;57;5;23;247;Gerbécourt;88;3;91
44;Grand Est;57;5;23;248;Givrycourt;88;1;89
44;Grand Est;57;9;16;249;Glatigny;256;7;263
44;Grand Est;57;6;02;250;Goetzenbruck;1531;41;1572
44;Grand Est;57;9;07;251;Goin;335;2;337
44;Grand Est;57;3;03;252;Gomelange;497;10;507
44;Grand Est;57;5;21;253;Gondrexange;491;4;495
44;Grand Est;57;9;05;254;Gorze;1167;10;1177
44;Grand Est;57;5;21;255;Gosselming;587;23;610
44;Grand Est;57;9;05;256;Gravelotte;830;4;834
44;Grand Est;57;5;23;257;Grémecey;105;0;105
44;Grand Est;57;3;20;258;Gréning;131;1;132
44;Grand Est;57;7;04;259;Grindorff-Bizing;317;7;324
44;Grand Est;57;6;02;261;Gros-Réderching;1333;40;1373
44;Grand Est;57;6;22;260;Grosbliederstroff;3303;53;3356
44;Grand Est;57;3;20;262;Grostenquin;631;6;637
44;Grand Est;57;6;20;263;Grundviller;658;19;677
44;Grand Est;57;6;20;264;Guebenhouse;426;6;432
44;Grand Est;57;5;23;265;Guébestroff;48;4;52
44;Grand Est;57;5;23;266;Guéblange-lès-Dieuze;156;4;160
44;Grand Est;57;5;23;268;Guébling;124;4;128
44;Grand Est;57;7;14;269;Guénange;7210;65;7275
44;Grand Est;57;3;09;271;Guenviller;645;22;667
44;Grand Est;57;5;21;272;Guermange;93;5;98
44;Grand Est;57;3;04;273;Guerstling;415;8;423
44;Grand Est;57;3;03;274;Guerting;854;20;874
44;Grand Est;57;3;20;275;Guessling-Hémering;919;13;932
44;Grand Est;57;3;07;276;Guinglange;329;5;334
44;Grand Est;57;3;03;277;Guinkirchen;152;8;160
44;Grand Est;57;5;23;278;Guinzeling;69;0;69
44;Grand Est;57;5;17;280;Guntzviller;385;13;398
44;Grand Est;57;5;23;281;Haboudange;267;4;271
44;Grand Est;57;7;27;282;Hagen;362;1;363
44;Grand Est;57;9;24;283;Hagondange;9242;97;9339
44;Grand Est;57;3;07;284;Hallering;113;5;118
44;Grand Est;57;7;04;286;Halstroff;313;9;322
44;Grand Est;57;3;03;288;Ham-sous-Varsberg;2825;40;2865
44;Grand Est;57;6;22;289;Hambach;2886;67;2953
44;Grand Est;57;5;23;290;Hampont;185;2;187
44;Grand Est;57;3;07;293;Han-sur-Nied;258;8;266
44;Grand Est;57;5;17;291;Hangviller;263;4;267
44;Grand Est;57;5;23;292;Hannocourt;21;1;22
44;Grand Est;57;6;02;294;Hanviller;208;8;216
44;Grand Est;57;5;23;295;Haraucourt-sur-Seille;103;1;104
44;Grand Est;57;3;04;296;Hargarten-aux-Mines;1107;20;1127
44;Grand Est;57;3;20;297;Harprich;173;6;179
44;Grand Est;57;5;17;298;Harreberg;395;7;402
44;Grand Est;57;5;17;299;Hartzviller;912;15;927
44;Grand Est;57;5;17;300;Haselbourg;315;7;322
44;Grand Est;57;6;02;301;Haspelschiedt;303;12;315
44;Grand Est;57;5;17;302;Hattigny;187;1;188
44;Grand Est;57;9;24;303;Hauconcourt;623;9;632
44;Grand Est;57;5;21;304;Haut-Clocher;348;11;359
44;Grand Est;57;7;04;371;Haute-Kontz;588;7;595
44;Grand Est;57;3;07;714;Haute-Vigneulles;416;9;425
44;Grand Est;57;7;01;305;Havange;448;8;456
44;Grand Est;57;7;10;306;Hayange;15811;161;15972
44;Grand Est;57;9;16;307;Hayes;232;6;238
44;Grand Est;57;6;20;308;Hazembourg;138;5;143
44;Grand Est;57;3;04;309;Heining-lès-Bouzonville;477;9;486
44;Grand Est;57;5;21;310;Hellering-lès-Fénétrange;187;1;188
44;Grand Est;57;3;20;311;Hellimer;548;9;557
44;Grand Est;57;3;03;312;Helstroff;535;16;551
44;Grand Est;57;3;07;313;Hémilly;143;3;146
44;Grand Est;57;5;17;314;Héming;498;2;500
44;Grand Est;57;5;17;315;Henridorff;701;14;715
44;Grand Est;57;3;09;316;Henriville;753;15;768
44;Grand Est;57;5;17;317;Hérange;108;4;112
44;Grand Est;57;5;17;318;Hermelange;224;5;229
44;Grand Est;57;3;07;319;Herny;508;5;513
44;Grand Est;57;5;21;320;Hertzing;190;2;192
44;Grand Est;57;5;17;321;Hesse;572;24;596
44;Grand Est;57;3;04;322;Hestroff;449;14;463
44;Grand Est;57;7;27;323;Hettange-Grande;7653;166;7819
44;Grand Est;57;5;21;324;Hilbesheim;607;21;628
44;Grand Est;57;6;20;325;Hilsprich;857;17;874
44;Grand Est;57;3;03;326;Hinckange;325;4;329
44;Grand Est;57;3;07;328;Holacourt;88;2;90
44;Grand Est;57;3;04;329;Holling;440;5;445
44;Grand Est;57;6;20;330;Holving;1290;11;1301
44;Grand Est;57;7;14;331;Hombourg-Budange;556;10;566
44;Grand Est;57;3;09;332;Hombourg-Haut;6433;66;6499
44;Grand Est;57;5;21;333;Hommarting;850;24;874
44;Grand Est;57;5;17;334;Hommert;337;10;347
44;Grand Est;57;5;23;335;Honskirch;224;4;228
44;Grand Est;57;3;19;336;L' Hôpital;5350;55;5405
44;Grand Est;57;3;09;337;Hoste;611;18;629
44;Grand Est;57;6;02;338;Hottviller;522;6;528
44;Grand Est;57;5;17;339;Hultehouse;364;5;369
44;Grand Est;57;6;22;340;Hundling;1350;20;1370
44;Grand Est;57;7;04;341;Hunting;721;18;739
44;Grand Est;57;5;21;342;Ibigny;97;1;98
44;Grand Est;57;7;27;343;Illange;1870;30;1900
44;Grand Est;57;5;21;344;Imling;724;9;733
44;Grand Est;57;7;14;345;Inglange;441;25;466
44;Grand Est;57;5;23;346;Insming;584;23;607
44;Grand Est;57;5;23;347;Insviller;177;3;180
44;Grand Est;57;6;22;348;Ippling;785;17;802
44;Grand Est;57;5;23;349;Jallaucourt;166;0;166
44;Grand Est;57;9;05;350;Jouy-aux-Arches;1472;22;1494
44;Grand Est;57;9;16;351;Jury;1036;22;1058
44;Grand Est;57;9;05;352;Jussy;443;17;460
44;Grand Est;57;5;23;353;Juvelize;71;1;72
44;Grand Est;57;5;23;354;Juville;119;5;124
44;Grand Est;57;6;22;355;Kalhausen;837;18;855
44;Grand Est;57;7;27;356;Kanfen;1174;21;1195
44;Grand Est;57;6;20;357;Kappelkinger;398;9;407
44;Grand Est;57;7;14;358;Kédange-sur-Canner;1087;22;1109
44;Grand Est;57;7;14;359;Kemplich;168;4;172
44;Grand Est;57;3;25;360;Kerbach;1189;32;1221
44;Grand Est;57;7;04;361;Kerling-lès-Sierck;578;17;595
44;Grand Est;57;5;21;362;Kerprich-aux-Bois;165;3;168
44;Grand Est;57;7;04;364;Kirsch-lès-Sierck;308;4;312
44;Grand Est;57;7;04;365;Kirschnaumen;481;6;487
44;Grand Est;57;6;20;366;Kirviller;141;2;143
44;Grand Est;57;7;14;367;Klang;239;3;242
44;Grand Est;57;7;01;368;Knutange;3203;58;3261
44;Grand Est;57;7;14;372;Kuntzig;1314;14;1328
44;Grand Est;57;7;14;370;Kœnigsmacker;2244;41;2285
44;Grand Est;57;3;19;373;Lachambre;914;27;941
44;Grand Est;57;5;17;374;Lafrimbolle;202;6;208
44;Grand Est;57;5;23;375;Lagarde;190;1;191
44;Grand Est;57;6;02;376;Lambach;508;6;514
44;Grand Est;57;5;17;377;Landange;242;3;245
44;Grand Est;57;3;20;379;Landroff;271;1;272
44;Grand Est;57;5;23;381;Laneuveville-en-Saulnois;303;3;306
44;Grand Est;57;5;17;380;Laneuveville-lès-Lorquin;102;3;105
44;Grand Est;57;5;21;382;Langatte;559;6;565
44;Grand Est;57;5;21;383;Languimberg;173;4;177
44;Grand Est;57;3;20;384;Laning;604;18;622
44;Grand Est;57;9;16;385;Laquenexy;1143;20;1163
44;Grand Est;57;3;07;386;Laudrefang;341;7;348
44;Grand Est;57;7;04;387;Laumesfeld;284;1;285
44;Grand Est;57;7;04;388;Launstroff;264;4;268
44;Grand Est;57;3;20;389;Lelling;472;12;484
44;Grand Est;57;6;02;390;Lemberg;1455;24;1479
44;Grand Est;57;5;23;391;Lemoncourt;70;1;71
44;Grand Est;57;9;07;392;Lemud;501;3;504
44;Grand Est;57;6;02;393;Lengelsheim;205;3;208
44;Grand Est;57;5;23;394;Léning;339;12;351
44;Grand Est;57;5;23;395;Lesse;206;4;210
44;Grand Est;57;9;05;396;Lessy;745;28;773
44;Grand Est;57;5;23;397;Ley;97;1;98
44;Grand Est;57;3;20;398;Leyviller;493;10;503
44;Grand Est;57;5;23;399;Lezey;100;4;104
44;Grand Est;57;5;23;410;Lhor;134;3;137
44;Grand Est;57;5;23;401;Lidrezing;86;1;87
44;Grand Est;57;6;02;402;Liederschiedt;122;4;126
44;Grand Est;57;9;07;403;Liéhon;114;2;116
44;Grand Est;57;5;23;404;Lindre-Basse;218;7;225
44;Grand Est;57;5;23;405;Lindre-Haute;50;1;51
44;Grand Est;57;5;23;406;Liocourt;136;7;143
44;Grand Est;57;5;17;407;Lixheim;579;6;585
44;Grand Est;57;6;22;408;Lixing-lès-Rouhling;937;19;956
44;Grand Est;57;3;20;409;Lixing-lès-Saint-Avold;682;17;699
44;Grand Est;57;7;01;411;Lommerange;301;1;302
44;Grand Est;57;9;15;412;Longeville-lès-Metz;4030;59;4089
44;Grand Est;57;3;07;413;Longeville-lès-Saint-Avold;3666;81;3747
44;Grand Est;57;5;17;414;Lorquin;1151;26;1177
44;Grand Est;57;9;05;415;Lorry-lès-Metz;1786;77;1863
44;Grand Est;57;9;05;416;Lorry-Mardigny;650;16;666
44;Grand Est;57;5;23;417;Lostroff;69;0;69
44;Grand Est;57;5;23;418;Loudrefing;322;4;326
44;Grand Est;57;6;20;419;Loupershouse;925;23;948
44;Grand Est;57;6;02;421;Loutzviller;150;3;153
44;Grand Est;57;9;07;422;Louvigny;899;11;910
44;Grand Est;57;5;23;423;Lubécourt;73;0;73
44;Grand Est;57;5;23;424;Lucy;228;2;230
44;Grand Est;57;9;07;425;Luppy;570;5;575
44;Grand Est;57;7;14;426;Luttange;892;8;900
44;Grand Est;57;5;17;427;Lutzelbourg;584;9;593
44;Grand Est;57;3;19;428;Macheren;2767;68;2835
44;Grand Est;57;3;07;430;Mainvillers;335;8;343
44;Grand Est;57;9;16;431;Maizeroy;390;3;393
44;Grand Est;57;9;24;433;Maizières-lès-Metz;11388;122;11510
44;Grand Est;57;5;23;434;Maizières-lès-Vic;496;9;505
44;Grand Est;57;5;23;436;Malaucourt-sur-Seille;123;4;127
44;Grand Est;57;7;04;437;Malling;630;14;644
44;Grand Est;57;9;16;438;Malroy;355;4;359
44;Grand Est;57;7;04;439;Manderen-Ritzing;586;13;599
44;Grand Est;57;5;23;440;Manhoué;142;3;145
44;Grand Est;57;7;27;441;Manom;2872;58;2930
44;Grand Est;57;3;07;442;Many;259;2;261
44;Grand Est;57;9;18;443;Marange-Silvange;6179;59;6238
44;Grand Est;57;3;07;444;Marange-Zondrange;341;2;343
44;Grand Est;57;9;05;445;Marieulles;703;8;711
44;Grand Est;57;5;23;446;Marimont-lès-Bénestroff;38;1;39
44;Grand Est;57;9;15;447;Marly;10104;238;10342
44;Grand Est;57;5;23;448;Marsal;282;3;285
44;Grand Est;57;9;16;449;Marsilly;579;6;585
44;Grand Est;57;5;23;451;Marthille;171;3;174
44;Grand Est;57;9;24;452;La Maxe;924;15;939
44;Grand Est;57;3;20;453;Maxstadt;316;11;327
44;Grand Est;57;9;16;454;Mécleuves;1156;23;1179
44;Grand Est;57;3;03;455;Mégange;160;1;161
44;Grand Est;57;6;02;456;Meisenthal;699;17;716
44;Grand Est;57;3;04;457;Menskirch;140;2;142
44;Grand Est;57;7;04;459;Merschweiller;248;1;249
44;Grand Est;57;3;04;460;Merten;1504;26;1530
44;Grand Est;57;5;17;461;Métairies-Saint-Quirin;266;4;270
44;Grand Est;57;5;17;462;Metting;399;7;406
44;Grand Est;57;9;98;463;Metz;116429;1824;118253
44;Grand Est;57;7;14;464;Metzeresche;949;21;970
44;Grand Est;57;7;14;465;Metzervisse;2271;53;2324
44;Grand Est;57;3;25;466;Metzing;645;11;656
44;Grand Est;57;9;16;467;Mey;267;5;272
44;Grand Est;57;5;17;468;Mittelbronn;688;10;698
44;Grand Est;57;5;21;469;Mittersheim;596;5;601
44;Grand Est;57;5;23;470;Molring;5;0;5
44;Grand Est;57;3;03;471;Momerstroff;285;3;288
44;Grand Est;57;9;23;472;Moncheux;149;2;151
44;Grand Est;57;5;23;473;Moncourt;70;2;72
44;Grand Est;57;7;06;474;Mondelange;5665;73;5738
44;Grand Est;57;7;27;475;Mondorff;518;14;532
44;Grand Est;57;7;14;476;Monneren;420;6;426
44;Grand Est;57;6;02;477;Montbronn;1630;46;1676
44;Grand Est;57;5;23;478;Montdidier;80;0;80
44;Grand Est;57;7;04;479;Montenach;458;12;470
44;Grand Est;57;9;15;480;Montigny-lès-Metz;21819;374;22193
44;Grand Est;57;9;18;481;Montois-la-Montagne;2710;19;2729
44;Grand Est;57;3;20;483;Morhange;3445;82;3527
44;Grand Est;57;3;08;484;Morsbach;2686;29;2715
44;Grand Est;57;5;23;485;Morville-lès-Vic;123;1;124
44;Grand Est;57;5;23;486;Morville-sur-Nied;119;1;120
44;Grand Est;57;9;05;487;Moulins-lès-Metz;5055;62;5117
44;Grand Est;57;5;21;488;Moussey;561;8;569
44;Grand Est;57;6;02;489;Mouterhouse;308;6;314
44;Grand Est;57;5;23;490;Moyenvic;364;4;368
44;Grand Est;57;7;10;491;Moyeuvre-Grande;7823;71;7894
44;Grand Est;57;7;10;492;Moyeuvre-Petite;462;2;464
44;Grand Est;57;5;23;493;Mulcey;211;1;212
44;Grand Est;57;5;23;494;Munster;249;0;249
44;Grand Est;57;3;03;495;Narbéfontaine;118;1;119
44;Grand Est;57;5;23;496;Nébing;345;5;350
44;Grand Est;57;6;20;497;Nelling;263;9;272
44;Grand Est;57;7;01;498;Neufchef;2580;53;2633
44;Grand Est;57;6;22;499;Neufgrange;1389;31;1420
44;Grand Est;57;5;17;500;Neufmoulins;43;0;43
44;Grand Est;57;5;23;501;Neufvillage;36;0;36
44;Grand Est;57;3;04;502;Neunkirchen-lès-Bouzonville;339;12;351
44;Grand Est;57;5;17;504;Niderhoff;285;2;287
44;Grand Est;57;5;17;505;Niderviller;1218;22;1240
44;Grand Est;57;5;21;506;Niederstinzel;257;1;258
44;Grand Est;57;3;03;507;Niedervisse;257;3;260
44;Grand Est;57;7;01;508;Nilvange;4725;42;4767
44;Grand Est;57;5;17;509;Nitting;464;3;467
44;Grand Est;57;9;16;510;Noisseville;1031;11;1042
44;Grand Est;57;9;18;511;Norroy-le-Veneur;1002;23;1025
44;Grand Est;57;9;16;512;Nouilly;723;7;730
44;Grand Est;57;6;02;513;Nousseviller-lès-Bitche;141;1;142
44;Grand Est;57;3;25;514;Nousseviller-Saint-Nabor;1210;31;1241
44;Grand Est;57;9;05;515;Novéant-sur-Moselle;1797;26;1823
44;Grand Est;57;3;04;516;Oberdorff;343;10;353
44;Grand Est;57;6;02;517;Obergailbach;304;3;307
44;Grand Est;57;5;21;518;Oberstinzel;340;9;349
44;Grand Est;57;3;03;519;Obervisse;159;3;162
44;Grand Est;57;5;23;520;Obreck;36;2;38
44;Grand Est;57;9;16;482;Ogy-Montoy-Flanville;1724;34;1758
44;Grand Est;57;5;23;524;Ommeray;127;2;129
44;Grand Est;57;5;23;525;Oriocourt;57;1;58
44;Grand Est;57;6;02;526;Ormersviller;390;2;392
44;Grand Est;57;9;07;527;Orny;358;4;362
44;Grand Est;57;5;23;528;Oron;94;1;95
44;Grand Est;57;7;01;529;Ottange;3043;65;3108
44;Grand Est;57;3;03;530;Ottonville;445;6;451
44;Grand Est;57;7;14;531;Oudrenne;740;14;754
44;Grand Est;57;9;07;532;Pagny-lès-Goin;238;4;242
44;Grand Est;57;9;16;533;Pange;871;22;893
44;Grand Est;57;9;16;534;Peltre;1856;120;1976
44;Grand Est;57;6;02;535;Petit-Réderching;1488;37;1525
44;Grand Est;57;3;20;536;Petit-Tenquin;229;5;234
44;Grand Est;57;3;08;537;Petite-Rosselle;6338;94;6432
44;Grand Est;57;5;23;538;Pettoncourt;291;2;293
44;Grand Est;57;5;23;539;Pévange;51;3;54
44;Grand Est;57;5;17;540;Phalsbourg;4728;258;4986
44;Grand Est;57;6;02;541;Philippsbourg;611;14;625
44;Grand Est;57;3;03;542;Piblange;1011;11;1022
44;Grand Est;57;9;18;543;Pierrevillers;1509;24;1533
44;Grand Est;57;5;17;544;Plaine-de-Walsch;630;16;646
44;Grand Est;57;9;15;545;Plappeville;1998;74;2072
44;Grand Est;57;9;18;546;Plesnois;826;29;855
44;Grand Est;57;9;07;547;Pommérieux;695;9;704
44;Grand Est;57;9;07;548;Pontoy;466;2;468
44;Grand Est;57;3;07;549;Pontpierre;724;14;738
44;Grand Est;57;3;19;550;Porcelette;2485;66;2551
44;Grand Est;57;5;21;551;Postroff;211;0;211
44;Grand Est;57;9;05;552;Pouilly;614;8;622
44;Grand Est;57;9;05;553;Pournoy-la-Chétive;637;6;643
44;Grand Est;57;9;07;554;Pournoy-la-Grasse;629;19;648
44;Grand Est;57;5;23;555;Prévocourt;110;0;110
44;Grand Est;57;6;20;556;Puttelange-aux-Lacs;3025;45;3070
44;Grand Est;57;7;27;557;Puttelange-lès-Thionville;974;23;997
44;Grand Est;57;5;23;558;Puttigny;85;0;85
44;Grand Est;57;5;23;559;Puzieux;187;5;192
44;Grand Est;57;3;20;560;Racrange;605;12;617
44;Grand Est;57;6;02;561;Rahling;766;20;786
44;Grand Est;57;7;10;562;Ranguevaux;832;18;850
44;Grand Est;57;9;16;563;Raville;268;2;270
44;Grand Est;57;5;21;564;Réchicourt-le-Château;541;8;549
44;Grand Est;57;7;01;565;Rédange;994;13;1007
44;Grand Est;57;5;21;566;Réding;2384;66;2450
44;Grand Est;57;3;04;567;Rémelfang;165;1;166
44;Grand Est;57;6;22;568;Rémelfing;1405;29;1434
44;Grand Est;57;7;04;569;Rémeling;308;6;314
44;Grand Est;57;3;04;570;Rémering;436;10;446
44;Grand Est;57;6;20;571;Rémering-lès-Puttelange;1087;30;1117
44;Grand Est;57;9;07;572;Rémilly;2016;103;2119
44;Grand Est;57;5;23;573;Réning;133;3;136
44;Grand Est;57;9;16;575;Retonfey;1384;15;1399
44;Grand Est;57;7;04;576;Rettel;764;65;829
44;Grand Est;57;6;02;577;Reyersviller;367;8;375
44;Grand Est;57;9;05;578;Rezonville-Vionville;503;6;509
44;Grand Est;57;5;21;579;Rhodes;122;1;123
44;Grand Est;57;5;23;580;Riche;188;3;191
44;Grand Est;57;6;20;581;Richeling;337;9;346
44;Grand Est;57;7;06;582;Richemont;2075;40;2115
44;Grand Est;57;5;21;583;Richeval;133;2;135
44;Grand Est;57;6;02;584;Rimling;650;16;666
44;Grand Est;57;7;01;586;Rochonvillers;188;2;190
44;Grand Est;57;5;23;587;Rodalbe;253;5;258
44;Grand Est;57;7;27;588;Rodemack;1240;31;1271
44;Grand Est;57;6;02;589;Rohrbach-lès-Bitche;2283;49;2332
44;Grand Est;57;6;02;590;Rolbing;249;5;254
44;Grand Est;57;9;18;591;Rombas;9882;111;9993
44;Grand Est;57;5;21;592;Romelfing;356;2;358
44;Grand Est;57;9;18;593;Roncourt;1003;10;1013
44;Grand Est;57;6;02;594;Roppeviller;105;3;108
44;Grand Est;57;5;23;595;Rorbach-lès-Dieuze;51;1;52
44;Grand Est;57;3;08;596;Rosbruck;764;11;775
44;Grand Est;57;7;10;597;Rosselange;2693;18;2711
44;Grand Est;57;6;22;598;Rouhling;2060;53;2113
44;Grand Est;57;3;03;599;Roupeldange;369;9;378
44;Grand Est;57;7;27;600;Roussy-le-Village;1369;24;1393
44;Grand Est;57;9;05;601;Rozérieulles;1383;43;1426
44;Grand Est;57;7;14;602;Rurange-lès-Thionville;2494;46;2540
44;Grand Est;57;7;01;603;Russange;1285;17;1302
44;Grand Est;57;7;04;604;Rustroff;612;5;617
44;Grand Est;57;9;23;605;Sailly-Achâtel;292;5;297
44;Grand Est;57;3;19;606;Saint-Avold;15483;377;15860
44;Grand Est;57;5;23;609;Saint-Epvre;177;0;177
44;Grand Est;57;3;04;610;Saint-François-Lacroix;302;6;308
44;Grand Est;57;5;21;611;Saint-Georges;198;5;203
44;Grand Est;57;9;16;612;Saint-Hubert;233;5;238
44;Grand Est;57;5;21;613;Saint-Jean-de-Bassel;350;3;353
44;Grand Est;57;5;17;614;Saint-Jean-Kourtzerode;714;4;718
44;Grand Est;57;6;20;615;Saint-Jean-Rohrbach;966;12;978
44;Grand Est;57;9;16;616;Saint-Julien-lès-Metz;3421;83;3504
44;Grand Est;57;9;23;617;Saint-Jure;295;6;301
44;Grand Est;57;5;17;618;Saint-Louis;665;20;685
44;Grand Est;57;6;02;619;Saint-Louis-lès-Bitche;490;10;500
44;Grand Est;57;5;23;621;Saint-Médard;100;1;101
44;Grand Est;57;9;18;622;Saint-Privat-la-Montagne;1839;18;1857
44;Grand Est;57;5;17;623;Saint-Quirin;722;45;767
44;Grand Est;57;9;16;607;Sainte-Barbe;745;10;755
44;Grand Est;57;9;18;620;Sainte-Marie-aux-Chênes;4216;59;4275
44;Grand Est;57;9;05;624;Sainte-Ruffine;563;28;591
44;Grand Est;57;5;23;625;Salonnes;189;2;191
44;Grand Est;57;9;16;626;Sanry-lès-Vigy;528;8;536
44;Grand Est;57;9;16;627;Sanry-sur-Nied;291;3;294
44;Grand Est;57;6;20;628;Sarralbe;4555;103;4658
44;Grand Est;57;5;21;629;Sarraltroff;748;8;756
44;Grand Est;57;5;21;630;Sarrebourg;12045;306;12351
44;Grand Est;57;6;22;631;Sarreguemines;20783;449;21232
44;Grand Est;57;6;22;633;Sarreinsming;1268;30;1298
44;Grand Est;57;9;18;634;Saulny;1428;35;1463
44;Grand Est;57;5;21;635;Schalbach;343;7;350
44;Grand Est;57;6;02;636;Schmittviller;322;12;334
44;Grand Est;57;5;17;637;Schneckenbusch;303;9;312
44;Grand Est;57;6;02;639;Schorbach;540;9;549
44;Grand Est;57;3;04;640;Schwerdorff;473;14;487
44;Grand Est;57;6;02;641;Schweyen;315;4;319
44;Grand Est;57;3;08;638;Schœneck;2570;41;2611
44;Grand Est;57;9;15;642;Scy-Chazelles;2676;49;2725
44;Grand Est;57;9;23;643;Secourt;196;5;201
44;Grand Est;57;3;09;644;Seingbouse;1822;43;1865
44;Grand Est;57;9;24;645;Semécourt;995;9;1004
44;Grand Est;57;7;10;647;Serémange-Erzange;4273;55;4328
44;Grand Est;57;9;16;648;Servigny-lès-Raville;484;4;488
44;Grand Est;57;9;16;649;Servigny-lès-Sainte-Barbe;466;4;470
44;Grand Est;57;7;04;650;Sierck-les-Bains;1755;14;1769
44;Grand Est;57;6;02;651;Siersthal;665;11;676
44;Grand Est;57;9;07;652;Sillegny;478;5;483
44;Grand Est;57;9;07;653;Silly-en-Saulnois;33;1;34
44;Grand Est;57;9;16;654;Silly-sur-Nied;693;12;705
44;Grand Est;57;9;07;655;Solgne;1109;64;1173
44;Grand Est;57;9;16;656;Sorbey;372;6;378
44;Grand Est;57;5;23;657;Sotzeling;20;0;20
44;Grand Est;57;6;02;658;Soucht;1049;18;1067
44;Grand Est;57;3;25;659;Spicheren;3224;57;3281
44;Grand Est;57;3;25;660;Stiring-Wendel;11618;124;11742
44;Grand Est;57;7;14;767;Stuckange;1073;27;1100
44;Grand Est;57;6;02;661;Sturzelbronn;176;3;179
44;Grand Est;57;3;20;662;Suisse;103;5;108
44;Grand Est;57;9;24;663;Talange;7707;172;7879
44;Grand Est;57;5;23;664;Tarquimpol;62;1;63
44;Grand Est;57;3;25;665;Tenteling;1077;39;1116
44;Grand Est;57;7;26;666;Terville;7025;91;7116
44;Grand Est;57;3;03;667;Téterchen;819;7;826
44;Grand Est;57;3;07;668;Teting-sur-Nied;1305;35;1340
44;Grand Est;57;3;25;669;Théding;2501;46;2547
44;Grand Est;57;3;07;670;Thicourt;142;2;144
44;Grand Est;57;9;07;671;Thimonville;155;0;155
44;Grand Est;57;7;99;672;Thionville;40701;787;41488
44;Grand Est;57;3;07;673;Thonville;47;0;47
44;Grand Est;57;5;23;674;Tincry;174;5;179
44;Grand Est;57;5;23;675;Torcheville;110;1;111
44;Grand Est;57;9;07;676;Tragny;97;2;99
44;Grand Est;57;9;16;677;Trémery;1063;19;1082
44;Grand Est;57;7;01;678;Tressange;2132;31;2163
44;Grand Est;57;3;07;679;Tritteling-Redlach;533;4;537
44;Grand Est;57;5;17;680;Troisfontaines;1272;27;1299
44;Grand Est;57;3;04;681;Tromborn;357;5;362
44;Grand Est;57;5;17;682;Turquestein-Blancrupt;14;0;14
44;Grand Est;57;7;06;683;Uckange;6818;45;6863
44;Grand Est;57;3;20;684;Vahl-Ebersing;514;10;524
44;Grand Est;57;5;23;685;Vahl-lès-Bénestroff;148;2;150
44;Grand Est;57;3;07;686;Vahl-lès-Faulquemont;256;4;260
44;Grand Est;57;5;23;270;Val-de-Bride;588;12;600
44;Grand Est;57;6;20;267;Le Val-de-Guéblange;856;19;875
44;Grand Est;57;3;20;687;Vallerange;209;4;213
44;Grand Est;57;7;14;689;Valmestroff;308;5;313
44;Grand Est;57;3;19;690;Valmont;3131;70;3201
44;Grand Est;57;3;03;691;Valmunster;94;4;98
44;Grand Est;57;5;23;692;Vannecourt;79;0;79
44;Grand Est;57;9;16;693;Vantoux;851;19;870
44;Grand Est;57;9;16;694;Vany;410;6;416
44;Grand Est;57;3;03;695;Varize-Vaudoncourt;552;9;561
44;Grand Est;57;3;03;696;Varsberg;951;26;977
44;Grand Est;57;5;17;697;Vasperviller;316;9;325
44;Grand Est;57;3;07;698;Vatimont;324;0;324
44;Grand Est;57;3;04;700;Vaudreching;532;8;540
44;Grand Est;57;9;05;701;Vaux;798;24;822
44;Grand Est;57;5;23;702;Vaxy;166;0;166
44;Grand Est;57;5;21;703;Veckersviller;231;5;236
44;Grand Est;57;7;14;704;Veckring;670;15;685
44;Grand Est;57;3;03;705;Velving;205;5;210
44;Grand Est;57;5;23;706;Vergaville;578;15;593
44;Grand Est;57;9;05;707;Vernéville;616;8;624
44;Grand Est;57;9;07;708;Verny;1950;90;2040
44;Grand Est;57;5;17;709;Vescheim;321;7;328
44;Grand Est;57;5;23;711;Vibersviller;454;7;461
44;Grand Est;57;5;23;712;Vic-sur-Seille;1295;105;1400
44;Grand Est;57;5;21;713;Vieux-Lixheim;256;8;264
44;Grand Est;57;9;23;715;Vigny;366;3;369
44;Grand Est;57;9;16;716;Vigy;1716;33;1749
44;Grand Est;57;3;20;717;Viller;201;4;205
44;Grand Est;57;9;07;718;Villers-Stoncourt;222;3;225
44;Grand Est;57;5;23;719;Villers-sur-Nied;73;1;74
44;Grand Est;57;3;04;720;Villing;494;11;505
44;Grand Est;57;5;17;721;Vilsberg;357;11;368
44;Grand Est;57;5;23;723;Virming;296;6;302
44;Grand Est;57;7;10;724;Vitry-sur-Orne;3019;34;3053
44;Grand Est;57;5;23;725;Vittersbourg;358;7;365
44;Grand Est;57;3;07;726;Vittoncourt;375;3;378
44;Grand Est;57;5;23;727;Viviers;123;1;124
44;Grand Est;57;3;07;728;Voimhaut;253;3;256
44;Grand Est;57;3;03;730;Volmerange-lès-Boulay;559;11;570
44;Grand Est;57;7;27;731;Volmerange-les-Mines;2189;48;2237
44;Grand Est;57;6;02;732;Volmunster;793;21;814
44;Grand Est;57;7;14;733;Volstroff;1965;28;1993
44;Grand Est;57;5;17;734;Voyer;452;11;463
44;Grand Est;57;9;16;736;Vry;595;9;604
44;Grand Est;57;9;23;737;Vulmont;30;1;31
44;Grand Est;57;3;04;749;Vœlfling-lès-Bouzonville;155;6;161
44;Grand Est;57;6;02;738;Waldhouse;401;6;407
44;Grand Est;57;7;04;739;Waldweistroff;494;2;496
44;Grand Est;57;7;04;740;Waldwisse;824;12;836
44;Grand Est;57;6;02;741;Walschbronn;497;16;513
44;Grand Est;57;5;17;742;Walscheid;1536;42;1578
44;Grand Est;57;5;17;743;Waltembourg;243;7;250
44;Grand Est;57;6;22;745;Wiesviller;968;21;989
44;Grand Est;57;6;22;746;Willerwald;1544;36;1580
44;Grand Est;57;5;17;747;Wintersbourg;265;7;272
44;Grand Est;57;6;22;748;Wittring;790;15;805
44;Grand Est;57;9;24;751;Woippy;14214;139;14353
44;Grand Est;57;6;20;752;Woustviller;3175;59;3234
44;Grand Est;57;5;23;753;Wuisse;63;4;67
44;Grand Est;57;6;22;750;Wœlfling-lès-Sarreguemines;739;26;765
44;Grand Est;57;5;23;754;Xanrey;116;0;116
44;Grand Est;57;5;23;755;Xocourt;93;1;94
44;Grand Est;57;5;17;756;Xouaxange;305;4;309
44;Grand Est;57;7;27;757;Yutz;16537;254;16791
44;Grand Est;57;5;23;759;Zarbeling;58;2;60
44;Grand Est;57;6;22;760;Zetting;825;24;849
44;Grand Est;57;5;17;761;Zilling;274;4;278
44;Grand Est;57;3;07;762;Zimming;712;6;718
44;Grand Est;57;5;23;763;Zommange;44;2;46
44;Grand Est;57;7;27;764;Zoufftgen;1222;14;1236
44;Grand Est;57;3;08;521;Œting;2679;52;2731
27;Bourgogne-Franche-Comté;58;1;02;001;Achun;162;3;165
27;Bourgogne-Franche-Comté;58;4;05;002;Alligny-Cosne;877;18;895
27;Bourgogne-Franche-Comté;58;1;02;003;Alligny-en-Morvan;613;7;620
27;Bourgogne-Franche-Comté;58;1;02;004;Alluy;386;8;394
27;Bourgogne-Franche-Comté;58;2;03;005;Amazy;228;1;229
27;Bourgogne-Franche-Comté;58;3;08;006;Anlezy;246;5;251
27;Bourgogne-Franche-Comté;58;4;15;007;Annay;339;5;344
27;Bourgogne-Franche-Comté;58;2;04;008;Anthien;177;5;182
27;Bourgogne-Franche-Comté;58;4;01;009;Arbourse;127;1;128
27;Bourgogne-Franche-Comté;58;1;02;010;Arleuf;746;11;757
27;Bourgogne-Franche-Comté;58;2;03;011;Armes;283;6;289
27;Bourgogne-Franche-Comté;58;4;15;012;Arquian;581;13;594
27;Bourgogne-Franche-Comté;58;4;01;013;Arthel;95;1;96
27;Bourgogne-Franche-Comté;58;4;01;014;Arzembouy;68;1;69
27;Bourgogne-Franche-Comté;58;2;04;015;Asnan;125;2;127
27;Bourgogne-Franche-Comté;58;2;03;016;Asnois;146;3;149
27;Bourgogne-Franche-Comté;58;1;02;017;Aunay-en-Bazois;228;5;233
27;Bourgogne-Franche-Comté;58;2;04;018;Authiou;44;0;44
27;Bourgogne-Franche-Comté;58;1;10;019;Avrée;80;1;81
27;Bourgogne-Franche-Comté;58;3;16;020;Avril-sur-Loire;268;4;272
27;Bourgogne-Franche-Comté;58;3;16;021;Azy-le-Vif;206;6;212
27;Bourgogne-Franche-Comté;58;1;04;023;Bazoches;177;3;180
27;Bourgogne-Franche-Comté;58;3;08;024;Bazolles;279;6;285
27;Bourgogne-Franche-Comté;58;3;09;025;Béard;172;8;180
27;Bourgogne-Franche-Comté;58;2;04;026;Beaulieu;159;10;169
27;Bourgogne-Franche-Comté;58;4;01;027;Beaumont-la-Ferrière;123;3;126
27;Bourgogne-Franche-Comté;58;3;08;028;Beaumont-Sardolles;115;4;119
27;Bourgogne-Franche-Comté;58;2;04;029;Beuvron;79;0;79
27;Bourgogne-Franche-Comté;58;1;02;030;Biches;287;11;298
27;Bourgogne-Franche-Comté;58;3;08;031;Billy-Chevannes;308;4;312
27;Bourgogne-Franche-Comté;58;2;03;032;Billy-sur-Oisy;370;8;378
27;Bourgogne-Franche-Comté;58;4;15;033;Bitry;305;8;313
27;Bourgogne-Franche-Comté;58;1;02;034;Blismes;180;6;186
27;Bourgogne-Franche-Comté;58;3;08;035;Bona;313;2;315
27;Bourgogne-Franche-Comté;58;4;15;036;Bouhy;460;8;468
27;Bourgogne-Franche-Comté;58;1;04;037;Brassy;611;36;647
27;Bourgogne-Franche-Comté;58;2;03;038;Breugnon;169;5;174
27;Bourgogne-Franche-Comté;58;2;03;039;Brèves;243;2;245
27;Bourgogne-Franche-Comté;58;1;02;040;Brinay;144;4;148
27;Bourgogne-Franche-Comté;58;2;04;041;Brinon-sur-Beuvron;181;5;186
27;Bourgogne-Franche-Comté;58;4;15;042;Bulcy;129;5;134
27;Bourgogne-Franche-Comté;58;2;04;043;Bussy-la-Pesle;56;0;56
27;Bourgogne-Franche-Comté;58;4;05;044;La Celle-sur-Loire;830;11;841
27;Bourgogne-Franche-Comté;58;4;01;045;La Celle-sur-Nièvre;160;0;160
27;Bourgogne-Franche-Comté;58;1;10;046;Cercy-la-Tour;1746;26;1772
27;Bourgogne-Franche-Comté;58;2;04;047;Cervon;650;14;664
27;Bourgogne-Franche-Comté;58;4;15;048;Cessy-les-Bois;94;3;97
27;Bourgogne-Franche-Comté;58;1;04;049;Chalaux;86;2;88
27;Bourgogne-Franche-Comté;58;2;04;050;Challement;51;2;53
27;Bourgogne-Franche-Comté;58;3;13;051;Challuy;1537;133;1670
27;Bourgogne-Franche-Comté;58;2;04;052;Champallement;49;3;52
27;Bourgogne-Franche-Comté;58;4;01;053;Champlemy;332;7;339
27;Bourgogne-Franche-Comté;58;2;01;054;Champlin;39;1;40
27;Bourgogne-Franche-Comté;58;3;06;055;Champvert;797;17;814
27;Bourgogne-Franche-Comté;58;4;01;056;Champvoux;309;9;318
27;Bourgogne-Franche-Comté;58;3;16;057;Chantenay-Saint-Imbert;1172;20;1192
27;Bourgogne-Franche-Comté;58;2;03;058;La Chapelle-Saint-André;315;5;320
27;Bourgogne-Franche-Comté;58;4;01;059;La Charité-sur-Loire;4901;71;4972
27;Bourgogne-Franche-Comté;58;1;10;060;Charrin;609;9;618
27;Bourgogne-Franche-Comté;58;4;01;061;Chasnay;116;3;119
27;Bourgogne-Franche-Comté;58;1;02;063;Château-Chinon (Campagne);548;10;558
27;Bourgogne-Franche-Comté;58;1;02;062;Château-Chinon (Ville);1964;390;2354
27;Bourgogne-Franche-Comté;58;4;15;064;Châteauneuf-Val-de-Bargis;530;14;544
27;Bourgogne-Franche-Comté;58;1;02;065;Châtillon-en-Bazois;897;17;914
27;Bourgogne-Franche-Comté;58;1;02;066;Châtin;88;0;88
27;Bourgogne-Franche-Comté;58;4;01;067;Chaulgnes;1505;23;1528
27;Bourgogne-Franche-Comté;58;1;02;068;Chaumard;208;5;213
27;Bourgogne-Franche-Comté;58;2;04;069;Chaumot;158;3;161
27;Bourgogne-Franche-Comté;58;2;04;070;Chazeuil;59;2;61
27;Bourgogne-Franche-Comté;58;2;04;071;Chevannes-Changy;132;6;138
27;Bourgogne-Franche-Comté;58;3;16;072;Chevenon;590;11;601
27;Bourgogne-Franche-Comté;58;2;03;073;Chevroches;125;5;130
27;Bourgogne-Franche-Comté;58;1;10;074;Chiddes;334;5;339
27;Bourgogne-Franche-Comté;58;2;04;075;Chitry-les-Mines;208;4;212
27;Bourgogne-Franche-Comté;58;1;02;076;Chougny;76;1;77
27;Bourgogne-Franche-Comté;58;4;15;077;Ciez;369;6;375
27;Bourgogne-Franche-Comté;58;3;08;078;Cizely;61;0;61
27;Bourgogne-Franche-Comté;58;2;03;079;Clamecy;3759;161;3920
27;Bourgogne-Franche-Comté;58;2;04;080;La Collancelle;175;1;176
27;Bourgogne-Franche-Comté;58;4;15;081;Colméry;321;6;327
27;Bourgogne-Franche-Comté;58;1;02;082;Corancy;301;4;305
27;Bourgogne-Franche-Comté;58;2;04;083;Corbigny;1482;108;1590
27;Bourgogne-Franche-Comté;58;2;04;084;Corvol-d'Embernard;87;3;90
27;Bourgogne-Franche-Comté;58;2;03;085;Corvol-l'Orgueilleux;800;8;808
27;Bourgogne-Franche-Comté;58;4;05;086;Cosne-Cours-sur-Loire;9874;257;10131
27;Bourgogne-Franche-Comté;58;3;06;087;Cossaye;718;8;726
27;Bourgogne-Franche-Comté;58;3;11;088;Coulanges-lès-Nevers;3629;84;3713
27;Bourgogne-Franche-Comté;58;4;15;089;Couloutre;191;7;198
27;Bourgogne-Franche-Comté;58;2;03;090;Courcelles;217;3;220
27;Bourgogne-Franche-Comté;58;3;08;092;Crux-la-Ville;405;9;414
27;Bourgogne-Franche-Comté;58;2;03;093;Cuncy-lès-Varzy;127;2;129
27;Bourgogne-Franche-Comté;58;4;15;094;Dampierre-sous-Bouhy;457;7;464
27;Bourgogne-Franche-Comté;58;3;06;095;Decize;5393;190;5583
27;Bourgogne-Franche-Comté;58;3;06;096;Devay;493;9;502
27;Bourgogne-Franche-Comté;58;3;08;097;Diennes-Aubigny;94;1;95
27;Bourgogne-Franche-Comté;58;2;03;098;Dirol;116;4;120
27;Bourgogne-Franche-Comté;58;1;02;099;Dommartin;170;4;174
27;Bourgogne-Franche-Comté;58;4;01;101;Dompierre-sur-Nièvre;191;2;193
27;Bourgogne-Franche-Comté;58;4;15;102;Donzy;1583;27;1610
27;Bourgogne-Franche-Comté;58;2;03;103;Dornecy;481;8;489
27;Bourgogne-Franche-Comté;58;3;16;104;Dornes;1430;26;1456
27;Bourgogne-Franche-Comté;58;3;09;105;Druy-Parigny;320;6;326
27;Bourgogne-Franche-Comté;58;1;04;106;Dun-les-Places;351;4;355
27;Bourgogne-Franche-Comté;58;1;02;107;Dun-sur-Grandry;156;2;158
27;Bourgogne-Franche-Comté;58;1;04;108;Empury;83;1;84
27;Bourgogne-Franche-Comté;58;2;03;109;Entrains-sur-Nohain;769;16;785
27;Bourgogne-Franche-Comté;58;2;04;110;Epiry;238;2;240
27;Bourgogne-Franche-Comté;58;1;02;111;Fâchin;110;1;111
27;Bourgogne-Franche-Comté;58;3;08;112;La Fermeté;655;7;662
27;Bourgogne-Franche-Comté;58;3;08;113;Fertrève;101;3;104
27;Bourgogne-Franche-Comté;58;1;10;114;Fléty;103;6;109
27;Bourgogne-Franche-Comté;58;3;16;115;Fleury-sur-Loire;229;5;234
27;Bourgogne-Franche-Comté;58;2;03;116;Flez-Cuzy;134;2;136
27;Bourgogne-Franche-Comté;58;3;07;117;Fourchambault;4229;58;4287
27;Bourgogne-Franche-Comté;58;1;10;118;Fours;645;7;652
27;Bourgogne-Franche-Comté;58;3;08;119;Frasnay-Reugny;88;4;92
27;Bourgogne-Franche-Comté;58;2;04;120;Gâcogne;245;0;245
27;Bourgogne-Franche-Comté;58;3;07;121;Garchizy;3726;45;3771
27;Bourgogne-Franche-Comté;58;4;15;122;Garchy;427;8;435
27;Bourgogne-Franche-Comté;58;2;04;123;Germenay;145;4;149
27;Bourgogne-Franche-Comté;58;3;07;124;Germigny-sur-Loire;769;9;778
27;Bourgogne-Franche-Comté;58;1;02;125;Gien-sur-Cure;96;2;98
27;Bourgogne-Franche-Comté;58;3;13;126;Gimouille;459;7;466
27;Bourgogne-Franche-Comté;58;4;01;127;Giry;195;2;197
27;Bourgogne-Franche-Comté;58;1;02;128;Glux-en-Glenne;93;0;93
27;Bourgogne-Franche-Comté;58;1;02;129;Gouloux;181;6;187
27;Bourgogne-Franche-Comté;58;2;04;130;Grenois;97;2;99
27;Bourgogne-Franche-Comté;58;3;08;131;Guérigny;2514;40;2554
27;Bourgogne-Franche-Comté;58;2;04;132;Guipy;240;22;262
27;Bourgogne-Franche-Comté;58;2;04;133;Héry;74;3;77
27;Bourgogne-Franche-Comté;58;3;09;134;Imphy;3345;43;3388
27;Bourgogne-Franche-Comté;58;1;10;135;Isenay;98;0;98
27;Bourgogne-Franche-Comté;58;3;08;136;Jailly;64;2;66
27;Bourgogne-Franche-Comté;58;3;06;137;Lamenay-sur-Loire;61;0;61
27;Bourgogne-Franche-Comté;58;3;16;138;Langeron;366;10;376
27;Bourgogne-Franche-Comté;58;1;10;139;Lanty;122;0;122
27;Bourgogne-Franche-Comté;58;1;10;140;Larochemillay;231;4;235
27;Bourgogne-Franche-Comté;58;1;02;141;Lavault-de-Frétoy;66;0;66
27;Bourgogne-Franche-Comté;58;1;02;142;Limanton;240;4;244
27;Bourgogne-Franche-Comté;58;3;08;143;Limon;148;5;153
27;Bourgogne-Franche-Comté;58;3;16;144;Livry;700;9;709
27;Bourgogne-Franche-Comté;58;1;04;145;Lormes;1288;29;1317
27;Bourgogne-Franche-Comté;58;3;06;146;Lucenay-lès-Aix;982;18;1000
27;Bourgogne-Franche-Comté;58;4;01;147;Lurcy-le-Bourg;287;5;292
27;Bourgogne-Franche-Comté;58;3;16;148;Luthenay-Uxeloup;625;13;638
27;Bourgogne-Franche-Comté;58;1;10;149;Luzy;1980;46;2026
27;Bourgogne-Franche-Comté;58;2;03;150;Lys;109;6;115
27;Bourgogne-Franche-Comté;58;3;09;151;La Machine;3343;52;3395
27;Bourgogne-Franche-Comté;58;3;12;152;Magny-Cours;1393;28;1421
27;Bourgogne-Franche-Comté;58;2;04;153;Magny-Lormes;74;2;76
27;Bourgogne-Franche-Comté;58;2;03;154;La Maison-Dieu;121;1;122
27;Bourgogne-Franche-Comté;58;4;01;155;La Marche;565;15;580
27;Bourgogne-Franche-Comté;58;2;03;156;Marcy;153;4;157
27;Bourgogne-Franche-Comté;58;1;04;157;Marigny-l'Église;293;17;310
27;Bourgogne-Franche-Comté;58;2;04;159;Marigny-sur-Yonne;206;7;213
27;Bourgogne-Franche-Comté;58;3;16;158;Mars-sur-Allier;303;7;310
27;Bourgogne-Franche-Comté;58;3;07;160;Marzy;3672;198;3870
27;Bourgogne-Franche-Comté;58;1;10;161;Maux;142;0;142
27;Bourgogne-Franche-Comté;58;4;15;162;Menestreau;113;1;114
27;Bourgogne-Franche-Comté;58;2;03;163;Menou;181;1;182
27;Bourgogne-Franche-Comté;58;4;15;164;Mesves-sur-Loire;690;33;723
27;Bourgogne-Franche-Comté;58;2;03;165;Metz-le-Comte;162;7;169
27;Bourgogne-Franche-Comté;58;2;04;166;Mhère;230;1;231
27;Bourgogne-Franche-Comté;58;1;10;168;Millay;446;6;452
27;Bourgogne-Franche-Comté;58;2;03;169;Moissy-Moulinot;18;3;21
27;Bourgogne-Franche-Comté;58;2;03;170;Monceaux-le-Comte;122;2;124
27;Bourgogne-Franche-Comté;58;1;02;175;Mont-et-Marré;163;1;164
27;Bourgogne-Franche-Comté;58;1;10;172;Montambert;123;2;125
27;Bourgogne-Franche-Comté;58;1;02;171;Montapas;288;2;290
27;Bourgogne-Franche-Comté;58;1;10;173;Montaron;161;2;163
27;Bourgogne-Franche-Comté;58;4;01;174;Montenoison;121;1;122
27;Bourgogne-Franche-Comté;58;3;08;176;Montigny-aux-Amognes;618;22;640
27;Bourgogne-Franche-Comté;58;1;02;177;Montigny-en-Morvan;290;1;291
27;Bourgogne-Franche-Comté;58;1;10;178;Montigny-sur-Canne;152;3;155
27;Bourgogne-Franche-Comté;58;2;02;179;Montreuillon;261;7;268
27;Bourgogne-Franche-Comté;58;1;02;180;Montsauche-les-Settons;522;3;525
27;Bourgogne-Franche-Comté;58;2;04;181;Moraches;142;5;147
27;Bourgogne-Franche-Comté;58;1;10;182;Moulins-Engilbert;1445;23;1468
27;Bourgogne-Franche-Comté;58;2;04;183;Mouron-sur-Yonne;96;1;97
27;Bourgogne-Franche-Comté;58;4;01;184;Moussy;106;0;106
27;Bourgogne-Franche-Comté;58;1;02;185;Moux-en-Morvan;538;4;542
27;Bourgogne-Franche-Comté;58;4;01;186;Murlin;92;2;94
27;Bourgogne-Franche-Comté;58;4;05;187;Myennes;532;6;538
27;Bourgogne-Franche-Comté;58;4;01;188;Nannay;117;3;120
27;Bourgogne-Franche-Comté;58;4;01;189;Narcy;513;4;517
27;Bourgogne-Franche-Comté;58;2;03;190;Neuffontaines;104;3;107
27;Bourgogne-Franche-Comté;58;2;04;191;Neuilly;118;2;120
27;Bourgogne-Franche-Comté;58;3;16;192;Neuville-lès-Decize;230;9;239
27;Bourgogne-Franche-Comté;58;4;15;193;Neuvy-sur-Loire;1438;30;1468
27;Bourgogne-Franche-Comté;58;3;99;194;Nevers;32990;1107;34097
27;Bourgogne-Franche-Comté;58;1;10;195;La Nocle-Maulaix;279;2;281
27;Bourgogne-Franche-Comté;58;3;08;196;Nolay;357;3;360
27;Bourgogne-Franche-Comté;58;2;03;197;Nuars;156;1;157
27;Bourgogne-Franche-Comté;58;2;03;198;Oisy;305;5;310
27;Bourgogne-Franche-Comté;58;1;02;199;Onlay;148;3;151
27;Bourgogne-Franche-Comté;58;2;03;200;Ouagne;153;1;154
27;Bourgogne-Franche-Comté;58;2;03;201;Oudan;144;3;147
27;Bourgogne-Franche-Comté;58;1;02;202;Ougny;25;0;25
27;Bourgogne-Franche-Comté;58;4;01;203;Oulon;64;2;66
27;Bourgogne-Franche-Comté;58;1;02;205;Ouroux-en-Morvan;617;8;625
27;Bourgogne-Franche-Comté;58;2;03;206;Parigny-la-Rose;41;0;41
27;Bourgogne-Franche-Comté;58;3;17;207;Parigny-les-Vaux;960;36;996
27;Bourgogne-Franche-Comté;58;2;04;208;Pazy;305;10;315
27;Bourgogne-Franche-Comté;58;4;15;209;Perroy;160;4;164
27;Bourgogne-Franche-Comté;58;1;02;210;Planchez;301;4;305
27;Bourgogne-Franche-Comté;58;1;10;211;Poil;138;2;140
27;Bourgogne-Franche-Comté;58;3;08;212;Poiseux;334;4;338
27;Bourgogne-Franche-Comté;58;4;05;213;Pougny;462;14;476
27;Bourgogne-Franche-Comté;58;3;17;214;Pougues-les-Eaux;2388;53;2441
27;Bourgogne-Franche-Comté;58;4;15;215;Pouilly-sur-Loire;1636;25;1661
27;Bourgogne-Franche-Comté;58;2;04;216;Pouques-Lormes;160;3;163
27;Bourgogne-Franche-Comté;58;2;03;217;Pousseaux;194;8;202
27;Bourgogne-Franche-Comté;58;4;01;218;Prémery;1838;31;1869
27;Bourgogne-Franche-Comté;58;1;10;219;Préporché;206;4;210
27;Bourgogne-Franche-Comté;58;4;01;220;Raveau;673;12;685
27;Bourgogne-Franche-Comté;58;1;10;221;Rémilly;152;2;154
27;Bourgogne-Franche-Comté;58;2;03;222;Rix;159;1;160
27;Bourgogne-Franche-Comté;58;3;08;223;Rouy;613;8;621
27;Bourgogne-Franche-Comté;58;2;03;224;Ruages;93;4;97
27;Bourgogne-Franche-Comté;58;3;13;225;Saincaize-Meauce;376;7;383
27;Bourgogne-Franche-Comté;58;1;02;226;Saint-Agnan;137;2;139
27;Bourgogne-Franche-Comté;58;4;15;227;Saint-Amand-en-Puisaye;1258;26;1284
27;Bourgogne-Franche-Comté;58;4;15;228;Saint-Andelain;519;4;523
27;Bourgogne-Franche-Comté;58;1;04;229;Saint-André-en-Morvan;310;5;315
27;Bourgogne-Franche-Comté;58;2;03;230;Saint-Aubin-des-Chaumes;68;0;68
27;Bourgogne-Franche-Comté;58;4;01;231;Saint-Aubin-les-Forges;402;7;409
27;Bourgogne-Franche-Comté;58;3;08;232;Saint-Benin-d'Azy;1278;15;1293
27;Bourgogne-Franche-Comté;58;3;08;233;Saint-Benin-des-Bois;168;7;175
27;Bourgogne-Franche-Comté;58;4;01;234;Saint-Bonnot;138;1;139
27;Bourgogne-Franche-Comté;58;1;02;235;Saint-Brisson;264;3;267
27;Bourgogne-Franche-Comté;58;2;03;237;Saint-Didier;28;4;32
27;Bourgogne-Franche-Comté;58;3;12;238;Saint-Éloi;2146;45;2191
27;Bourgogne-Franche-Comté;58;3;08;239;Saint-Firmin;175;2;177
27;Bourgogne-Franche-Comté;58;3;08;240;Saint-Franchy;74;3;77
27;Bourgogne-Franche-Comté;58;3;06;241;Saint-Germain-Chassenay;323;5;328
27;Bourgogne-Franche-Comté;58;2;03;242;Saint-Germain-des-Bois;120;0;120
27;Bourgogne-Franche-Comté;58;1;10;243;Saint-Gratien-Savigny;113;4;117
27;Bourgogne-Franche-Comté;58;1;02;244;Saint-Hilaire-en-Morvan;220;7;227
27;Bourgogne-Franche-Comté;58;1;10;245;Saint-Hilaire-Fontaine;172;5;177
27;Bourgogne-Franche-Comté;58;1;10;246;Saint-Honoré-les-Bains;744;14;758
27;Bourgogne-Franche-Comté;58;3;08;247;Saint-Jean-aux-Amognes;492;7;499
27;Bourgogne-Franche-Comté;58;4;15;248;Saint-Laurent-l'Abbaye;215;4;219
27;Bourgogne-Franche-Comté;58;1;02;249;Saint-Léger-de-Fougeret;373;3;376
27;Bourgogne-Franche-Comté;58;3;06;250;Saint-Léger-des-Vignes;1886;46;1932
27;Bourgogne-Franche-Comté;58;4;05;251;Saint-Loup;468;7;475
27;Bourgogne-Franche-Comté;58;4;15;252;Saint-Malo-en-Donziois;128;3;131
27;Bourgogne-Franche-Comté;58;3;08;254;Saint-Martin-d'Heuille;596;13;609
27;Bourgogne-Franche-Comté;58;1;04;255;Saint-Martin-du-Puy;276;5;281
27;Bourgogne-Franche-Comté;58;4;15;256;Saint-Martin-sur-Nohain;371;18;389
27;Bourgogne-Franche-Comté;58;3;08;257;Saint-Maurice;62;0;62
27;Bourgogne-Franche-Comté;58;3;09;258;Saint-Ouen-sur-Loire;561;6;567
27;Bourgogne-Franche-Comté;58;3;16;259;Saint-Parize-en-Viry;150;3;153
27;Bourgogne-Franche-Comté;58;3;16;260;Saint-Parize-le-Châtel;1301;29;1330
27;Bourgogne-Franche-Comté;58;4;05;261;Saint-Père;1097;21;1118
27;Bourgogne-Franche-Comté;58;1;02;262;Saint-Péreuse;219;10;229
27;Bourgogne-Franche-Comté;58;2;03;263;Saint-Pierre-du-Mont;190;4;194
27;Bourgogne-Franche-Comté;58;3;16;264;Saint-Pierre-le-Moûtier;1956;21;1977
27;Bourgogne-Franche-Comté;58;4;15;265;Saint-Quentin-sur-Nohain;100;3;103
27;Bourgogne-Franche-Comté;58;2;04;266;Saint-Révérien;160;0;160
27;Bourgogne-Franche-Comté;58;3;08;267;Saint-Saulge;738;80;818
27;Bourgogne-Franche-Comté;58;1;10;268;Saint-Seine;207;5;212
27;Bourgogne-Franche-Comté;58;3;08;269;Saint-Sulpice;399;7;406
27;Bourgogne-Franche-Comté;58;4;15;270;Saint-Vérain;340;6;346
27;Bourgogne-Franche-Comté;58;4;15;236;Sainte-Colombe-des-Bois;132;2;134
27;Bourgogne-Franche-Comté;58;3;08;253;Sainte-Marie;80;4;84
27;Bourgogne-Franche-Comté;58;2;03;271;Saizy;189;3;192
27;Bourgogne-Franche-Comté;58;2;04;272;Sardy-lès-Épiry;113;4;117
27;Bourgogne-Franche-Comté;58;3;09;273;Sauvigny-les-Bois;1458;40;1498
27;Bourgogne-Franche-Comté;58;1;10;274;Savigny-Poil-Fol;124;2;126
27;Bourgogne-Franche-Comté;58;3;08;275;Saxi-Bourdon;299;4;303
27;Bourgogne-Franche-Comté;58;1;10;276;Sémelay;234;3;237
27;Bourgogne-Franche-Comté;58;1;10;277;Sermages;188;8;196
27;Bourgogne-Franche-Comté;58;3;12;278;Sermoise-sur-Loire;1514;71;1585
27;Bourgogne-Franche-Comté;58;4;01;279;Sichamps;194;2;196
27;Bourgogne-Franche-Comté;58;3;09;280;Sougy-sur-Loire;625;17;642
27;Bourgogne-Franche-Comté;58;4;15;281;Suilly-la-Tour;600;14;614
27;Bourgogne-Franche-Comté;58;2;03;282;Surgy;328;20;348
27;Bourgogne-Franche-Comté;58;2;04;283;Taconnay;77;3;80
27;Bourgogne-Franche-Comté;58;2;03;284;Talon;40;1;41
27;Bourgogne-Franche-Comté;58;1;02;285;Tamnay-en-Bazois;167;5;172
27;Bourgogne-Franche-Comté;58;2;03;286;Tannay;585;11;596
27;Bourgogne-Franche-Comté;58;1;10;287;Tazilly;198;3;201
27;Bourgogne-Franche-Comté;58;2;03;288;Teigny;103;2;105
27;Bourgogne-Franche-Comté;58;1;10;289;Ternant;192;0;192
27;Bourgogne-Franche-Comté;58;1;10;290;Thaix;50;1;51
27;Bourgogne-Franche-Comté;58;3;09;291;Thianges;171;0;171
27;Bourgogne-Franche-Comté;58;1;02;292;Tintury;183;0;183
27;Bourgogne-Franche-Comté;58;3;16;293;Toury-Lurcy;430;8;438
27;Bourgogne-Franche-Comté;58;3;16;294;Toury-sur-Jour;120;2;122
27;Bourgogne-Franche-Comté;58;4;15;295;Tracy-sur-Loire;970;14;984
27;Bourgogne-Franche-Comté;58;3;16;296;Tresnay;148;0;148
27;Bourgogne-Franche-Comté;58;3;09;297;Trois-Vèvres;240;1;241
27;Bourgogne-Franche-Comté;58;4;01;298;Tronsanges;395;9;404
27;Bourgogne-Franche-Comté;58;2;03;299;Trucy-l'Orgueilleux;220;3;223
27;Bourgogne-Franche-Comté;58;3;08;300;Urzy;1775;35;1810
27;Bourgogne-Franche-Comté;58;1;10;301;Vandenesse;309;5;314
27;Bourgogne-Franche-Comté;58;4;01;302;Varennes-lès-Narcy;955;5;960
27;Bourgogne-Franche-Comté;58;3;17;303;Varennes-Vauzelles;9298;176;9474
27;Bourgogne-Franche-Comté;58;2;03;304;Varzy;1215;197;1412
27;Bourgogne-Franche-Comté;58;2;04;305;Vauclaix;134;2;136
27;Bourgogne-Franche-Comté;58;3;08;204;Vaux d'Amognes;543;8;551
27;Bourgogne-Franche-Comté;58;3;06;306;Verneuil;296;9;305
27;Bourgogne-Franche-Comté;58;4;15;307;Vielmanay;183;3;186
27;Bourgogne-Franche-Comté;58;2;03;308;Vignol;62;0;62
27;Bourgogne-Franche-Comté;58;1;10;309;Villapourçon;415;8;423
27;Bourgogne-Franche-Comté;58;3;08;311;Ville-Langy;252;5;257
27;Bourgogne-Franche-Comté;58;2;03;310;Villiers-le-Sec;48;1;49
27;Bourgogne-Franche-Comté;58;2;03;312;Villiers-sur-Yonne;274;9;283
27;Bourgogne-Franche-Comté;58;2;04;313;Vitry-Laché;82;3;85
32;Hauts-de-France;59;2;09;001;Abancourt;463;13;476
32;Hauts-de-France;59;6;14;002;Abscon;4447;36;4483
32;Hauts-de-France;59;1;19;003;Aibes;370;5;375
32;Hauts-de-France;59;3;31;004;Aix-en-Pévèle;1220;14;1234
32;Hauts-de-France;59;5;02;005;Allennes-les-Marais;3460;60;3520
32;Hauts-de-France;59;1;05;006;Amfroipret;223;8;231
32;Hauts-de-France;59;3;31;007;Anhiers;898;10;908
32;Hauts-de-France;59;3;01;008;Aniche;10244;104;10348
32;Hauts-de-France;59;2;09;010;Anneux;272;2;274
32;Hauts-de-France;59;5;02;011;Annœullin;10428;106;10534
32;Hauts-de-France;59;1;19;012;Anor;3220;47;3267
32;Hauts-de-France;59;5;36;013;Anstaing;1469;16;1485
32;Hauts-de-France;59;6;03;014;Anzin;13305;95;13400
32;Hauts-de-France;59;3;01;015;Arleux;3219;25;3244
32;Hauts-de-France;59;4;12;016;Armbouts-Cappel;2281;48;2329
32;Hauts-de-France;59;5;04;017;Armentières;24882;359;25241
32;Hauts-de-France;59;4;41;018;Arnèke;1617;16;1633
32;Hauts-de-France;59;6;06;019;Artres;1057;12;1069
32;Hauts-de-France;59;1;30;021;Assevent;1825;18;1843
32;Hauts-de-France;59;5;36;022;Attiches;2275;32;2307
32;Hauts-de-France;59;2;09;023;Aubencheul-au-Bac;535;7;542
32;Hauts-de-France;59;3;01;024;Auberchicourt;4448;32;4480
32;Hauts-de-France;59;5;02;025;Aubers;1651;21;1672
32;Hauts-de-France;59;3;01;026;Aubigny-au-Bac;1178;18;1196
32;Hauts-de-France;59;6;06;027;Aubry-du-Hainaut;1679;14;1693
32;Hauts-de-France;59;3;31;028;Auby;7274;41;7315
32;Hauts-de-France;59;3;31;029;Auchy-lez-Orchies;1521;21;1542
32;Hauts-de-France;59;1;05;031;Audignies;366;4;370
32;Hauts-de-France;59;6;06;032;Aulnoy-lez-Valenciennes;7341;67;7408
32;Hauts-de-France;59;1;05;033;Aulnoye-Aymeries;8811;238;9049
32;Hauts-de-France;59;5;36;034;Avelin;2690;34;2724
32;Hauts-de-France;59;1;19;035;Avesnelles;2495;30;2525
32;Hauts-de-France;59;6;14;038;Avesnes-le-Sec;1458;16;1474
32;Hauts-de-France;59;2;11;037;Avesnes-les-Aubert;3640;34;3674
32;Hauts-de-France;59;1;07;036;Avesnes-sur-Helpe;4495;147;4642
32;Hauts-de-France;59;2;10;039;Awoingt;817;17;834
32;Hauts-de-France;59;1;05;041;Bachant;2324;25;2349
32;Hauts-de-France;59;5;36;042;Bachy;1702;23;1725
32;Hauts-de-France;59;4;08;043;Bailleul;14769;270;15039
32;Hauts-de-France;59;5;36;044;Baisieux;4765;48;4813
32;Hauts-de-France;59;1;19;045;Baives;167;2;169
32;Hauts-de-France;59;4;41;046;Bambecque;770;10;780
32;Hauts-de-France;59;2;10;047;Banteux;344;2;346
32;Hauts-de-France;59;2;09;048;Bantigny;510;11;521
32;Hauts-de-France;59;2;10;049;Bantouzelle;426;6;432
32;Hauts-de-France;59;1;19;050;Bas-Lieu;349;8;357
32;Hauts-de-France;59;5;02;051;La Bassée;6402;53;6455
32;Hauts-de-France;59;5;02;052;Bauvin;5180;43;5223
32;Hauts-de-France;59;1;05;053;Bavay;3326;78;3404
32;Hauts-de-France;59;4;41;054;Bavinchove;972;9;981
32;Hauts-de-France;59;2;10;055;Bazuel;525;10;535
32;Hauts-de-France;59;5;28;056;Beaucamps-Ligny;856;23;879
32;Hauts-de-France;59;1;07;057;Beaudignies;564;14;578
32;Hauts-de-France;59;1;07;058;Beaufort;1000;13;1013
32;Hauts-de-France;59;2;10;059;Beaumont-en-Cambrésis;446;4;450
32;Hauts-de-France;59;2;11;060;Beaurain;231;3;234
32;Hauts-de-France;59;1;07;061;Beaurepaire-sur-Sambre;260;1;261
32;Hauts-de-France;59;1;19;062;Beaurieux;165;0;165
32;Hauts-de-France;59;2;11;063;Beauvois-en-Cambrésis;2072;25;2097
32;Hauts-de-France;59;6;06;064;Bellaing;1239;12;1251
32;Hauts-de-France;59;1;05;065;Bellignies;827;9;836
32;Hauts-de-France;59;1;19;066;Bérelles;146;3;149
32;Hauts-de-France;59;4;12;067;Bergues;3653;47;3700
32;Hauts-de-France;59;1;05;068;Berlaimont;3130;36;3166
32;Hauts-de-France;59;2;11;069;Bermerain;723;11;734
32;Hauts-de-France;59;1;05;070;Bermeries;373;4;377
32;Hauts-de-France;59;5;36;071;Bersée;2230;47;2277
32;Hauts-de-France;59;1;30;072;Bersillies;252;6;258
32;Hauts-de-France;59;4;08;073;Berthen;551;13;564
32;Hauts-de-France;59;2;10;074;Bertry;2177;37;2214
32;Hauts-de-France;59;2;11;075;Béthencourt;749;11;760
32;Hauts-de-France;59;1;30;076;Bettignies;310;5;315
32;Hauts-de-France;59;1;05;077;Bettrechies;252;4;256
32;Hauts-de-France;59;1;19;078;Beugnies;635;6;641
32;Hauts-de-France;59;6;03;079;Beuvrages;6740;34;6774
32;Hauts-de-France;59;3;31;080;Beuvry-la-Forêt;2758;28;2786
32;Hauts-de-France;59;2;11;081;Bévillers;562;5;567
32;Hauts-de-France;59;4;12;082;Bierne;1831;31;1862
32;Hauts-de-France;59;4;41;083;Bissezeele;247;2;249
32;Hauts-de-France;59;4;21;084;Blaringhem;2069;31;2100
32;Hauts-de-France;59;2;09;085;Blécourt;306;6;312
32;Hauts-de-France;59;4;08;086;Boeschepe;2183;31;2214
32;Hauts-de-France;59;4;21;087;Boëseghem;748;13;761
32;Hauts-de-France;59;5;04;088;Bois-Grenier;1612;22;1634
32;Hauts-de-France;59;4;41;089;Bollezeele;1435;30;1465
32;Hauts-de-France;59;5;24;090;Bondues;10103;181;10284
32;Hauts-de-France;59;4;08;091;Borre;591;12;603
32;Hauts-de-France;59;6;14;092;Bouchain;3952;39;3991
32;Hauts-de-France;59;1;07;093;Boulogne-sur-Helpe;339;4;343
32;Hauts-de-France;59;4;20;094;Bourbourg;7097;54;7151
32;Hauts-de-France;59;5;36;096;Bourghelles;1664;38;1702
32;Hauts-de-France;59;2;09;097;Boursies;394;5;399
32;Hauts-de-France;59;5;22;098;Bousbecque;4831;46;4877
32;Hauts-de-France;59;1;07;099;Bousies;1738;13;1751
32;Hauts-de-France;59;6;34;100;Bousignies;333;2;335
32;Hauts-de-France;59;1;19;101;Bousignies-sur-Roc;402;2;404
32;Hauts-de-France;59;2;11;102;Boussières-en-Cambrésis;422;4;426
32;Hauts-de-France;59;1;05;103;Boussières-sur-Sambre;524;9;533
32;Hauts-de-France;59;1;30;104;Boussois;3231;21;3252
32;Hauts-de-France;59;3;31;105;Bouvignies;1535;26;1561
32;Hauts-de-France;59;5;36;106;Bouvines;775;17;792
32;Hauts-de-France;59;4;17;107;Bray-Dunes;4483;44;4527
32;Hauts-de-France;59;2;10;108;Briastre;748;4;752
32;Hauts-de-France;59;6;34;109;Brillon;738;9;747
32;Hauts-de-France;59;4;20;110;Brouckerque;1375;28;1403
32;Hauts-de-France;59;4;41;111;Broxeele;403;1;404
32;Hauts-de-France;59;6;03;112;Bruay-sur-l'Escaut;11449;45;11494
32;Hauts-de-France;59;3;35;113;Bruille-lez-Marchiennes;1345;7;1352
32;Hauts-de-France;59;6;34;114;Bruille-Saint-Amand;1671;16;1687
32;Hauts-de-France;59;3;01;115;Brunémont;711;4;715
32;Hauts-de-France;59;1;05;116;Bry;417;12;429
32;Hauts-de-France;59;3;01;117;Bugnicourt;1030;9;1039
32;Hauts-de-France;59;2;10;118;Busigny;2482;29;2511
32;Hauts-de-France;59;4;41;119;Buysscheure;583;9;592
32;Hauts-de-France;59;4;08;120;Caëstre;1980;31;2011
32;Hauts-de-France;59;2;11;121;Cagnoncles;611;7;618
32;Hauts-de-France;59;2;09;122;Cambrai;32558;642;33200
32;Hauts-de-France;59;5;02;123;Camphin-en-Carembault;1660;20;1680
32;Hauts-de-France;59;5;36;124;Camphin-en-Pévèle;2452;42;2494
32;Hauts-de-France;59;2;10;125;Cantaing-sur-Escaut;399;10;409
32;Hauts-de-France;59;3;01;126;Cantin;1577;12;1589
32;Hauts-de-France;59;2;11;127;Capelle;153;5;158
32;Hauts-de-France;59;5;04;128;Capinghem;2495;29;2524
32;Hauts-de-France;59;4;20;130;Cappelle-Brouck;1166;19;1185
32;Hauts-de-France;59;5;36;129;Cappelle-en-Pévèle;2232;26;2258
32;Hauts-de-France;59;4;12;131;Cappelle-la-Grande;7899;74;7973
32;Hauts-de-France;59;2;11;132;Carnières;1073;14;1087
32;Hauts-de-France;59;5;02;133;Carnin;1008;18;1026
32;Hauts-de-France;59;1;07;134;Cartignies;1253;10;1263
32;Hauts-de-France;59;4;08;135;Cassel;2289;101;2390
32;Hauts-de-France;59;2;10;136;Le Cateau-Cambrésis;6933;138;7071
32;Hauts-de-France;59;2;10;137;Catillon-sur-Sambre;840;7;847
32;Hauts-de-France;59;2;10;138;Cattenières;670;14;684
32;Hauts-de-France;59;2;11;139;Caudry;14591;148;14739
32;Hauts-de-France;59;2;10;140;Caullery;454;11;465
32;Hauts-de-France;59;2;11;141;Cauroir;570;15;585
32;Hauts-de-France;59;1;19;142;Cerfontaine;688;4;692
32;Hauts-de-France;59;5;04;143;La Chapelle-d'Armentières;8590;93;8683
32;Hauts-de-France;59;6;34;144;Château-l'Abbaye;874;10;884
32;Hauts-de-France;59;5;18;145;Chemy;768;12;780
32;Hauts-de-France;59;5;36;146;Chéreng;2990;42;3032
32;Hauts-de-France;59;1;19;147;Choisies;52;1;53
32;Hauts-de-France;59;1;19;148;Clairfayts;371;1;372
32;Hauts-de-France;59;2;10;149;Clary;1092;16;1108
32;Hauts-de-France;59;5;36;150;Cobrieux;521;11;532
32;Hauts-de-France;59;1;19;151;Colleret;1615;17;1632
32;Hauts-de-France;59;5;22;152;Comines;12358;88;12446
32;Hauts-de-France;59;6;29;153;Condé-sur-l'Escaut;9698;67;9765
32;Hauts-de-France;59;4;12;155;Coudekerque-Branche;21134;294;21428
32;Hauts-de-France;59;3;15;156;Courchelettes;2809;31;2840
32;Hauts-de-France;59;1;19;157;Cousolre;2270;39;2309
32;Hauts-de-France;59;3;31;158;Coutiches;3014;50;3064
32;Hauts-de-France;59;4;20;159;Craywick;694;6;700
32;Hauts-de-France;59;6;29;160;Crespin;4532;31;4563
32;Hauts-de-France;59;2;10;161;Crèvecœur-sur-l'Escaut;744;45;789
32;Hauts-de-France;59;4;41;162;Crochte;667;21;688
32;Hauts-de-France;59;5;13;163;Croix;21041;276;21317
32;Hauts-de-France;59;1;07;164;Croix-Caluyau;257;8;265
32;Hauts-de-France;59;3;15;165;Cuincy;6435;100;6535
32;Hauts-de-France;59;6;29;166;Curgies;1218;33;1251
32;Hauts-de-France;59;2;09;167;Cuvillers;201;1;202
32;Hauts-de-France;59;5;36;168;Cysoing;4968;73;5041
32;Hauts-de-France;59;1;19;169;Damousies;193;0;193
32;Hauts-de-France;59;3;01;170;Dechy;5324;38;5362
32;Hauts-de-France;59;2;10;171;Dehéries;39;2;41
32;Hauts-de-France;59;6;14;172;Denain;19825;96;19921
32;Hauts-de-France;59;5;04;173;Deûlémont;1769;21;1790
32;Hauts-de-France;59;1;19;174;Dimechaux;339;3;342
32;Hauts-de-France;59;1;19;175;Dimont;314;8;322
32;Hauts-de-France;59;2;09;176;Doignies;333;3;336
32;Hauts-de-France;59;1;07;177;Dompierre-sur-Helpe;860;15;875
32;Hauts-de-France;59;5;02;670;Don;1287;13;1300
32;Hauts-de-France;59;3;15;178;Douai;39700;905;40605
32;Hauts-de-France;59;6;14;179;Douchy-les-Mines;10558;40;10598
32;Hauts-de-France;59;4;08;180;Le Doulieu;1478;22;1500
32;Hauts-de-France;59;1;07;181;Dourlers;569;6;575
32;Hauts-de-France;59;4;20;182;Drincham;250;7;257
32;Hauts-de-France;59;4;96;183;Dunkerque;87353;1314;88667
32;Hauts-de-France;59;4;21;184;Ebblinghem;673;10;683
32;Hauts-de-France;59;3;01;185;Écaillon;1937;15;1952
32;Hauts-de-France;59;1;19;186;Eccles;84;1;85
32;Hauts-de-France;59;1;07;187;Éclaibes;292;5;297
32;Hauts-de-France;59;1;05;188;Écuélin;140;4;144
32;Hauts-de-France;59;4;08;189;Eecke;1219;22;1241
32;Hauts-de-France;59;1;30;190;Élesmes;980;14;994
32;Hauts-de-France;59;2;10;191;Élincourt;625;5;630
32;Hauts-de-France;59;6;14;192;Émerchicourt;886;44;930
32;Hauts-de-France;59;5;18;193;Emmerin;3172;23;3195
32;Hauts-de-France;59;1;07;194;Englefontaine;1304;15;1319
32;Hauts-de-France;59;5;28;195;Englos;609;9;618
32;Hauts-de-France;59;5;28;196;Ennetières-en-Weppes;1311;20;1331
32;Hauts-de-France;59;5;36;197;Ennevelin;2185;23;2208
32;Hauts-de-France;59;1;19;198;Eppe-Sauvage;267;0;267
32;Hauts-de-France;59;3;01;199;Erchin;692;12;704
32;Hauts-de-France;59;4;41;200;Eringhem;479;6;485
32;Hauts-de-France;59;5;28;201;Erquinghem-le-Sec;600;9;609
32;Hauts-de-France;59;5;04;202;Erquinghem-Lys;5158;40;5198
32;Hauts-de-France;59;3;35;203;Erre;1592;10;1602
32;Hauts-de-France;59;2;11;204;Escarmain;470;4;474
32;Hauts-de-France;59;6;14;205;Escaudain;9619;41;9660
32;Hauts-de-France;59;2;09;206;Escaudœuvres;3257;29;3286
32;Hauts-de-France;59;6;03;207;Escautpont;4192;28;4220
32;Hauts-de-France;59;5;28;208;Escobecques;299;10;309
32;Hauts-de-France;59;2;10;209;Esnes;679;8;687
32;Hauts-de-France;59;4;41;210;Esquelbecq;2115;39;2154
32;Hauts-de-France;59;3;15;211;Esquerchin;891;7;898
32;Hauts-de-France;59;4;21;212;Estaires;6379;159;6538
32;Hauts-de-France;59;2;11;213;Estourmel;461;7;468
32;Hauts-de-France;59;3;01;214;Estrées;1112;21;1133
32;Hauts-de-France;59;6;29;215;Estreux;956;19;975
32;Hauts-de-France;59;2;09;219;Estrun;709;8;717
32;Hauts-de-France;59;2;09;216;Eswars;352;8;360
32;Hauts-de-France;59;1;05;217;Eth;340;7;347
32;Hauts-de-France;59;1;07;218;Étrœungt;1319;15;1334
32;Hauts-de-France;59;5;18;220;Faches-Thumesnil;17835;120;17955
32;Hauts-de-France;59;6;06;221;Famars;2517;67;2584
32;Hauts-de-France;59;3;31;222;Faumont;2172;56;2228
32;Hauts-de-France;59;1;07;223;Le Favril;511;4;515
32;Hauts-de-France;59;3;01;224;Féchain;1745;15;1760
32;Hauts-de-France;59;1;05;225;Feignies;6881;97;6978
32;Hauts-de-France;59;1;19;226;Felleries;1420;16;1436
32;Hauts-de-France;59;3;35;227;Fenain;5385;48;5433
32;Hauts-de-France;59;3;01;228;Férin;1455;18;1473
32;Hauts-de-France;59;1;19;229;Féron;567;9;576
32;Hauts-de-France;59;1;30;230;Ferrière-la-Grande;5301;49;5350
32;Hauts-de-France;59;1;19;231;Ferrière-la-Petite;1066;13;1079
32;Hauts-de-France;59;1;05;232;La Flamengrie;420;4;424
32;Hauts-de-France;59;1;19;233;Flaumont-Waudrechies;382;9;391
32;Hauts-de-France;59;3;15;234;Flers-en-Escrebieux;5856;40;5896
32;Hauts-de-France;59;2;10;236;Flesquières;261;4;265
32;Hauts-de-France;59;4;08;237;Flêtre;972;22;994
32;Hauts-de-France;59;6;34;238;Flines-lès-Mortagne;1646;24;1670
32;Hauts-de-France;59;3;31;239;Flines-lez-Raches;5570;89;5659
32;Hauts-de-France;59;1;07;240;Floursies;128;1;129
32;Hauts-de-France;59;1;07;241;Floyon;532;8;540
32;Hauts-de-France;59;1;07;242;Fontaine-au-Bois;682;9;691
32;Hauts-de-France;59;2;10;243;Fontaine-au-Pire;1215;18;1233
32;Hauts-de-France;59;2;09;244;Fontaine-Notre-Dame;1780;32;1812
32;Hauts-de-France;59;1;07;246;Forest-en-Cambrésis;565;4;569
32;Hauts-de-France;59;5;40;247;Forest-sur-Marque;1457;19;1476
32;Hauts-de-France;59;1;19;249;Fourmies;11727;205;11932
32;Hauts-de-France;59;5;02;250;Fournes-en-Weppes;2220;115;2335
32;Hauts-de-France;59;1;05;251;Frasnoy;378;4;382
32;Hauts-de-France;59;5;04;252;Frelinghien;2415;20;2435
32;Hauts-de-France;59;6;03;253;Fresnes-sur-Escaut;7565;43;7608
32;Hauts-de-France;59;3;01;254;Fressain;877;12;889
32;Hauts-de-France;59;2;09;255;Fressies;572;8;580
32;Hauts-de-France;59;5;36;256;Fretin;3380;24;3404
32;Hauts-de-France;59;5;02;257;Fromelles;958;14;972
32;Hauts-de-France;59;5;36;258;Genech;2702;640;3342
32;Hauts-de-France;59;1;07;259;Ghissignies;520;20;540
32;Hauts-de-France;59;4;17;260;Ghyvelde;4193;61;4254
32;Hauts-de-France;59;1;19;261;Glageon;1807;28;1835
32;Hauts-de-France;59;4;08;262;Godewaersvelde;2051;38;2089
32;Hauts-de-France;59;1;30;264;Gognies-Chaussée;752;10;762
32;Hauts-de-France;59;1;05;265;Gommegnies;2301;35;2336
32;Hauts-de-France;59;5;18;266;Gondecourt;4055;42;4097
32;Hauts-de-France;59;2;10;267;Gonnelieu;309;4;313
32;Hauts-de-France;59;4;21;268;La Gorgue;5635;53;5688
32;Hauts-de-France;59;2;10;269;Gouzeaucourt;1511;28;1539
32;Hauts-de-France;59;1;07;270;Grand-Fayt;505;7;512
32;Hauts-de-France;59;4;20;272;Grand-Fort-Philippe;5048;47;5095
32;Hauts-de-France;59;4;20;271;Grande-Synthe;22966;191;23157
32;Hauts-de-France;59;4;20;273;Gravelines;11166;220;11386
32;Hauts-de-France;59;2;10;274;La Groise;481;4;485
32;Hauts-de-France;59;5;36;275;Gruson;1309;38;1347
32;Hauts-de-France;59;3;01;276;Guesnain;4677;36;4713
32;Hauts-de-France;59;1;05;277;Gussignies;334;4;338
32;Hauts-de-France;59;3;01;263;Gœulzin;1026;25;1051
32;Hauts-de-France;59;5;28;278;Hallennes-lez-Haubourdin;4436;35;4471
32;Hauts-de-France;59;5;37;279;Halluin;20800;127;20927
32;Hauts-de-France;59;3;01;280;Hamel;786;9;795
32;Hauts-de-France;59;5;02;281;Hantay;1304;12;1316
32;Hauts-de-France;59;4;41;282;Hardifort;381;10;391
32;Hauts-de-France;59;1;05;283;Hargnies;607;10;617
32;Hauts-de-France;59;6;34;284;Hasnon;3862;31;3893
32;Hauts-de-France;59;6;06;285;Haspres;2739;23;2762
32;Hauts-de-France;59;5;18;286;Haubourdin;14936;117;15053
32;Hauts-de-France;59;2;10;287;Haucourt-en-Cambrésis;198;4;202
32;Hauts-de-France;59;6;06;288;Haulchin;2306;29;2335
32;Hauts-de-France;59;2;11;289;Haussy;1531;33;1564
32;Hauts-de-France;59;1;07;290;Haut-Lieu;391;1;392
32;Hauts-de-France;59;1;07;291;Hautmont;14574;101;14675
32;Hauts-de-France;59;6;06;292;Haveluy;3174;6;3180
32;Hauts-de-France;59;4;21;293;Haverskerque;1425;25;1450
32;Hauts-de-France;59;2;09;294;Haynecourt;321;7;328
32;Hauts-de-France;59;4;21;295;Hazebrouck;21441;558;21999
32;Hauts-de-France;59;1;07;296;Hecq;360;10;370
32;Hauts-de-France;59;6;34;297;Hélesmes;1975;8;1983
32;Hauts-de-France;59;5;13;299;Hem;18617;166;18783
32;Hauts-de-France;59;2;09;300;Hem-Lenglet;565;10;575
32;Hauts-de-France;59;6;29;301;Hergnies;4437;33;4470
32;Hauts-de-France;59;6;06;302;Hérin;4135;30;4165
32;Hauts-de-France;59;5;02;303;Herlies;2399;27;2426
32;Hauts-de-France;59;5;18;304;Herrin;421;6;427
32;Hauts-de-France;59;4;41;305;Herzeele;1640;32;1672
32;Hauts-de-France;59;1;19;306;Hestrud;294;4;298
32;Hauts-de-France;59;4;41;307;Holque;896;5;901
32;Hauts-de-France;59;1;05;310;Hon-Hergies;858;10;868
32;Hauts-de-France;59;4;08;308;Hondeghem;951;25;976
32;Hauts-de-France;59;4;41;309;Hondschoote;4083;84;4167
32;Hauts-de-France;59;2;10;311;Honnechy;549;7;556
32;Hauts-de-France;59;2;10;312;Honnecourt-sur-Escaut;794;12;806
32;Hauts-de-France;59;6;14;313;Hordain;1396;5;1401
32;Hauts-de-France;59;3;35;314;Hornaing;3553;23;3576
32;Hauts-de-France;59;1;05;315;Houdain-lez-Bavay;875;9;884
32;Hauts-de-France;59;5;18;316;Houplin-Ancoisne;3409;45;3454
32;Hauts-de-France;59;5;04;317;Houplines;7805;94;7899
32;Hauts-de-France;59;4;41;318;Houtkerque;994;8;1002
32;Hauts-de-France;59;4;41;319;Hoymille;3214;203;3417
32;Hauts-de-France;59;5;02;320;Illies;1624;11;1635
32;Hauts-de-France;59;2;10;321;Inchy;741;5;746
32;Hauts-de-France;59;2;11;322;Iwuy;3348;30;3378
32;Hauts-de-France;59;1;05;323;Jenlain;1137;26;1163
32;Hauts-de-France;59;1;30;324;Jeumont;10159;126;10285
32;Hauts-de-France;59;1;07;325;Jolimetz;867;16;883
32;Hauts-de-France;59;4;41;326;Killem;1116;20;1136
32;Hauts-de-France;59;3;35;327;Lallaing;6231;43;6274
32;Hauts-de-France;59;5;22;328;Lambersart;27649;402;28051
32;Hauts-de-France;59;3;15;329;Lambres-lez-Douai;5125;101;5226
32;Hauts-de-France;59;3;31;330;Landas;2399;42;2441
32;Hauts-de-France;59;1;07;331;Landrecies;3483;107;3590
32;Hauts-de-France;59;5;13;332;Lannoy;1773;7;1780
32;Hauts-de-France;59;1;07;333;Larouillies;252;9;261
32;Hauts-de-France;59;3;15;334;Lauwin-Planque;1679;24;1703
32;Hauts-de-France;59;6;34;335;Lecelles;2810;54;2864
32;Hauts-de-France;59;3;01;336;Lécluse;1372;15;1387
32;Hauts-de-France;59;4;41;337;Lederzeele;676;15;691
32;Hauts-de-France;59;4;41;338;Ledringhem;661;27;688
32;Hauts-de-France;59;5;33;339;Leers;9473;79;9552
32;Hauts-de-France;59;4;17;340;Leffrinckoucke;4262;96;4358
32;Hauts-de-France;59;2;10;341;Lesdain;417;7;424
32;Hauts-de-France;59;5;36;343;Lesquin;8259;73;8332
32;Hauts-de-France;59;1;05;344;Leval;2455;10;2465
32;Hauts-de-France;59;3;01;345;Lewarde;2425;22;2447
32;Hauts-de-France;59;1;19;342;Lez-Fontaine;229;4;233
32;Hauts-de-France;59;5;26;346;Lezennes;3104;24;3128
32;Hauts-de-France;59;1;19;347;Liessies;533;16;549
32;Hauts-de-France;59;6;14;348;Lieu-Saint-Amand;1349;11;1360
32;Hauts-de-France;59;2;10;349;Ligny-en-Cambrésis;1894;29;1923
32;Hauts-de-France;59;5;97;350;Lille;232787;2055;234842
32;Hauts-de-France;59;1;07;351;Limont-Fontaine;563;6;569
32;Hauts-de-France;59;5;22;352;Linselles;8371;98;8469
32;Hauts-de-France;59;1;07;353;Locquignol;374;2;376
32;Hauts-de-France;59;3;01;354;Loffre;729;14;743
32;Hauts-de-France;59;5;22;356;Lompret;2299;53;2352
32;Hauts-de-France;59;1;05;357;La Longueville;2097;32;2129
32;Hauts-de-France;59;4;20;358;Looberghe;1178;22;1200
32;Hauts-de-France;59;4;20;359;Loon-Plage;6193;76;6269
32;Hauts-de-France;59;5;28;360;Loos;22233;255;22488
32;Hauts-de-France;59;6;14;361;Lourches;3949;17;3966
32;Hauts-de-France;59;1;07;363;Louvignies-Quesnoy;933;19;952
32;Hauts-de-France;59;5;36;364;Louvil;826;16;842
32;Hauts-de-France;59;1;30;365;Louvroil;6481;41;6522
32;Hauts-de-France;59;4;21;366;Lynde;758;14;772
32;Hauts-de-France;59;5;13;367;Lys-lez-Lannoy;13422;144;13566
32;Hauts-de-France;59;5;23;368;La Madeleine;21173;181;21354
32;Hauts-de-France;59;6;06;369;Maing;4112;41;4153
32;Hauts-de-France;59;1;30;370;Mairieux;735;15;750
32;Hauts-de-France;59;5;02;371;Le Maisnil;642;15;657
32;Hauts-de-France;59;2;10;372;Malincourt;504;6;510
32;Hauts-de-France;59;1;07;374;Marbaix;482;4;486
32;Hauts-de-France;59;3;35;375;Marchiennes;4590;62;4652
32;Hauts-de-France;59;2;10;377;Marcoing;1888;25;1913
32;Hauts-de-France;59;5;24;378;Marcq-en-Barœul;38617;807;39424
32;Hauts-de-France;59;3;01;379;Marcq-en-Ostrevent;736;3;739
32;Hauts-de-France;59;1;07;381;Maresches;820;16;836
32;Hauts-de-France;59;2;10;382;Maretz;1457;16;1473
32;Hauts-de-France;59;6;29;383;Marly;11855;122;11977
32;Hauts-de-France;59;1;07;384;Maroilles;1403;23;1426
32;Hauts-de-France;59;1;30;385;Marpent;2748;31;2779
32;Hauts-de-France;59;6;14;387;Marquette-en-Ostrevant;1873;12;1885
32;Hauts-de-France;59;5;23;386;Marquette-lez-Lille;10376;69;10445
32;Hauts-de-France;59;5;02;388;Marquillies;1997;23;2020
32;Hauts-de-France;59;2;10;389;Masnières;2717;29;2746
32;Hauts-de-France;59;3;01;390;Masny;4143;47;4190
32;Hauts-de-France;59;6;14;391;Mastaing;865;5;870
32;Hauts-de-France;59;1;30;392;Maubeuge;29944;314;30258
32;Hauts-de-France;59;6;34;393;Maulde;1026;13;1039
32;Hauts-de-France;59;2;10;394;Maurois;395;4;399
32;Hauts-de-France;59;2;10;395;Mazinghien;304;4;308
32;Hauts-de-France;59;1;05;396;Mecquignies;702;7;709
32;Hauts-de-France;59;4;41;397;Merckeghem;593;12;605
32;Hauts-de-France;59;5;36;398;Mérignies;3065;143;3208
32;Hauts-de-France;59;4;08;399;Merris;1018;29;1047
32;Hauts-de-France;59;4;21;400;Merville;9720;91;9811
32;Hauts-de-France;59;4;08;401;Méteren;2314;37;2351
32;Hauts-de-France;59;4;41;402;Millam;813;19;832
32;Hauts-de-France;59;6;34;403;Millonfosse;715;12;727
32;Hauts-de-France;59;1;05;406;Monceau-Saint-Waast;495;4;499
32;Hauts-de-France;59;6;06;407;Monchaux-sur-Écaillon;541;9;550
32;Hauts-de-France;59;5;36;408;Moncheaux;1536;18;1554
32;Hauts-de-France;59;3;01;409;Monchecourt;2502;21;2523
32;Hauts-de-France;59;5;25;410;Mons-en-Barœul;20782;161;20943
32;Hauts-de-France;59;5;36;411;Mons-en-Pévèle;2134;39;2173
32;Hauts-de-France;59;2;10;412;Montay;290;4;294
32;Hauts-de-France;59;2;10;413;Montigny-en-Cambrésis;562;9;571
32;Hauts-de-France;59;3;01;414;Montigny-en-Ostrevent;4801;37;4838
32;Hauts-de-France;59;2;11;415;Montrécourt;224;1;225
32;Hauts-de-France;59;4;21;416;Morbecque;2538;43;2581
32;Hauts-de-France;59;6;34;418;Mortagne-du-Nord;1626;7;1633
32;Hauts-de-France;59;5;36;419;Mouchin;1392;16;1408
32;Hauts-de-France;59;1;19;420;Moustier-en-Fagne;59;1;60
32;Hauts-de-France;59;5;24;421;Mouvaux;13151;188;13339
32;Hauts-de-France;59;2;09;405;Mœuvres;465;3;468
32;Hauts-de-France;59;2;11;422;Naves;636;9;645
32;Hauts-de-France;59;4;21;423;Neuf-Berquin;1234;25;1259
32;Hauts-de-France;59;1;05;424;Neuf-Mesnil;1330;5;1335
32;Hauts-de-France;59;5;36;427;La Neuville;646;10;656
32;Hauts-de-France;59;1;07;425;Neuville-en-Avesnois;304;8;312
32;Hauts-de-France;59;5;37;426;Neuville-en-Ferrain;10284;66;10350
32;Hauts-de-France;59;2;09;428;Neuville-Saint-Rémy;3803;41;3844
32;Hauts-de-France;59;6;14;429;Neuville-sur-Escaut;2702;16;2718
32;Hauts-de-France;59;2;10;430;Neuvilly;1113;12;1125
32;Hauts-de-France;59;4;08;431;Nieppe;7476;83;7559
32;Hauts-de-France;59;2;10;432;Niergnies;509;8;517
32;Hauts-de-France;59;4;41;433;Nieurlet;937;13;950
32;Hauts-de-France;59;6;34;434;Nivelle;1318;17;1335
32;Hauts-de-France;59;3;31;435;Nomain;2521;35;2556
32;Hauts-de-France;59;4;41;436;Noordpeene;788;10;798
32;Hauts-de-France;59;5;18;437;Noyelles-lès-Seclin;873;13;886
32;Hauts-de-France;59;2;10;438;Noyelles-sur-Escaut;803;12;815
32;Hauts-de-France;59;1;05;439;Noyelles-sur-Sambre;278;5;283
32;Hauts-de-France;59;6;14;440;Noyelles-sur-Selle;705;6;711
32;Hauts-de-France;59;1;05;441;Obies;686;6;692
32;Hauts-de-France;59;1;19;442;Obrechies;268;8;276
32;Hauts-de-France;59;4;41;443;Ochtezeele;383;5;388
32;Hauts-de-France;59;6;29;444;Odomez;936;12;948
32;Hauts-de-France;59;1;19;445;Ohain;1199;17;1216
32;Hauts-de-France;59;6;06;446;Oisy;614;8;622
32;Hauts-de-France;59;6;03;447;Onnaing;8797;65;8862
32;Hauts-de-France;59;4;41;448;Oost-Cappel;465;4;469
32;Hauts-de-France;59;3;31;449;Orchies;8828;159;8987
32;Hauts-de-France;59;2;10;450;Ors;643;8;651
32;Hauts-de-France;59;1;07;451;Orsinval;548;3;551
32;Hauts-de-France;59;5;02;452;Ostricourt;5372;27;5399
32;Hauts-de-France;59;4;41;453;Oudezeele;686;9;695
32;Hauts-de-France;59;4;08;454;Oxelaëre;519;4;523
32;Hauts-de-France;59;2;09;455;Paillencourt;991;9;1000
32;Hauts-de-France;59;3;35;456;Pecquencourt;6011;258;6269
32;Hauts-de-France;59;5;04;457;Pérenchies;8424;42;8466
32;Hauts-de-France;59;5;36;458;Péronne-en-Mélantois;908;19;927
32;Hauts-de-France;59;1;07;461;Petit-Fayt;309;2;311
32;Hauts-de-France;59;6;06;459;Petite-Forêt;4877;35;4912
32;Hauts-de-France;59;5;02;462;Phalempin;4729;40;4769
32;Hauts-de-France;59;4;20;463;Pitgam;966;12;978
32;Hauts-de-France;59;1;07;464;Poix-du-Nord;2203;18;2221
32;Hauts-de-France;59;2;10;465;Pommereuil;770;4;774
32;Hauts-de-France;59;5;36;466;Pont-à-Marcq;2884;84;2968
32;Hauts-de-France;59;1;05;467;Pont-sur-Sambre;2541;24;2565
32;Hauts-de-France;59;1;07;468;Potelle;395;4;399
32;Hauts-de-France;59;4;08;469;Pradelles;390;3;393
32;Hauts-de-France;59;5;04;470;Prémesques;2130;23;2153
32;Hauts-de-France;59;6;29;471;Préseau;1932;24;1956
32;Hauts-de-France;59;1;07;472;Preux-au-Bois;844;9;853
32;Hauts-de-France;59;1;05;473;Preux-au-Sart;314;7;321
32;Hauts-de-France;59;1;07;474;Prisches;1081;22;1103
32;Hauts-de-France;59;6;06;475;Prouvy;2282;39;2321
32;Hauts-de-France;59;2;09;476;Proville;3163;75;3238
32;Hauts-de-France;59;5;02;477;Provin;4234;29;4263
32;Hauts-de-France;59;4;41;478;Quaëdypre;1095;25;1120
32;Hauts-de-France;59;6;29;479;Quarouble;2992;28;3020
32;Hauts-de-France;59;6;06;480;Quérénaing;886;20;906
32;Hauts-de-France;59;1;07;481;Le Quesnoy;4934;131;5065
32;Hauts-de-France;59;5;22;482;Quesnoy-sur-Deûle;6758;58;6816
32;Hauts-de-France;59;1;19;483;Quiévelon;131;1;132
32;Hauts-de-France;59;6;29;484;Quiévrechain;6366;28;6394
32;Hauts-de-France;59;2;11;485;Quiévy;1783;20;1803
32;Hauts-de-France;59;3;31;486;Râches;2740;32;2772
32;Hauts-de-France;59;5;02;487;Radinghem-en-Weppes;1406;22;1428
32;Hauts-de-France;59;2;09;488;Raillencourt-Sainte-Olle;2238;42;2280
32;Hauts-de-France;59;3;31;489;Raimbeaucourt;4002;56;4058
32;Hauts-de-France;59;1;19;490;Rainsars;182;2;184
32;Hauts-de-France;59;6;34;491;Raismes;12587;75;12662
32;Hauts-de-France;59;2;09;492;Ramillies;600;7;607
32;Hauts-de-France;59;1;19;493;Ramousies;228;1;229
32;Hauts-de-France;59;1;07;494;Raucourt-au-Bois;173;1;174
32;Hauts-de-France;59;1;19;495;Recquignies;2413;22;2435
32;Hauts-de-France;59;2;10;496;Rejet-de-Beaulieu;261;1;262
32;Hauts-de-France;59;4;21;497;Renescure;2080;38;2118
32;Hauts-de-France;59;2;10;498;Reumont;363;9;372
32;Hauts-de-France;59;4;41;499;Rexpoëde;2001;33;2034
32;Hauts-de-France;59;2;10;500;Ribécourt-la-Tour;373;5;378
32;Hauts-de-France;59;3;35;501;Rieulay;1327;27;1354
32;Hauts-de-France;59;2;11;502;Rieux-en-Cambrésis;1445;9;1454
32;Hauts-de-France;59;1;07;503;Robersart;184;3;187
32;Hauts-de-France;59;6;29;505;Rombies-et-Marchipont;760;4;764
32;Hauts-de-France;59;2;11;506;Romeries;450;7;457
32;Hauts-de-France;59;5;26;507;Ronchin;19220;129;19349
32;Hauts-de-France;59;5;37;508;Roncq;13388;113;13501
32;Hauts-de-France;59;3;31;509;Roost-Warendin;6141;51;6192
32;Hauts-de-France;59;6;34;511;Rosult;1911;25;1936
32;Hauts-de-France;59;5;98;512;Roubaix;96990;502;97492
32;Hauts-de-France;59;3;01;513;Roucourt;454;7;461
32;Hauts-de-France;59;1;19;514;Rousies;4016;55;4071
32;Hauts-de-France;59;6;06;515;Rouvignies;655;6;661
32;Hauts-de-France;59;4;41;516;Rubrouck;939;18;957
32;Hauts-de-France;59;2;10;517;Les Rues-des-Vignes;801;18;819
32;Hauts-de-France;59;1;07;518;Ruesnes;450;7;457
32;Hauts-de-France;59;6;34;519;Rumegies;1797;17;1814
32;Hauts-de-France;59;2;10;520;Rumilly-en-Cambrésis;1453;25;1478
32;Hauts-de-France;59;6;14;504;Rœulx;3830;21;3851
32;Hauts-de-France;59;2;09;521;Sailly-lez-Cambrai;471;8;479
32;Hauts-de-France;59;5;40;522;Sailly-lez-Lannoy;1849;36;1885
32;Hauts-de-France;59;5;36;523;Sainghin-en-Mélantois;2760;25;2785
32;Hauts-de-France;59;5;02;524;Sainghin-en-Weppes;5586;51;5637
32;Hauts-de-France;59;1;19;525;Sains-du-Nord;2892;26;2918
32;Hauts-de-France;59;6;34;526;Saint-Amand-les-Eaux;15889;152;16041
32;Hauts-de-France;59;5;23;527;Saint-André-lez-Lille;12608;99;12707
32;Hauts-de-France;59;2;11;528;Saint-Aubert;1570;22;1592
32;Hauts-de-France;59;1;07;529;Saint-Aubin;363;8;371
32;Hauts-de-France;59;6;29;530;Saint-Aybert;379;5;384
32;Hauts-de-France;59;2;10;531;Saint-Benin;340;3;343
32;Hauts-de-France;59;4;20;532;Saint-Georges-sur-l'Aa;307;8;315
32;Hauts-de-France;59;2;11;533;Saint-Hilaire-lez-Cambrai;1602;14;1616
32;Hauts-de-France;59;1;07;534;Saint-Hilaire-sur-Helpe;823;31;854
32;Hauts-de-France;59;4;08;535;Saint-Jans-Cappel;1722;49;1771
32;Hauts-de-France;59;2;11;537;Saint-Martin-sur-Écaillon;515;9;524
32;Hauts-de-France;59;4;41;538;Saint-Momelin;462;12;474
32;Hauts-de-France;59;4;20;539;Saint-Pierre-Brouck;995;17;1012
32;Hauts-de-France;59;2;11;541;Saint-Python;1016;8;1024
32;Hauts-de-France;59;1;05;542;Saint-Remy-Chaussée;510;13;523
32;Hauts-de-France;59;1;07;543;Saint-Remy-du-Nord;1115;11;1126
32;Hauts-de-France;59;6;39;544;Saint-Saulve;11207;146;11353
32;Hauts-de-France;59;2;10;545;Saint-Souplet;1230;18;1248
32;Hauts-de-France;59;4;08;546;Saint-Sylvestre-Cappel;1180;9;1189
32;Hauts-de-France;59;2;11;547;Saint-Vaast-en-Cambrésis;888;10;898
32;Hauts-de-France;59;1;05;548;Saint-Waast;636;8;644
32;Hauts-de-France;59;4;08;536;Sainte-Marie-Cappel;877;21;898
32;Hauts-de-France;59;1;07;549;Salesches;303;2;305
32;Hauts-de-France;59;5;02;550;Salomé;2969;22;2991
32;Hauts-de-France;59;3;31;551;Saméon;1672;22;1694
32;Hauts-de-France;59;2;09;552;Sancourt;197;6;203
32;Hauts-de-France;59;5;28;553;Santes;5724;54;5778
32;Hauts-de-France;59;6;34;554;Sars-et-Rosières;588;6;594
32;Hauts-de-France;59;1;19;555;Sars-Poteries;1441;17;1458
32;Hauts-de-France;59;1;05;556;Sassegnies;269;3;272
32;Hauts-de-France;59;6;29;557;Saultain;2398;16;2414
32;Hauts-de-France;59;2;11;558;Saulzoir;1753;22;1775
32;Hauts-de-France;59;6;29;559;Sebourg;1969;32;2001
32;Hauts-de-France;59;5;18;560;Seclin;12414;93;12507
32;Hauts-de-France;59;1;19;562;Sémeries;546;6;552
32;Hauts-de-France;59;1;07;563;Semousies;243;3;246
32;Hauts-de-France;59;6;06;564;La Sentinelle;3136;16;3152
32;Hauts-de-France;59;1;07;565;Sepmeries;663;11;674
32;Hauts-de-France;59;5;28;566;Sequedin;4712;23;4735
32;Hauts-de-France;59;2;10;567;Séranvillers-Forenville;411;1;412
32;Hauts-de-France;59;4;21;568;Sercus;461;5;466
32;Hauts-de-France;59;3;35;569;Sin-le-Noble;15682;117;15799
32;Hauts-de-France;59;4;41;570;Socx;938;36;974
32;Hauts-de-France;59;2;11;571;Solesmes;4338;103;4441
32;Hauts-de-France;59;1;19;572;Solre-le-Château;1815;19;1834
32;Hauts-de-France;59;1;19;573;Solrinnes;135;0;135
32;Hauts-de-France;59;3;35;574;Somain;12151;81;12232
32;Hauts-de-France;59;2;11;575;Sommaing;413;4;417
32;Hauts-de-France;59;4;12;576;Spycker;1807;27;1834
32;Hauts-de-France;59;4;08;577;Staple;658;5;663
32;Hauts-de-France;59;4;21;578;Steenbecque;1690;30;1720
32;Hauts-de-France;59;4;12;579;Steene;1354;25;1379
32;Hauts-de-France;59;4;41;580;Steenvoorde;4368;84;4452
32;Hauts-de-France;59;4;08;581;Steenwerck;3673;53;3726
32;Hauts-de-France;59;4;08;582;Strazeele;945;23;968
32;Hauts-de-France;59;1;07;583;Taisnières-en-Thiérache;466;1;467
32;Hauts-de-France;59;1;05;584;Taisnières-sur-Hon;971;12;983
32;Hauts-de-France;59;5;18;585;Templemars;3344;24;3368
32;Hauts-de-France;59;5;36;586;Templeuve-en-Pévèle;6059;67;6126
32;Hauts-de-France;59;4;41;587;Terdeghem;532;14;546
32;Hauts-de-France;59;4;12;588;Téteghem-Coudekerque-Village;8341;251;8592
32;Hauts-de-France;59;6;06;589;Thiant;2917;23;2940
32;Hauts-de-France;59;4;21;590;Thiennes;908;15;923
32;Hauts-de-France;59;6;29;591;Thivencelle;846;2;848
32;Hauts-de-France;59;5;36;592;Thumeries;3900;31;3931
32;Hauts-de-France;59;2;09;593;Thun-l'Évêque;754;11;765
32;Hauts-de-France;59;6;34;594;Thun-Saint-Amand;1125;12;1137
32;Hauts-de-France;59;2;09;595;Thun-Saint-Martin;518;8;526
32;Hauts-de-France;59;2;09;597;Tilloy-lez-Cambrai;590;21;611
32;Hauts-de-France;59;3;35;596;Tilloy-lez-Marchiennes;518;17;535
32;Hauts-de-France;59;5;40;598;Toufflers;3905;19;3924
32;Hauts-de-France;59;5;99;599;Tourcoing;97368;660;98028
32;Hauts-de-France;59;5;36;600;Tourmignies;888;14;902
32;Hauts-de-France;59;1;19;601;Trélon;2856;68;2924
32;Hauts-de-France;59;5;36;602;Tressin;1408;32;1440
32;Hauts-de-France;59;6;06;603;Trith-Saint-Léger;6215;90;6305
32;Hauts-de-France;59;2;10;604;Troisvilles;841;9;850
32;Hauts-de-France;59;4;12;605;Uxem;1411;23;1434
32;Hauts-de-France;59;6;39;606;Valenciennes;43336;419;43755
32;Hauts-de-France;59;1;07;607;Vendegies-au-Bois;487;5;492
32;Hauts-de-France;59;2;11;608;Vendegies-sur-Écaillon;1068;20;1088
32;Hauts-de-France;59;5;18;609;Vendeville;1606;21;1627
32;Hauts-de-France;59;6;06;610;Verchain-Maugré;1013;9;1022
32;Hauts-de-France;59;5;22;611;Verlinghem;2460;56;2516
32;Hauts-de-France;59;2;11;612;Vertain;517;10;527
32;Hauts-de-France;59;6;29;613;Vicq;1492;16;1508
32;Hauts-de-France;59;2;11;614;Viesly;1506;21;1527
32;Hauts-de-France;59;4;08;615;Vieux-Berquin;2507;40;2547
32;Hauts-de-France;59;6;29;616;Vieux-Condé;10469;52;10521
32;Hauts-de-France;59;1;05;617;Vieux-Mesnil;636;7;643
32;Hauts-de-France;59;1;30;618;Vieux-Reng;848;14;862
32;Hauts-de-France;59;5;40;009;Villeneuve-d'Ascq;63408;693;64101
32;Hauts-de-France;59;1;05;619;Villereau;996;14;1010
32;Hauts-de-France;59;3;01;620;Villers-au-Tertre;630;7;637
32;Hauts-de-France;59;2;11;622;Villers-en-Cauchies;1248;17;1265
32;Hauts-de-France;59;2;10;623;Villers-Guislain;696;4;700
32;Hauts-de-France;59;2;10;624;Villers-Outréaux;2110;26;2136
32;Hauts-de-France;59;2;10;625;Villers-Plouich;404;4;408
32;Hauts-de-France;59;1;07;626;Villers-Pol;1276;21;1297
32;Hauts-de-France;59;1;30;627;Villers-Sire-Nicole;978;11;989
32;Hauts-de-France;59;4;41;628;Volckerinckhove;567;6;573
32;Hauts-de-France;59;3;35;629;Vred;1375;19;1394
32;Hauts-de-France;59;5;02;630;Wahagnies;2598;41;2639
32;Hauts-de-France;59;2;10;631;Walincourt-Selvigny;2136;30;2166
32;Hauts-de-France;59;6;34;632;Wallers;5526;39;5565
32;Hauts-de-France;59;1;19;633;Wallers-en-Fagne;286;7;293
32;Hauts-de-France;59;4;21;634;Wallon-Cappel;811;22;833
32;Hauts-de-France;59;2;10;635;Wambaix;374;6;380
32;Hauts-de-France;59;5;23;636;Wambrechies;10948;88;11036
32;Hauts-de-France;59;3;35;637;Wandignies-Hamage;1302;16;1318
32;Hauts-de-France;59;5;36;638;Wannehain;1272;14;1286
32;Hauts-de-France;59;1;05;639;Wargnies-le-Grand;1101;23;1124
32;Hauts-de-France;59;1;05;640;Wargnies-le-Petit;759;11;770
32;Hauts-de-France;59;4;41;641;Warhem;2032;43;2075
32;Hauts-de-France;59;3;35;642;Warlaing;579;17;596
32;Hauts-de-France;59;5;04;643;Warneton;239;2;241
32;Hauts-de-France;59;6;14;645;Wasnes-au-Bac;609;4;613
32;Hauts-de-France;59;5;13;646;Wasquehal;20479;226;20705
32;Hauts-de-France;59;4;41;647;Watten;2563;32;2595
32;Hauts-de-France;59;5;18;648;Wattignies;14549;194;14743
32;Hauts-de-France;59;1;19;649;Wattignies-la-Victoire;243;11;254
32;Hauts-de-France;59;5;33;650;Wattrelos;40958;160;41118
32;Hauts-de-France;59;6;14;651;Wavrechain-sous-Denain;1661;11;1672
32;Hauts-de-France;59;6;14;652;Wavrechain-sous-Faulx;386;1;387
32;Hauts-de-France;59;5;02;653;Wavrin;7676;68;7744
32;Hauts-de-France;59;3;35;654;Waziers;7452;67;7519
32;Hauts-de-France;59;4;41;655;Wemaers-Cappel;252;4;256
32;Hauts-de-France;59;5;22;656;Wervicq-Sud;5413;49;5462
32;Hauts-de-France;59;4;41;657;West-Cappel;628;7;635
32;Hauts-de-France;59;5;02;658;Wicres;498;7;505
32;Hauts-de-France;59;1;19;659;Wignehies;2903;31;2934
32;Hauts-de-France;59;5;40;660;Willems;3021;40;3061
32;Hauts-de-France;59;1;19;661;Willies;148;2;150
32;Hauts-de-France;59;4;41;662;Winnezeele;1306;22;1328
32;Hauts-de-France;59;4;41;663;Wormhout;5632;86;5718
32;Hauts-de-France;59;4;41;664;Wulverdinghe;309;4;313
32;Hauts-de-France;59;4;41;665;Wylder;291;10;301
32;Hauts-de-France;59;4;41;666;Zegerscappel;1529;32;1561
32;Hauts-de-France;59;4;41;667;Zermezeele;223;4;227
32;Hauts-de-France;59;4;17;668;Zuydcoote;1677;59;1736
32;Hauts-de-France;59;4;41;669;Zuytpeene;524;17;541
32;Hauts-de-France;60;1;11;001;Abancourt;651;8;659
32;Hauts-de-France;60;1;04;002;Abbecourt;787;23;810
32;Hauts-de-France;60;2;19;003;Abbeville-Saint-Lucien;490;13;503
32;Hauts-de-France;60;1;11;004;Achy;402;7;409
32;Hauts-de-France;60;4;15;005;Acy-en-Multien;849;14;863
32;Hauts-de-France;60;2;18;006;Les Ageux;1179;19;1198
32;Hauts-de-France;60;2;05;007;Agnetz;3050;121;3171
32;Hauts-de-France;60;2;19;008;Airion;399;154;553
32;Hauts-de-France;60;1;02;009;Allonne;1572;29;1601
32;Hauts-de-France;60;1;12;010;Amblainville;1740;21;1761
32;Hauts-de-France;60;3;21;011;Amy;392;5;397
32;Hauts-de-France;60;1;12;012;Andeville;3227;45;3272
32;Hauts-de-France;60;2;18;013;Angicourt;1396;29;1425
32;Hauts-de-France;60;2;19;014;Angivillers;185;5;190
32;Hauts-de-France;60;2;14;015;Angy;1172;14;1186
32;Hauts-de-France;60;2;14;016;Ansacq;276;4;280
32;Hauts-de-France;60;2;19;017;Ansauvillers;1197;25;1222
32;Hauts-de-France;60;3;10;019;Antheuil-Portes;409;6;415
32;Hauts-de-France;60;4;15;020;Antilly;264;9;273
32;Hauts-de-France;60;3;17;021;Appilly;542;8;550
32;Hauts-de-France;60;4;03;022;Apremont;660;16;676
32;Hauts-de-France;60;3;07;023;Armancourt;563;8;571
32;Hauts-de-France;60;3;10;024;Arsy;770;8;778
32;Hauts-de-France;60;3;06;025;Attichy;1880;41;1921
32;Hauts-de-France;60;1;19;026;Auchy-la-Montagne;592;13;605
32;Hauts-de-France;60;4;09;027;Auger-Saint-Vincent;518;13;531
32;Hauts-de-France;60;4;20;028;Aumont-en-Halatte;476;25;501
32;Hauts-de-France;60;1;02;029;Auneuil;2892;62;2954
32;Hauts-de-France;60;1;02;030;Auteuil;554;9;563
32;Hauts-de-France;60;4;15;031;Autheuil-en-Valois;272;6;278
32;Hauts-de-France;60;3;06;032;Autrêches;733;15;748
32;Hauts-de-France;60;4;20;033;Avilly-Saint-Léonard;887;40;927
32;Hauts-de-France;60;2;19;034;Avrechy;1150;17;1167
32;Hauts-de-France;60;3;21;035;Avricourt;260;2;262
32;Hauts-de-France;60;2;10;036;Avrigny;373;7;380
32;Hauts-de-France;60;3;17;037;Babœuf;520;7;527
32;Hauts-de-France;60;2;19;039;Bacouël;492;8;500
32;Hauts-de-France;60;2;10;040;Bailleul-le-Soc;642;11;653
32;Hauts-de-France;60;1;14;041;Bailleul-sur-Thérain;2175;51;2226
32;Hauts-de-France;60;2;05;042;Bailleval;1477;46;1523
32;Hauts-de-France;60;3;21;043;Bailly;636;9;645
32;Hauts-de-France;60;4;13;044;Balagny-sur-Thérain;1723;18;1741
32;Hauts-de-France;60;4;18;045;Barbery;572;10;582
32;Hauts-de-France;60;4;15;046;Bargny;332;7;339
32;Hauts-de-France;60;4;15;047;Baron;760;16;776
32;Hauts-de-France;60;3;10;048;Baugy;241;5;246
32;Hauts-de-France;60;1;11;049;Bazancourt;129;9;138
32;Hauts-de-France;60;2;18;050;Bazicourt;337;9;346
32;Hauts-de-France;60;1;11;051;Beaudéduit;204;1;205
32;Hauts-de-France;60;3;17;052;Beaugies-sous-Bois;101;3;104
32;Hauts-de-France;60;3;21;053;Beaulieu-les-Fontaines;609;50;659
32;Hauts-de-France;60;3;17;055;Beaurains-lès-Noyon;338;5;343
32;Hauts-de-France;60;4;18;056;Beaurepaire;67;1;68
32;Hauts-de-France;60;1;98;057;Beauvais;56254;1328;57582
32;Hauts-de-France;60;2;19;058;Beauvoir;238;4;242
32;Hauts-de-France;60;3;17;059;Béhéricourt;209;6;215
32;Hauts-de-France;60;4;12;060;Belle-Église;609;9;618
32;Hauts-de-France;60;3;10;061;Belloy;94;1;95
32;Hauts-de-France;60;3;17;062;Berlancourt;331;5;336
32;Hauts-de-France;60;1;02;063;Berneuil-en-Bray;788;36;824
32;Hauts-de-France;60;3;06;064;Berneuil-sur-Aisne;1004;16;1020
32;Hauts-de-France;60;1;04;065;Berthecourt;1633;30;1663
32;Hauts-de-France;60;4;09;066;Béthancourt-en-Valois;218;10;228
32;Hauts-de-France;60;4;09;067;Béthisy-Saint-Martin;1060;21;1081
32;Hauts-de-France;60;4;09;068;Béthisy-Saint-Pierre;3078;55;3133
32;Hauts-de-France;60;4;15;069;Betz;1161;39;1200
32;Hauts-de-France;60;3;06;070;Bienville;442;10;452
32;Hauts-de-France;60;3;10;071;Biermont;175;5;180
32;Hauts-de-France;60;3;06;072;Bitry;317;5;322
32;Hauts-de-France;60;1;11;073;Blacourt;602;5;607
32;Hauts-de-France;60;4;13;074;Blaincourt-lès-Précy;1190;30;1220
32;Hauts-de-France;60;1;19;075;Blancfossé;146;1;147
32;Hauts-de-France;60;1;11;076;Blargies;533;7;540
32;Hauts-de-France;60;1;11;077;Blicourt;349;9;358
32;Hauts-de-France;60;2;10;078;Blincourt;93;0;93
32;Hauts-de-France;60;4;15;079;Boissy-Fresnoy;999;13;1012
32;Hauts-de-France;60;1;14;081;Bonlier;474;9;483
32;Hauts-de-France;60;4;09;083;Bonneuil-en-Valois;1025;24;1049
32;Hauts-de-France;60;2;19;082;Bonneuil-les-Eaux;805;16;821
32;Hauts-de-France;60;1;11;084;Bonnières;169;1;170
32;Hauts-de-France;60;2;19;085;Bonvillers;204;2;206
32;Hauts-de-France;60;4;03;086;Boran-sur-Oise;2165;35;2200
32;Hauts-de-France;60;4;15;087;Borest;334;18;352
32;Hauts-de-France;60;1;12;088;Bornel;4817;69;4886
32;Hauts-de-France;60;1;04;089;Boubiers;412;11;423
32;Hauts-de-France;60;1;04;090;Bouconvillers;387;8;395
32;Hauts-de-France;60;4;15;091;Bouillancy;382;11;393
32;Hauts-de-France;60;4;15;092;Boullarre;223;5;228
32;Hauts-de-France;60;3;10;093;Boulogne-la-Grasse;471;9;480
32;Hauts-de-France;60;4;15;094;Boursonne;300;6;306
32;Hauts-de-France;60;1;04;095;Boury-en-Vexin;341;7;348
32;Hauts-de-France;60;1;04;097;Boutencourt;220;6;226
32;Hauts-de-France;60;1;11;098;Bouvresse;160;1;161
32;Hauts-de-France;60;3;10;099;Braisnes-sur-Aronde;169;2;171
32;Hauts-de-France;60;4;18;100;Brasseuse;107;0;107
32;Hauts-de-France;60;4;15;101;Brégy;636;14;650
32;Hauts-de-France;60;2;18;102;Brenouille;2016;30;2046
32;Hauts-de-France;60;1;14;103;Bresles;4147;44;4191
32;Hauts-de-France;60;2;19;104;Breteuil;4340;114;4454
32;Hauts-de-France;60;3;17;105;Brétigny;410;9;419
32;Hauts-de-France;60;2;05;106;Breuil-le-Sec;2648;38;2686
32;Hauts-de-France;60;2;05;107;Breuil-le-Vert;3087;129;3216
32;Hauts-de-France;60;1;11;108;Briot;283;8;291
32;Hauts-de-France;60;1;11;109;Brombos;256;4;260
32;Hauts-de-France;60;1;11;110;Broquiers;242;0;242
32;Hauts-de-France;60;2;19;111;Broyes;172;2;174
32;Hauts-de-France;60;2;19;112;Brunvillers-la-Motte;344;1;345
32;Hauts-de-France;60;2;19;113;Bucamps;188;3;191
32;Hauts-de-France;60;1;11;114;Buicourt;145;0;145
32;Hauts-de-France;60;2;19;115;Bulles;894;16;910
32;Hauts-de-France;60;2;14;116;Bury;2971;37;3008
32;Hauts-de-France;60;3;17;117;Bussy;323;8;331
32;Hauts-de-France;60;3;17;118;Caisnes;511;9;520
32;Hauts-de-France;60;2;14;120;Cambronne-lès-Clermont;1145;23;1168
32;Hauts-de-France;60;3;21;119;Cambronne-lès-Ribécourt;1949;37;1986
32;Hauts-de-France;60;3;17;121;Campagne;161;4;165
32;Hauts-de-France;60;1;11;122;Campeaux;503;9;512
32;Hauts-de-France;60;2;19;123;Campremy;490;0;490
32;Hauts-de-France;60;3;21;124;Candor;297;4;301
32;Hauts-de-France;60;3;10;125;Canly;782;19;801
32;Hauts-de-France;60;3;21;126;Cannectancourt;510;6;516
32;Hauts-de-France;60;3;21;127;Canny-sur-Matz;392;5;397
32;Hauts-de-France;60;1;11;128;Canny-sur-Thérain;228;2;230
32;Hauts-de-France;60;3;17;129;Carlepont;1514;20;1534
32;Hauts-de-France;60;2;05;130;Catenoy;1041;23;1064
32;Hauts-de-France;60;1;19;131;Catheux;109;1;110
32;Hauts-de-France;60;3;17;132;Catigny;191;3;194
32;Hauts-de-France;60;2;19;133;Catillon-Fumechon;536;5;541
32;Hauts-de-France;60;2;16;134;Cauffry;2540;25;2565
32;Hauts-de-France;60;1;04;135;Cauvigny;1662;36;1698
32;Hauts-de-France;60;1;11;136;Cempuis;501;12;513
32;Hauts-de-France;60;2;10;137;Cernoy;297;3;300
32;Hauts-de-France;60;4;20;138;Chamant;910;29;939
32;Hauts-de-France;60;4;12;139;Chambly;10174;131;10305
32;Hauts-de-France;60;1;04;140;Chambors;315;4;319
32;Hauts-de-France;60;4;03;141;Chantilly;10863;226;11089
32;Hauts-de-France;60;4;20;142;La Chapelle-en-Serval;3141;84;3225
32;Hauts-de-France;60;1;04;143;Chaumont-en-Vexin;3269;41;3310
32;Hauts-de-France;60;1;04;144;Chavençon;172;3;175
32;Hauts-de-France;60;3;07;145;Chelles;507;14;521
32;Hauts-de-France;60;2;19;146;Chepoix;431;3;434
32;Hauts-de-France;60;3;21;147;Chevincourt;869;22;891
32;Hauts-de-France;60;4;15;148;Chèvreville;425;8;433
32;Hauts-de-France;60;3;10;149;Chevrières;1993;67;2060
32;Hauts-de-France;60;3;21;150;Chiry-Ourscamp;1199;17;1216
32;Hauts-de-France;60;3;06;151;Choisy-au-Bac;3291;103;3394
32;Hauts-de-France;60;2;10;152;Choisy-la-Victoire;236;1;237
32;Hauts-de-France;60;1;19;153;Choqueuse-les-Bénards;103;0;103
32;Hauts-de-France;60;2;18;154;Cinqueux;1556;44;1600
32;Hauts-de-France;60;4;13;155;Cires-lès-Mello;3977;50;4027
32;Hauts-de-France;60;3;06;156;Clairoix;2165;45;2210
32;Hauts-de-France;60;2;05;157;Clermont;10147;215;10362
32;Hauts-de-France;60;2;10;158;Coivrel;251;2;253
32;Hauts-de-France;60;3;99;159;Compiègne;40199;1036;41235
32;Hauts-de-France;60;3;10;160;Conchy-les-Pots;705;12;717
32;Hauts-de-France;60;1;19;161;Conteville;73;0;73
32;Hauts-de-France;60;1;04;162;Corbeil-Cerf;332;8;340
32;Hauts-de-France;60;1;19;163;Cormeilles;421;6;427
32;Hauts-de-France;60;1;04;209;La Corne en Vexin;529;13;542
32;Hauts-de-France;60;1;11;164;Le Coudray-Saint-Germer;906;10;916
32;Hauts-de-France;60;1;04;165;Le Coudray-sur-Thelle;544;19;563
32;Hauts-de-France;60;3;10;166;Coudun;1062;32;1094
32;Hauts-de-France;60;3;06;167;Couloisy;541;14;555
32;Hauts-de-France;60;2;10;168;Courcelles-Epayelles;205;3;208
32;Hauts-de-France;60;1;04;169;Courcelles-lès-Gisors;821;23;844
32;Hauts-de-France;60;4;20;170;Courteuil;602;37;639
32;Hauts-de-France;60;3;06;171;Courtieux;181;4;185
32;Hauts-de-France;60;4;03;172;Coye-la-Forêt;3931;203;4134
32;Hauts-de-France;60;4;13;173;Cramoisy;809;3;812
32;Hauts-de-France;60;3;21;174;Crapeaumesnil;202;3;205
32;Hauts-de-France;60;4;08;175;Creil;35657;227;35884
32;Hauts-de-France;60;4;09;176;Crépy-en-Valois;15090;267;15357
32;Hauts-de-France;60;2;10;177;Cressonsacq;448;8;456
32;Hauts-de-France;60;1;19;178;Crèvecœur-le-Grand;3535;142;3677
32;Hauts-de-France;60;2;10;179;Crèvecœur-le-Petit;147;2;149
32;Hauts-de-France;60;1;11;180;Crillon;491;4;495
32;Hauts-de-France;60;3;17;181;Crisolles;935;20;955
32;Hauts-de-France;60;1;19;182;Le Crocq;182;1;183
32;Hauts-de-France;60;1;19;183;Croissy-sur-Celle;266;2;268
32;Hauts-de-France;60;3;07;184;Croutoy;207;6;213
32;Hauts-de-France;60;4;03;185;Crouy-en-Thelle;1098;10;1108
32;Hauts-de-France;60;2;19;186;Cuignières;248;4;252
32;Hauts-de-France;60;1;11;187;Cuigy-en-Bray;943;13;956
32;Hauts-de-France;60;3;07;188;Cuise-la-Motte;2192;107;2299
32;Hauts-de-France;60;3;17;189;Cuts;975;21;996
32;Hauts-de-France;60;4;15;190;Cuvergnon;291;7;298
32;Hauts-de-France;60;3;10;191;Cuvilly;637;5;642
32;Hauts-de-France;60;3;21;192;Cuy;219;5;224
32;Hauts-de-France;60;1;11;193;Daméraucourt;222;1;223
32;Hauts-de-France;60;1;11;194;Dargies;253;2;255
32;Hauts-de-France;60;1;04;195;Delincourt;473;13;486
32;Hauts-de-France;60;4;12;197;Dieudonné;818;18;836
32;Hauts-de-France;60;3;21;198;Dives;401;6;407
32;Hauts-de-France;60;1;19;199;Doméliers;248;8;256
32;Hauts-de-France;60;2;10;200;Domfront;311;2;313
32;Hauts-de-France;60;2;10;201;Dompierre;240;2;242
32;Hauts-de-France;60;1;04;196;La Drenne;1001;14;1015
32;Hauts-de-France;60;4;09;203;Duvy;445;8;453
32;Hauts-de-France;60;3;21;204;Écuvilly;312;4;316
32;Hauts-de-France;60;1;11;205;Élencourt;53;1;54
32;Hauts-de-France;60;3;21;206;Élincourt-Sainte-Marguerite;862;12;874
32;Hauts-de-France;60;4;09;207;Éméville;287;6;293
32;Hauts-de-France;60;1;04;208;Énencourt-Léage;136;6;142
32;Hauts-de-France;60;2;10;210;Épineuse;244;9;253
32;Hauts-de-France;60;1;04;211;Éragny-sur-Epte;606;5;611
32;Hauts-de-France;60;4;12;212;Ercuis;1609;27;1636
32;Hauts-de-France;60;4;15;213;Ermenonville;1007;21;1028
32;Hauts-de-France;60;1;11;214;Ernemont-Boutavent;207;3;210
32;Hauts-de-France;60;2;05;215;Erquery;607;13;620
32;Hauts-de-France;60;2;19;216;Erquinvillers;183;2;185
32;Hauts-de-France;60;1;11;217;Escames;217;2;219
32;Hauts-de-France;60;1;12;218;Esches;1573;14;1587
32;Hauts-de-France;60;1;11;219;Escles-Saint-Pierre;165;3;168
32;Hauts-de-France;60;1;11;220;Espaubourg;505;5;510
32;Hauts-de-France;60;2;19;221;Esquennoy;720;7;727
32;Hauts-de-France;60;2;19;222;Essuiles;560;16;576
32;Hauts-de-France;60;3;10;223;Estrées-Saint-Denis;3752;53;3805
32;Hauts-de-France;60;4;15;224;Étavigny;152;1;153
32;Hauts-de-France;60;2;05;225;Étouy;774;40;814
32;Hauts-de-France;60;4;15;226;Ève;421;2;423
32;Hauts-de-France;60;3;21;227;Évricourt;224;2;226
32;Hauts-de-France;60;1;04;228;Fay-les-Étangs;471;8;479
32;Hauts-de-France;60;1;14;230;Le Fay-Saint-Quentin;522;8;530
32;Hauts-de-France;60;3;10;229;Le Fayel;220;0;220
32;Hauts-de-France;60;4;09;231;Feigneux;427;14;441
32;Hauts-de-France;60;2;10;232;Ferrières;480;3;483
32;Hauts-de-France;60;1;11;233;Feuquières;1404;20;1424
32;Hauts-de-France;60;2;05;234;Fitz-James;2515;28;2543
32;Hauts-de-France;60;1;02;235;Flavacourt;659;20;679
32;Hauts-de-France;60;3;17;236;Flavy-le-Meldeux;213;0;213
32;Hauts-de-France;60;2;19;237;Fléchy;95;1;96
32;Hauts-de-France;60;4;20;238;Fleurines;1907;91;1998
32;Hauts-de-France;60;1;04;239;Fleury;553;10;563
32;Hauts-de-France;60;1;19;240;Fontaine-Bonneleau;244;3;247
32;Hauts-de-France;60;4;15;241;Fontaine-Chaalis;347;16;363
32;Hauts-de-France;60;1;11;242;Fontaine-Lavaganne;507;7;514
32;Hauts-de-France;60;1;14;243;Fontaine-Saint-Lucien;168;6;174
32;Hauts-de-France;60;1;11;244;Fontenay-Torcy;124;2;126
32;Hauts-de-France;60;1;11;245;Formerie;2131;29;2160
32;Hauts-de-France;60;2;05;247;Fouilleuse;140;2;142
32;Hauts-de-France;60;1;11;248;Fouilloy;200;6;206
32;Hauts-de-France;60;4;13;249;Foulangues;198;2;200
32;Hauts-de-France;60;1;01;250;Fouquenies;430;12;442
32;Hauts-de-France;60;1;14;251;Fouquerolles;281;5;286
32;Hauts-de-France;60;2;19;252;Fournival;518;3;521
32;Hauts-de-France;60;1;19;253;Francastel;479;1;480
32;Hauts-de-France;60;3;10;254;Francières;547;16;563
32;Hauts-de-France;60;3;17;255;Fréniches;349;4;353
32;Hauts-de-France;60;1;04;257;Fresne-Léguillon;438;9;447
32;Hauts-de-France;60;3;21;258;Fresnières;164;6;170
32;Hauts-de-France;60;4;12;259;Fresnoy-en-Thelle;915;24;939
32;Hauts-de-France;60;4;09;260;Fresnoy-la-Rivière;651;20;671
32;Hauts-de-France;60;4;15;261;Fresnoy-le-Luat;503;12;515
32;Hauts-de-France;60;2;10;262;Le Frestoy-Vaux;249;6;255
32;Hauts-de-France;60;3;17;263;Frétoy-le-Château;256;3;259
32;Hauts-de-France;60;1;02;264;Frocourt;523;15;538
32;Hauts-de-France;60;2;19;265;Froissy;887;12;899
32;Hauts-de-France;60;1;19;267;Le Gallet;173;5;178
32;Hauts-de-France;60;2;19;268;Gannes;340;1;341
32;Hauts-de-France;60;1;11;269;Gaudechart;361;5;366
32;Hauts-de-France;60;3;17;270;Genvry;322;85;407
32;Hauts-de-France;60;1;11;271;Gerberoy;90;2;92
32;Hauts-de-France;60;4;09;272;Gilocourt;654;19;673
32;Hauts-de-France;60;3;10;273;Giraumont;539;19;558
32;Hauts-de-France;60;4;09;274;Glaignes;372;13;385
32;Hauts-de-France;60;1;11;275;Glatigny;228;2;230
32;Hauts-de-France;60;2;10;276;Godenvillers;228;3;231
32;Hauts-de-France;60;1;02;277;Goincourt;1390;34;1424
32;Hauts-de-France;60;3;17;278;Golancourt;391;3;394
32;Hauts-de-France;60;4;15;279;Gondreville;206;5;211
32;Hauts-de-France;60;1;11;280;Gourchelles;121;0;121
32;Hauts-de-France;60;3;10;281;Gournay-sur-Aronde;573;17;590
32;Hauts-de-France;60;4;03;282;Gouvieux;9069;402;9471
32;Hauts-de-France;60;2;19;283;Gouy-les-Groseillers;27;0;27
32;Hauts-de-France;60;3;10;284;Grandfresnoy;1773;59;1832
32;Hauts-de-France;60;3;17;287;Grandrû;348;3;351
32;Hauts-de-France;60;2;10;285;Grandvillers-aux-Bois;313;15;328
32;Hauts-de-France;60;1;11;286;Grandvilliers;2940;84;3024
32;Hauts-de-France;60;1;11;288;Grémévillers;458;5;463
32;Hauts-de-France;60;1;11;289;Grez;270;4;274
32;Hauts-de-France;60;1;14;290;Guignecourt;381;4;385
32;Hauts-de-France;60;3;17;291;Guiscard;1803;23;1826
32;Hauts-de-France;60;3;21;292;Gury;242;11;253
32;Hauts-de-France;60;1;04;293;Hadancourt-le-Haut-Clocher;366;8;374
32;Hauts-de-France;60;3;10;294;Hainvillers;80;1;81
32;Hauts-de-France;60;1;11;295;Halloy;452;9;461
32;Hauts-de-France;60;1;11;297;Le Hamel;183;2;185
32;Hauts-de-France;60;1;11;296;Hannaches;141;1;142
32;Hauts-de-France;60;1;11;298;Hanvoile;617;7;624
32;Hauts-de-France;60;2;19;299;Hardivillers;540;7;547
32;Hauts-de-France;60;1;11;301;Haucourt;138;5;143
32;Hauts-de-France;60;1;14;302;Haudivillers;812;23;835
32;Hauts-de-France;60;1;11;303;Hautbos;193;1;194
32;Hauts-de-France;60;1;11;304;Haute-Épine;272;9;281
32;Hauts-de-France;60;3;07;305;Hautefontaine;335;4;339
32;Hauts-de-France;60;1;04;054;Les Hauts Talican;875;18;893
32;Hauts-de-France;60;1;11;306;Hécourt;155;3;158
32;Hauts-de-France;60;2;14;307;Heilles;623;10;633
32;Hauts-de-France;60;3;10;308;Hémévillers;462;9;471
32;Hauts-de-France;60;1;04;309;Hénonville;827;13;840
32;Hauts-de-France;60;1;01;310;Herchies;642;27;669
32;Hauts-de-France;60;2;19;311;La Hérelle;243;4;247
32;Hauts-de-France;60;1;11;312;Héricourt-sur-Thérain;126;2;128
32;Hauts-de-France;60;1;14;313;Hermes;2498;41;2539
32;Hauts-de-France;60;1;11;314;Hétomesnil;312;5;317
32;Hauts-de-France;60;1;11;315;Hodenc-en-Bray;490;10;500
32;Hauts-de-France;60;1;04;316;Hodenc-l'Évêque;248;8;256
32;Hauts-de-France;60;2;14;317;Hondainville;708;8;716
32;Hauts-de-France;60;3;10;318;Houdancourt;671;11;682
32;Hauts-de-France;60;1;02;319;La Houssoye;612;6;618
32;Hauts-de-France;60;4;15;320;Ivors;259;3;262
32;Hauts-de-France;60;1;04;321;Ivry-le-Temple;776;7;783
32;Hauts-de-France;60;1;04;322;Jaméricourt;322;5;327
32;Hauts-de-France;60;3;06;323;Janville;681;11;692
32;Hauts-de-France;60;3;06;324;Jaulzy;903;11;914
32;Hauts-de-France;60;3;07;325;Jaux;2411;67;2478
32;Hauts-de-France;60;3;07;326;Jonquières;609;23;632
32;Hauts-de-France;60;1;04;327;Jouy-sous-Thelle;1028;17;1045
32;Hauts-de-France;60;1;14;328;Juvignies;322;10;332
32;Hauts-de-France;60;3;21;329;Laberlière;197;6;203
32;Hauts-de-France;60;1;04;330;Laboissière-en-Thelle;1347;25;1372
32;Hauts-de-France;60;1;02;331;Labosse;443;6;449
32;Hauts-de-France;60;2;05;332;Labruyère;691;10;701
32;Hauts-de-France;60;1;02;333;Lachapelle-aux-Pots;1620;35;1655
32;Hauts-de-France;60;1;04;334;Lachapelle-Saint-Pierre;919;21;940
32;Hauts-de-France;60;1;11;335;Lachapelle-sous-Gerberoy;148;1;149
32;Hauts-de-France;60;1;19;336;Lachaussée-du-Bois-d'Écu;203;3;206
32;Hauts-de-France;60;3;07;337;Lachelle;651;23;674
32;Hauts-de-France;60;3;07;338;Lacroix-Saint-Ouen;4708;152;4860
32;Hauts-de-France;60;1;14;339;Lafraye;368;9;377
32;Hauts-de-France;60;3;21;340;Lagny;527;15;542
32;Hauts-de-France;60;4;15;341;Lagny-le-Sec;2062;54;2116
32;Hauts-de-France;60;2;16;342;Laigneville;4719;53;4772
32;Hauts-de-France;60;1;02;343;Lalande-en-Son;653;25;678
32;Hauts-de-France;60;1;02;344;Lalandelle;480;9;489
32;Hauts-de-France;60;2;05;345;Lamécourt;191;2;193
32;Hauts-de-France;60;4;03;346;Lamorlaye;8881;236;9117
32;Hauts-de-France;60;1;11;347;Lannoy-Cuillère;282;5;287
32;Hauts-de-France;60;3;17;348;Larbroye;510;9;519
32;Hauts-de-France;60;3;21;350;Lassigny;1399;24;1423
32;Hauts-de-France;60;3;10;351;Lataule;117;2;119
32;Hauts-de-France;60;1;04;352;Lattainville;150;1;151
32;Hauts-de-France;60;1;11;353;Lavacquerie;207;1;208
32;Hauts-de-France;60;1;11;354;Laverrière;38;1;39
32;Hauts-de-France;60;1;14;355;Laversines;1168;52;1220
32;Hauts-de-France;60;1;04;356;Lavilletertre;534;16;550
32;Hauts-de-France;60;2;10;357;Léglantiers;551;5;556
32;Hauts-de-France;60;4;15;358;Lévignen;972;23;995
32;Hauts-de-France;60;1;11;359;Lhéraule;189;2;191
32;Hauts-de-France;60;2;05;360;Liancourt;6880;61;6941
32;Hauts-de-France;60;1;04;361;Liancourt-Saint-Pierre;595;20;615
32;Hauts-de-France;60;3;17;362;Libermont;182;6;188
32;Hauts-de-France;60;1;04;363;Lierville;227;1;228
32;Hauts-de-France;60;2;19;364;Lieuvillers;709;8;717
32;Hauts-de-France;60;1;11;365;Lihus;410;4;414
32;Hauts-de-France;60;2;14;366;Litz;356;5;361
32;Hauts-de-France;60;1;04;367;Loconville;336;8;344
32;Hauts-de-France;60;3;21;368;Longueil-Annel;2622;60;2682
32;Hauts-de-France;60;3;10;369;Longueil-Sainte-Marie;1919;35;1954
32;Hauts-de-France;60;1;12;370;Lormaison;1306;15;1321
32;Hauts-de-France;60;1;11;371;Loueuse;150;1;151
32;Hauts-de-France;60;1;19;372;Luchy;642;15;657
32;Hauts-de-France;60;3;21;373;Machemont;718;17;735
32;Hauts-de-France;60;2;10;374;Maignelay-Montigny;2699;32;2731
32;Hauts-de-France;60;2;05;375;Maimbeville;414;10;424
32;Hauts-de-France;60;1;14;376;Maisoncelle-Saint-Pierre;161;1;162
32;Hauts-de-France;60;2;19;377;Maisoncelle-Tuilerie;301;2;303
32;Hauts-de-France;60;1;02;703;Aux Marais;847;16;863
32;Hauts-de-France;60;3;21;378;Marest-sur-Matz;406;5;411
32;Hauts-de-France;60;3;21;379;Mareuil-la-Motte;641;16;657
32;Hauts-de-France;60;4;15;380;Mareuil-sur-Ourcq;1613;24;1637
32;Hauts-de-France;60;3;21;381;Margny-aux-Cerises;261;1;262
32;Hauts-de-France;60;3;06;382;Margny-lès-Compiègne;8370;174;8544
32;Hauts-de-France;60;3;10;383;Margny-sur-Matz;536;12;548
32;Hauts-de-France;60;4;15;385;Marolles;680;14;694
32;Hauts-de-France;60;3;10;386;Marquéglise;491;9;500
32;Hauts-de-France;60;1;11;387;Marseille-en-Beauvaisis;1482;9;1491
32;Hauts-de-France;60;1;11;388;Martincourt;128;1;129
32;Hauts-de-France;60;3;17;389;Maucourt;249;2;251
32;Hauts-de-France;60;1;19;390;Maulers;316;6;322
32;Hauts-de-France;60;4;13;391;Maysel;249;3;252
32;Hauts-de-France;60;3;21;392;Mélicocq;740;16;756
32;Hauts-de-France;60;4;13;393;Mello;638;18;656
32;Hauts-de-France;60;2;10;394;Ménévillers;104;1;105
32;Hauts-de-France;60;1;12;395;Méru;14614;186;14800
32;Hauts-de-France;60;2;10;396;Méry-la-Bataille;629;5;634
32;Hauts-de-France;60;1;11;397;Le Mesnil-Conteville;84;1;85
32;Hauts-de-France;60;4;03;398;Le Mesnil-en-Thelle;2229;30;2259
32;Hauts-de-France;60;2;19;399;Le Mesnil-Saint-Firmin;204;61;265
32;Hauts-de-France;60;2;19;400;Le Mesnil-sur-Bulles;266;8;274
32;Hauts-de-France;60;1;04;401;Le Mesnil-Théribus;794;48;842
32;Hauts-de-France;60;3;07;402;Le Meux;2270;59;2329
32;Hauts-de-France;60;1;01;403;Milly-sur-Thérain;1708;31;1739
32;Hauts-de-France;60;2;16;404;Mogneville;1515;37;1552
32;Hauts-de-France;60;1;11;405;Moliens;1158;16;1174
32;Hauts-de-France;60;2;18;406;Monceaux;825;16;841
32;Hauts-de-France;60;1;11;407;Monceaux-l'Abbaye;227;2;229
32;Hauts-de-France;60;3;10;408;Monchy-Humières;769;13;782
32;Hauts-de-France;60;2;16;409;Monchy-Saint-Éloi;2214;40;2254
32;Hauts-de-France;60;3;17;410;Mondescourt;243;3;246
32;Hauts-de-France;60;1;04;411;Monneville;823;12;835
32;Hauts-de-France;60;4;20;421;Mont-l'Évêque;397;7;404
32;Hauts-de-France;60;1;01;428;Le Mont-Saint-Adrien;647;27;674
32;Hauts-de-France;60;1;04;412;Montagny-en-Vexin;669;12;681
32;Hauts-de-France;60;4;15;413;Montagny-Sainte-Félicité;417;9;426
32;Hauts-de-France;60;4;13;414;Montataire;13263;156;13419
32;Hauts-de-France;60;1;04;256;Montchevreuil;1283;26;1309
32;Hauts-de-France;60;4;18;415;Montépilloy;138;9;147
32;Hauts-de-France;60;2;10;416;Montgérain;183;1;184
32;Hauts-de-France;60;2;10;418;Montiers;427;8;435
32;Hauts-de-France;60;1;04;420;Montjavoult;483;11;494
32;Hauts-de-France;60;4;15;422;Montlognon;196;11;207
32;Hauts-de-France;60;3;21;423;Montmacq;1082;24;1106
32;Hauts-de-France;60;3;10;424;Montmartin;262;4;266
32;Hauts-de-France;60;2;19;425;Montreuil-sur-Brêche;488;17;505
32;Hauts-de-France;60;1;04;426;Montreuil-sur-Thérain;245;2;247
32;Hauts-de-France;60;1;04;427;Monts;166;4;170
32;Hauts-de-France;60;4;03;429;Morangles;392;13;405
32;Hauts-de-France;60;4;09;430;Morienval;1078;13;1091
32;Hauts-de-France;60;3;17;431;Morlincourt;538;11;549
32;Hauts-de-France;60;4;20;432;Mortefontaine;854;29;883
32;Hauts-de-France;60;1;04;433;Mortefontaine-en-Thelle;913;19;932
32;Hauts-de-France;60;3;10;434;Mortemer;224;6;230
32;Hauts-de-France;60;1;11;435;Morvillers;476;4;480
32;Hauts-de-France;60;2;19;436;Mory-Montcrux;83;2;85
32;Hauts-de-France;60;1;04;437;Mouchy-le-Châtel;82;0;82
32;Hauts-de-France;60;3;06;438;Moulin-sous-Touvent;213;5;218
32;Hauts-de-France;60;2;14;439;Mouy;5288;75;5363
32;Hauts-de-France;60;2;10;440;Moyenneville;630;12;642
32;Hauts-de-France;60;3;10;441;Moyvillers;679;7;686
32;Hauts-de-France;60;1;19;442;Muidorge;141;2;143
32;Hauts-de-France;60;3;17;443;Muirancourt;571;4;575
32;Hauts-de-France;60;1;11;444;Mureaumont;153;4;157
32;Hauts-de-France;60;3;06;445;Nampcel;317;3;320
32;Hauts-de-France;60;4;15;446;Nanteuil-le-Haudouin;4296;38;4334
32;Hauts-de-France;60;4;09;447;Néry;661;14;675
32;Hauts-de-France;60;4;15;448;Neufchelles;377;6;383
32;Hauts-de-France;60;3;10;449;Neufvy-sur-Aronde;279;4;283
32;Hauts-de-France;60;4;12;450;Neuilly-en-Thelle;3655;42;3697
32;Hauts-de-France;60;2;14;451;Neuilly-sous-Clermont;1673;30;1703
32;Hauts-de-France;60;1;04;452;Neuville-Bosc;510;14;524
32;Hauts-de-France;60;2;14;454;La Neuville-en-Hez;972;31;1003
32;Hauts-de-France;60;2;10;456;La Neuville-Roy;952;15;967
32;Hauts-de-France;60;2;19;457;La Neuville-Saint-Pierre;158;2;160
32;Hauts-de-France;60;1;11;458;La Neuville-sur-Oudeuil;326;7;333
32;Hauts-de-France;60;3;10;459;La Neuville-sur-Ressons;212;3;215
32;Hauts-de-France;60;1;11;460;La Neuville-Vault;191;8;199
32;Hauts-de-France;60;1;14;461;Nivillers;188;24;212
32;Hauts-de-France;60;1;04;462;Noailles;2826;42;2868
32;Hauts-de-France;60;4;16;463;Nogent-sur-Oise;20033;362;20395
32;Hauts-de-France;60;2;05;464;Nointel;1029;15;1044
32;Hauts-de-France;60;2;19;465;Noirémont;179;6;185
32;Hauts-de-France;60;2;19;466;Noroy;234;3;237
32;Hauts-de-France;60;2;19;468;Nourard-le-Franc;339;4;343
32;Hauts-de-France;60;1;04;469;Novillers;364;9;373
32;Hauts-de-France;60;2;19;470;Noyers-Saint-Martin;863;13;876
32;Hauts-de-France;60;3;17;471;Noyon;13519;312;13831
32;Hauts-de-France;60;1;11;472;Offoy;117;1;118
32;Hauts-de-France;60;4;15;473;Ognes;294;1;295
32;Hauts-de-France;60;3;21;474;Ognolles;287;6;293
32;Hauts-de-France;60;1;11;476;Omécourt;198;8;206
32;Hauts-de-France;60;1;02;477;Ons-en-Bray;1399;37;1436
32;Hauts-de-France;60;4;15;478;Ormoy-le-Davien;343;8;351
32;Hauts-de-France;60;4;15;479;Ormoy-Villers;644;10;654
32;Hauts-de-France;60;1;14;480;Oroër;556;17;573
32;Hauts-de-France;60;4;09;481;Orrouy;595;13;608
32;Hauts-de-France;60;4;20;482;Orry-la-Ville;3345;89;3434
32;Hauts-de-France;60;3;10;483;Orvillers-Sorel;519;59;578
32;Hauts-de-France;60;1;11;484;Oudeuil;263;10;273
32;Hauts-de-France;60;2;19;485;Oursel-Maison;240;5;245
32;Hauts-de-France;60;2;19;486;Paillart;580;10;590
32;Hauts-de-France;60;1;04;487;Parnes;341;13;354
32;Hauts-de-France;60;3;17;488;Passel;282;6;288
32;Hauts-de-France;60;4;15;489;Péroy-les-Gombries;1137;14;1151
32;Hauts-de-France;60;1;01;490;Pierrefitte-en-Beauvaisis;365;12;377
32;Hauts-de-France;60;3;07;491;Pierrefonds;1808;209;2017
32;Hauts-de-France;60;3;21;492;Pimprez;868;19;887
32;Hauts-de-France;60;1;11;493;Pisseleu;500;7;507
32;Hauts-de-France;60;4;20;494;Plailly;1787;41;1828
32;Hauts-de-France;60;2;19;495;Plainval;403;4;407
32;Hauts-de-France;60;2;19;496;Plainville;161;1;162
32;Hauts-de-France;60;2;19;497;Le Plessier-sur-Bulles;214;0;214
32;Hauts-de-France;60;2;19;498;Le Plessier-sur-Saint-Just;514;3;517
32;Hauts-de-France;60;4;15;500;Le Plessis-Belleville;3408;51;3459
32;Hauts-de-France;60;3;21;501;Le Plessis-Brion;1365;32;1397
32;Hauts-de-France;60;3;21;499;Plessis-de-Roye;233;5;238
32;Hauts-de-France;60;3;17;502;Le Plessis-Patte-d'Oie;102;4;106
32;Hauts-de-France;60;2;10;503;Le Ployron;113;1;114
32;Hauts-de-France;60;1;04;504;Ponchon;1113;18;1131
32;Hauts-de-France;60;3;17;506;Pont-l'Évêque;672;12;684
32;Hauts-de-France;60;4;18;509;Pont-Sainte-Maxence;12209;113;12322
32;Hauts-de-France;60;4;20;505;Pontarmé;817;20;837
32;Hauts-de-France;60;3;17;507;Pontoise-lès-Noyon;459;10;469
32;Hauts-de-France;60;4;18;508;Pontpoint;3268;67;3335
32;Hauts-de-France;60;1;02;510;Porcheux;609;5;614
32;Hauts-de-France;60;3;17;511;Porquéricourt;393;4;397
32;Hauts-de-France;60;1;04;512;Pouilly;156;2;158
32;Hauts-de-France;60;4;13;513;Précy-sur-Oise;3205;73;3278
32;Hauts-de-France;60;1;11;514;Prévillers;232;0;232
32;Hauts-de-France;60;2;10;515;Pronleroy;382;11;393
32;Hauts-de-France;60;1;11;516;Puiseux-en-Bray;420;3;423
32;Hauts-de-France;60;4;12;517;Puiseux-le-Hauberger;851;11;862
32;Hauts-de-France;60;2;19;518;Puits-la-Vallée;203;4;207
32;Hauts-de-France;60;3;17;519;Quesmy;181;4;185
32;Hauts-de-France;60;2;19;520;Le Quesnel-Aubry;213;8;221
32;Hauts-de-France;60;1;11;521;Quincampoix-Fleuzy;396;16;412
32;Hauts-de-France;60;2;19;522;Quinquempoix;322;3;325
32;Hauts-de-France;60;1;02;523;Rainvillers;927;24;951
32;Hauts-de-France;60;2;05;524;Rantigny;2506;22;2528
32;Hauts-de-France;60;4;18;525;Raray;144;6;150
32;Hauts-de-France;60;2;19;526;Ravenel;1098;13;1111
32;Hauts-de-France;60;4;15;527;Réez-Fosse-Martin;149;4;153
32;Hauts-de-France;60;1;04;528;Reilly;126;2;128
32;Hauts-de-France;60;2;05;529;Rémécourt;79;0;79
32;Hauts-de-France;60;2;14;530;Rémérangles;216;9;225
32;Hauts-de-France;60;3;10;531;Remy;1836;37;1873
32;Hauts-de-France;60;3;10;533;Ressons-sur-Matz;1687;23;1710
32;Hauts-de-France;60;3;06;534;Rethondes;656;24;680
32;Hauts-de-France;60;2;19;535;Reuil-sur-Brêche;329;6;335
32;Hauts-de-France;60;4;18;536;Rhuis;140;8;148
32;Hauts-de-France;60;3;21;537;Ribécourt-Dreslincourt;3748;174;3922
32;Hauts-de-France;60;3;10;538;Ricquebourg;285;4;289
32;Hauts-de-France;60;2;18;539;Rieux;1567;21;1588
32;Hauts-de-France;60;3;10;540;Rivecourt;595;14;609
32;Hauts-de-France;60;4;18;541;Roberval;367;12;379
32;Hauts-de-France;60;1;14;542;Rochy-Condé;990;16;1006
32;Hauts-de-France;60;4;09;543;Rocquemont;121;2;123
32;Hauts-de-France;60;2;19;544;Rocquencourt;197;1;198
32;Hauts-de-France;60;1;11;545;Romescamps;547;8;555
32;Hauts-de-France;60;4;15;546;Rosières;137;3;140
32;Hauts-de-France;60;2;05;547;Rosoy;632;13;645
32;Hauts-de-France;60;4;15;548;Rosoy-en-Multien;567;7;574
32;Hauts-de-France;60;1;19;549;Rotangy;213;1;214
32;Hauts-de-France;60;1;11;550;Rothois;226;0;226
32;Hauts-de-France;60;2;13;551;Rousseloy;314;5;319
32;Hauts-de-France;60;4;15;552;Rouville;254;9;263
32;Hauts-de-France;60;2;10;553;Rouvillers;276;7;283
32;Hauts-de-France;60;4;15;554;Rouvres-en-Multien;465;10;475
32;Hauts-de-France;60;2;19;555;Rouvroy-les-Merles;54;0;54
32;Hauts-de-France;60;1;11;557;Roy-Boissy;318;5;323
32;Hauts-de-France;60;2;10;556;Royaucourt;209;3;212
32;Hauts-de-France;60;3;21;558;Roye-sur-Matz;466;11;477
32;Hauts-de-France;60;2;14;559;La Rue-Saint-Pierre;809;10;819
32;Hauts-de-France;60;4;18;560;Rully;720;40;760
32;Hauts-de-France;60;4;09;561;Russy-Bémont;200;6;206
32;Hauts-de-France;60;2;18;562;Sacy-le-Grand;1542;27;1569
32;Hauts-de-France;60;2;18;563;Sacy-le-Petit;552;7;559
32;Hauts-de-France;60;2;10;564;Sains-Morainvillers;273;3;276
32;Hauts-de-France;60;2;19;565;Saint-André-Farivillers;514;4;518
32;Hauts-de-France;60;1;11;566;Saint-Arnoult;217;4;221
32;Hauts-de-France;60;1;02;567;Saint-Aubin-en-Bray;1140;26;1166
32;Hauts-de-France;60;2;05;568;Saint-Aubin-sous-Erquery;336;5;341
32;Hauts-de-France;60;3;06;569;Saint-Crépin-aux-Bois;215;10;225
32;Hauts-de-France;60;1;04;570;Saint-Crépin-Ibouvillers;1533;34;1567
32;Hauts-de-France;60;1;11;571;Saint-Deniscourt;86;3;89
32;Hauts-de-France;60;3;07;572;Saint-Étienne-Roilaye;310;9;319
32;Hauts-de-France;60;2;14;574;Saint-Félix;631;7;638
32;Hauts-de-France;60;1;01;576;Saint-Germain-la-Poterie;477;12;489
32;Hauts-de-France;60;1;11;577;Saint-Germer-de-Fly;1712;35;1747
32;Hauts-de-France;60;3;07;579;Saint-Jean-aux-Bois;315;14;329
32;Hauts-de-France;60;2;19;581;Saint-Just-en-Chaussée;6013;46;6059
32;Hauts-de-France;60;3;21;582;Saint-Léger-aux-Bois;795;16;811
32;Hauts-de-France;60;1;02;583;Saint-Léger-en-Bray;349;12;361
32;Hauts-de-France;60;4;13;584;Saint-Leu-d'Esserent;4688;100;4788
32;Hauts-de-France;60;2;10;585;Saint-Martin-aux-Bois;287;5;292
32;Hauts-de-France;60;1;02;586;Saint-Martin-le-Nœud;1040;22;1062
32;Hauts-de-France;60;2;18;587;Saint-Martin-Longueau;1492;29;1521
32;Hauts-de-France;60;1;11;588;Saint-Maur;383;5;388
32;Hauts-de-France;60;4;03;589;Saint-Maximin;2938;111;3049
32;Hauts-de-France;60;1;11;590;Saint-Omer-en-Chaussée;1249;25;1274
32;Hauts-de-France;60;1;02;591;Saint-Paul;1531;61;1592
32;Hauts-de-France;60;1;11;592;Saint-Pierre-es-Champs;712;8;720
32;Hauts-de-France;60;3;06;593;Saint-Pierre-lès-Bitry;147;3;150
32;Hauts-de-France;60;1;11;594;Saint-Quentin-des-Prés;283;6;289
32;Hauts-de-France;60;2;19;595;Saint-Remy-en-l'Eau;416;3;419
32;Hauts-de-France;60;1;11;596;Saint-Samson-la-Poterie;250;2;252
32;Hauts-de-France;60;3;07;597;Saint-Sauveur;1734;30;1764
32;Hauts-de-France;60;1;04;598;Saint-Sulpice;1020;100;1120
32;Hauts-de-France;60;1;11;599;Saint-Thibault;298;5;303
32;Hauts-de-France;60;4;09;600;Saint-Vaast-de-Longmont;647;7;654
32;Hauts-de-France;60;4;13;601;Saint-Vaast-lès-Mello;1074;17;1091
32;Hauts-de-France;60;1;11;602;Saint-Valery;65;1;66
32;Hauts-de-France;60;2;19;573;Sainte-Eusoye;321;2;323
32;Hauts-de-France;60;1;04;575;Sainte-Geneviève;3230;43;3273
32;Hauts-de-France;60;4;09;578;Saintines;1077;17;1094
32;Hauts-de-France;60;3;17;603;Salency;890;21;911
32;Hauts-de-France;60;1;11;604;Sarcus;265;2;267
32;Hauts-de-France;60;1;11;605;Sarnois;348;6;354
32;Hauts-de-France;60;1;19;608;Le Saulchoy;100;1;101
32;Hauts-de-France;60;1;01;609;Savignies;844;23;867
32;Hauts-de-France;60;3;17;610;Sempigny;789;13;802
32;Hauts-de-France;60;1;11;611;Senantes;621;18;639
32;Hauts-de-France;60;4;20;612;Senlis;14277;601;14878
32;Hauts-de-France;60;1;04;613;Senots;347;6;353
32;Hauts-de-France;60;1;04;614;Serans;222;2;224
32;Hauts-de-France;60;2;19;615;Sérévillers;136;3;139
32;Hauts-de-France;60;1;02;616;Sérifontaine;2755;33;2788
32;Hauts-de-France;60;3;17;617;Sermaize;257;4;261
32;Hauts-de-France;60;4;09;618;Séry-Magneval;282;9;291
32;Hauts-de-France;60;4;15;619;Silly-le-Long;1160;26;1186
32;Hauts-de-France;60;1;04;620;Silly-Tillard;440;7;447
32;Hauts-de-France;60;3;21;621;Solente;138;1;139
32;Hauts-de-France;60;1;11;622;Sommereux;482;6;488
32;Hauts-de-France;60;1;11;623;Songeons;1073;56;1129
32;Hauts-de-France;60;1;11;624;Sully;170;4;174
32;Hauts-de-France;60;3;17;625;Suzoy;568;12;580
32;Hauts-de-France;60;1;11;626;Talmontiers;683;12;695
32;Hauts-de-France;60;2;19;627;Tartigny;274;3;277
32;Hauts-de-France;60;1;14;628;Therdonne;1063;23;1086
32;Hauts-de-France;60;1;11;629;Thérines;202;9;211
32;Hauts-de-France;60;1;04;630;Thibivillers;165;7;172
32;Hauts-de-France;60;4;20;631;Thiers-sur-Thève;1059;23;1082
32;Hauts-de-France;60;3;21;632;Thiescourt;754;16;770
32;Hauts-de-France;60;1;11;633;Thieuloy-Saint-Antoine;410;2;412
32;Hauts-de-France;60;2;19;634;Thieux;439;11;450
32;Hauts-de-France;60;4;13;635;Thiverny;1065;10;1075
32;Hauts-de-France;60;3;21;636;Thourotte;4558;74;4632
32;Hauts-de-France;60;4;15;637;Thury-en-Valois;493;5;498
32;Hauts-de-France;60;2;14;638;Thury-sous-Clermont;679;9;688
32;Hauts-de-France;60;1;14;639;Tillé;1169;23;1192
32;Hauts-de-France;60;1;04;640;Tourly;175;1;176
32;Hauts-de-France;60;3;06;641;Tracy-le-Mont;1735;27;1762
32;Hauts-de-France;60;3;21;642;Tracy-le-Val;1095;32;1127
32;Hauts-de-France;60;2;10;643;Tricot;1422;15;1437
32;Hauts-de-France;60;1;04;644;Trie-Château;1943;31;1974
32;Hauts-de-France;60;1;04;645;Trie-la-Ville;310;5;315
32;Hauts-de-France;60;1;14;646;Troissereux;1232;33;1265
32;Hauts-de-France;60;3;06;647;Trosly-Breuil;2081;52;2133
32;Hauts-de-France;60;2;19;648;Troussencourt;332;4;336
32;Hauts-de-France;60;4;09;650;Trumilly;528;25;553
32;Hauts-de-France;60;4;13;651;Ully-Saint-Georges;1869;30;1899
32;Hauts-de-France;60;1;04;652;Valdampierre;936;11;947
32;Hauts-de-France;60;2;19;653;Valescourt;291;2;293
32;Hauts-de-France;60;3;21;654;Vandélicourt;276;5;281
32;Hauts-de-France;60;3;17;655;Varesnes;368;10;378
32;Hauts-de-France;60;4;15;656;Varinfroy;290;3;293
32;Hauts-de-France;60;3;17;657;Vauchelles;265;5;270
32;Hauts-de-France;60;4;09;658;Vauciennes;682;9;691
32;Hauts-de-France;60;1;04;659;Vaudancourt;170;2;172
32;Hauts-de-France;60;1;02;660;Le Vaumain;372;10;382
32;Hauts-de-France;60;4;09;661;Vaumoise;985;84;1069
32;Hauts-de-France;60;1;02;662;Le Vauroux;504;13;517
32;Hauts-de-France;60;1;14;663;Velennes;241;3;244
32;Hauts-de-France;60;2;19;664;Vendeuil-Caply;470;10;480
32;Hauts-de-France;60;3;07;665;Venette;2857;60;2917
32;Hauts-de-France;60;4;15;666;Ver-sur-Launette;1159;27;1186
32;Hauts-de-France;60;4;09;667;Verberie;3848;52;3900
32;Hauts-de-France;60;1;14;668;Verderel-lès-Sauqueuse;736;23;759
32;Hauts-de-France;60;2;05;669;Verderonne;486;14;500
32;Hauts-de-France;60;4;08;670;Verneuil-en-Halatte;4650;97;4747
32;Hauts-de-France;60;4;15;671;Versigny;380;15;395
32;Hauts-de-France;60;4;09;672;Vez;283;13;296
32;Hauts-de-France;60;1;19;673;Viefvillers;193;1;194
32;Hauts-de-France;60;3;07;674;Vieux-Moulin;644;43;687
32;Hauts-de-France;60;3;10;675;Vignemont;434;6;440
32;Hauts-de-France;60;3;17;676;Ville;762;16;778
32;Hauts-de-France;60;1;11;677;Villembray;256;3;259
32;Hauts-de-France;60;1;12;678;Villeneuve-les-Sablons;1188;16;1204
32;Hauts-de-France;60;4;15;679;La Villeneuve-sous-Thury;164;5;169
32;Hauts-de-France;60;4;18;680;Villeneuve-sur-Verberie;636;17;653
32;Hauts-de-France;60;1;02;681;Villers-Saint-Barthélemy;480;18;498
32;Hauts-de-France;60;4;18;682;Villers Saint Frambourg-Ognon;714;38;752
32;Hauts-de-France;60;4;15;683;Villers-Saint-Genest;389;16;405
32;Hauts-de-France;60;4;16;684;Villers-Saint-Paul;6422;67;6489
32;Hauts-de-France;60;1;04;685;Villers-Saint-Sépulcre;1002;9;1011
32;Hauts-de-France;60;4;13;686;Villers-sous-Saint-Leu;2335;57;2392
32;Hauts-de-France;60;1;11;687;Villers-sur-Auchy;374;9;383
32;Hauts-de-France;60;1;11;688;Villers-sur-Bonnières;164;1;165
32;Hauts-de-France;60;3;10;689;Villers-sur-Coudun;1407;58;1465
32;Hauts-de-France;60;1;11;691;Villers-Vermont;124;5;129
32;Hauts-de-France;60;2;19;692;Villers-Vicomte;151;2;153
32;Hauts-de-France;60;3;17;693;Villeselve;421;4;425
32;Hauts-de-France;60;4;20;695;Vineuil-Saint-Firmin;1413;46;1459
32;Hauts-de-France;60;1;11;697;Vrocourt;33;1;34
32;Hauts-de-France;60;2;10;698;Wacquemoulin;300;10;310
32;Hauts-de-France;60;1;11;699;Wambez;164;5;169
32;Hauts-de-France;60;1;02;700;Warluis;1157;32;1189
32;Hauts-de-France;60;2;19;701;Wavignies;1212;12;1224
32;Hauts-de-France;60;2;10;702;Welles-Pérennes;255;3;258
28;Normandie;61;3;01;214;L' Aigle;8090;208;8298
28;Normandie;61;1;97;001;Alençon;25848;744;26592
28;Normandie;61;1;19;002;Almenêches;716;7;723
28;Normandie;61;3;09;005;Appenai-sous-Bellême;276;6;282
28;Normandie;61;2;98;006;Argentan;13823;385;14208
28;Normandie;61;3;20;422;Les Aspres;631;14;645
28;Normandie;61;2;06;007;Athis-Val de Rouvre;4256;87;4343
28;Normandie;61;3;18;008;Aube;1298;37;1335
28;Normandie;61;3;21;010;Aubry-le-Panthou;115;6;121
28;Normandie;61;2;14;011;Aubusson;431;20;451
28;Normandie;61;3;20;012;Auguaise;207;6;213
28;Normandie;61;1;17;013;Aunay-les-Bois;145;0;145
28;Normandie;61;2;04;014;Aunou-le-Faucon;246;9;255
28;Normandie;61;1;19;015;Aunou-sur-Orne;266;7;273
28;Normandie;61;3;18;017;Les Authieux-du-Puits;73;0;73
28;Normandie;61;3;21;018;Avernes-Saint-Gourgon;56;5;61
28;Normandie;61;2;15;020;Avoine;218;7;225
28;Normandie;61;2;11;021;Avrilly;107;3;110
28;Normandie;61;1;89;483;Bagnoles de l'Orne Normandie;2693;51;2744
28;Normandie;61;2;05;023;Bailleul;608;17;625
28;Normandie;61;2;12;024;Banvou;615;14;629
28;Normandie;61;1;17;026;Barville;191;9;200
28;Normandie;61;2;06;028;Bazoches-au-Houlme;468;11;479
28;Normandie;61;3;16;029;Bazoches-sur-Hoëne;861;23;884
28;Normandie;61;2;13;030;La Bazoque;265;4;269
28;Normandie;61;3;18;032;Beaufai;342;8;350
28;Normandie;61;3;20;034;Beaulieu;211;8;219
28;Normandie;61;1;12;035;Beauvain;271;2;273
28;Normandie;61;1;19;036;Belfonds;205;0;205
28;Normandie;61;3;09;196;Belforêt-en-Perche;1678;43;1721
28;Normandie;61;3;16;037;Bellavilliers;139;3;142
28;Normandie;61;3;09;038;Bellême;1464;19;1483
28;Normandie;61;1;19;039;La Bellière;125;1;126
28;Normandie;61;2;12;040;Bellou-en-Houlme;1117;29;1146
28;Normandie;61;3;09;041;Bellou-le-Trichard;214;3;217
28;Normandie;61;3;08;043;Berd'huis;1111;31;1142
28;Normandie;61;2;06;044;Berjou;461;16;477
28;Normandie;61;3;20;046;Bizou;130;3;133
28;Normandie;61;3;16;048;Boëcé;124;5;129
28;Normandie;61;2;04;375;Boischampré;1199;36;1235
28;Normandie;61;1;19;049;Boissei-la-Lande;124;2;126
28;Normandie;61;1;19;051;Boitron;354;6;360
28;Normandie;61;3;20;052;Bonnefoi;185;5;190
28;Normandie;61;3;20;053;Bonsmoulins;240;8;248
28;Normandie;61;3;21;054;Le Bosc-Renoult;249;4;253
28;Normandie;61;2;15;055;Boucé;615;12;627
28;Normandie;61;1;19;056;Le Bouillon;171;1;172
28;Normandie;61;3;20;060;Brethel;164;1;165
28;Normandie;61;3;08;061;Bretoncelles;1487;30;1517
28;Normandie;61;2;04;062;Brieux;90;2;92
28;Normandie;61;2;06;063;Briouze;1534;71;1605
28;Normandie;61;1;17;064;Brullemail;95;3;98
28;Normandie;61;1;17;066;Buré;111;1;112
28;Normandie;61;1;17;067;Bures;165;5;170
28;Normandie;61;1;17;068;Bursard;214;3;217
28;Normandie;61;2;06;069;Cahan;181;3;184
28;Normandie;61;2;13;070;Caligny;827;26;853
28;Normandie;61;3;21;071;Camembert;187;5;192
28;Normandie;61;3;21;072;Canapville;206;4;210
28;Normandie;61;1;15;074;Carrouges;672;12;684
28;Normandie;61;1;07;075;Ceaucé;1182;27;1209
28;Normandie;61;1;19;076;Le Cercueil;137;6;143
28;Normandie;61;1;02;077;Cerisé;863;23;886
28;Normandie;61;2;13;078;Cerisy-Belle-Étoile;724;47;771
28;Normandie;61;3;09;079;Ceton;1785;25;1810
28;Normandie;61;1;15;080;Chahains;86;2;88
28;Normandie;61;1;19;081;Chailloué;897;26;923
28;Normandie;61;1;17;082;Le Chalange;98;4;102
28;Normandie;61;1;15;085;Le Champ-de-la-Pierre;41;0;41
28;Normandie;61;3;18;088;Champ-Haut;50;0;50
28;Normandie;61;2;06;084;Champcerie;160;7;167
28;Normandie;61;3;21;086;Les Champeaux;116;0;116
28;Normandie;61;3;16;087;Champeaux-sur-Sarthe;167;5;172
28;Normandie;61;3;21;089;Champosoult;97;0;97
28;Normandie;61;2;11;091;Champsecret;895;19;914
28;Normandie;61;3;01;092;Chandai;664;7;671
28;Normandie;61;2;11;093;Chanu;1257;17;1274
28;Normandie;61;2;13;094;La Chapelle-au-Moine;587;17;604
28;Normandie;61;2;13;095;La Chapelle-Biche;527;8;535
28;Normandie;61;3;16;097;La Chapelle-Montligeon;520;15;535
28;Normandie;61;1;19;098;La Chapelle-près-Sées;449;31;480
28;Normandie;61;3;09;099;La Chapelle-Souëf;255;8;263
28;Normandie;61;3;20;100;La Chapelle-Viel;272;9;281
28;Normandie;61;3;20;429;Charencey;797;32;829
28;Normandie;61;1;19;101;Le Château-d'Almenêches;205;9;214
28;Normandie;61;2;13;102;Le Châtellier;411;8;419
28;Normandie;61;3;21;103;Chaumont;177;1;178
28;Normandie;61;1;15;104;La Chaux;53;1;54
28;Normandie;61;3;09;105;Chemilli;200;1;201
28;Normandie;61;1;15;107;Ciral;394;11;405
28;Normandie;61;3;21;108;Cisai-Saint-Aubin;153;5;158
28;Normandie;61;1;10;111;Colombiers;335;13;348
28;Normandie;61;3;16;113;Comblot;64;1;65
28;Normandie;61;2;04;114;Commeaux;154;4;158
28;Normandie;61;1;10;117;Condé-sur-Sarthe;2507;46;2553
28;Normandie;61;3;16;118;Corbon;137;6;143
28;Normandie;61;2;05;120;Coudehard;78;0;78
28;Normandie;61;3;16;121;Coulimer;293;8;301
28;Normandie;61;3;21;122;Coulmer;85;1;86
28;Normandie;61;2;05;123;Coulonces;224;5;229
28;Normandie;61;2;12;124;La Coulonche;493;19;512
28;Normandie;61;1;17;126;Coulonges-sur-Sarthe;543;9;552
28;Normandie;61;3;08;050;Cour-Maugis sur Huisne;610;24;634
28;Normandie;61;3;16;129;Courgeon;372;11;383
28;Normandie;61;3;16;130;Courgeoût;451;13;464
28;Normandie;61;1;17;133;Courtomer;702;16;718
28;Normandie;61;2;06;137;Craménil;148;5;153
28;Normandie;61;3;21;138;Croisilles;207;4;211
28;Normandie;61;3;21;139;Crouttes;306;11;317
28;Normandie;61;3;20;140;Crulai;858;15;873
28;Normandie;61;1;10;141;Cuissai;418;18;436
28;Normandie;61;3;09;142;Dame-Marie;144;4;148
28;Normandie;61;1;10;143;Damigny;2568;65;2633
28;Normandie;61;2;11;145;Domfront en Poiraie;4243;127;4370
28;Normandie;61;2;12;146;Dompierre;406;3;409
28;Normandie;61;2;06;148;Durcet;312;5;317
28;Normandie;61;2;12;149;Échalou;389;9;398
28;Normandie;61;3;18;150;Échauffour;742;12;754
28;Normandie;61;3;18;151;Écorcei;390;12;402
28;Normandie;61;2;05;152;Écorches;89;0;89
28;Normandie;61;2;87;153;Écouché-les-Vallées;2169;53;2222
28;Normandie;61;1;17;341;Écouves;1703;55;1758
28;Normandie;61;1;17;156;Essay;531;14;545
28;Normandie;61;2;06;158;Faverolles;146;2;148
28;Normandie;61;3;18;159;Fay;71;2;73
28;Normandie;61;3;16;160;Feings;191;5;196
28;Normandie;61;3;20;162;La Ferrière-au-Doyen;169;3;172
28;Normandie;61;2;12;163;La Ferrière-aux-Étangs;1518;22;1540
28;Normandie;61;1;19;164;La Ferrière-Béchet;242;2;244
28;Normandie;61;1;10;165;La Ferrière-Bochard;742;14;756
28;Normandie;61;1;17;166;Ferrières-la-Verrerie;149;3;152
28;Normandie;61;3;18;167;La Ferté-en-Ouche;3217;49;3266
28;Normandie;61;2;88;168;La Ferté Macé;5237;403;5640
28;Normandie;61;2;99;169;Flers;14734;359;15093
28;Normandie;61;2;15;170;Fleuré;207;3;210
28;Normandie;61;2;05;171;Fontaine-les-Bassets;105;1;106
28;Normandie;61;1;19;176;Francheville;150;4;154
28;Normandie;61;3;21;178;La Fresnaie-Fayel;54;2;56
28;Normandie;61;3;21;180;Fresnay-le-Samson;87;1;88
28;Normandie;61;3;21;181;Gacé;1861;61;1922
28;Normandie;61;1;10;182;Gandelain;411;6;417
28;Normandie;61;1;17;183;Gâprée;134;5;139
28;Normandie;61;3;20;187;Les Genettes;193;7;200
28;Normandie;61;3;18;188;La Genevraie;98;5;103
28;Normandie;61;2;06;189;Giel-Courteilles;430;248;678
28;Normandie;61;2;05;190;Ginai;85;1;86
28;Normandie;61;3;18;192;Godisson;111;0;111
28;Normandie;61;3;18;193;La Gonfrière;302;3;305
28;Normandie;61;2;05;474;Gouffern en Auge;3729;80;3809
28;Normandie;61;2;06;195;Le Grais;197;4;201
28;Normandie;61;2;05;197;Guêprei;138;4;142
28;Normandie;61;3;21;198;Guerquesalles;135;0;135
28;Normandie;61;2;06;199;Habloville;323;5;328
28;Normandie;61;1;17;202;Hauterive;473;11;484
28;Normandie;61;1;10;203;Héloup;917;26;943
28;Normandie;61;3;20;206;L' Hôme-Chamondot;257;4;261
28;Normandie;61;3;09;207;Igé;630;24;654
28;Normandie;61;3;20;208;Irai;613;15;628
28;Normandie;61;1;15;209;Joué-du-Bois;422;2;424
28;Normandie;61;2;15;210;Joué-du-Plain;255;10;265
28;Normandie;61;2;04;212;Juvigny-sur-Orne;119;4;123
28;Normandie;61;1;07;211;Juvigny Val d'Andaine;2193;55;2248
28;Normandie;61;1;10;213;Lalacelle;284;4;288
28;Normandie;61;1;17;215;Laleu;360;7;367
28;Normandie;61;1;15;216;La Lande-de-Goult;192;3;195
28;Normandie;61;2;15;217;La Lande-de-Lougé;49;1;50
28;Normandie;61;2;13;218;La Lande-Patry;1791;53;1844
28;Normandie;61;2;06;219;La Lande-Saint-Siméon;151;1;152
28;Normandie;61;2;14;221;Landigou;440;8;448
28;Normandie;61;2;13;222;Landisacq;749;20;769
28;Normandie;61;1;17;224;Larré;435;7;442
28;Normandie;61;3;18;225;Lignères;28;0;28
28;Normandie;61;2;06;227;Lignou;150;3;153
28;Normandie;61;3;16;229;Loisail;126;4;130
28;Normandie;61;3;20;230;Longny les Villages;3008;51;3059
28;Normandie;61;2;11;232;Lonlay-l'Abbaye;1128;35;1163
28;Normandie;61;2;12;233;Lonlay-le-Tesson;222;5;227
28;Normandie;61;1;10;234;Lonrai;1134;37;1171
28;Normandie;61;2;15;237;Lougé-sur-Maire;315;12;327
28;Normandie;61;2;05;238;Louvières-en-Auge;76;1;77
28;Normandie;61;1;19;240;Macé;409;5;414
28;Normandie;61;3;08;241;La Madeleine-Bouvet;408;10;418
28;Normandie;61;3;20;242;Le Mage;231;10;241
28;Normandie;61;1;15;243;Magny-le-Désert;1400;42;1442
28;Normandie;61;3;18;244;Mahéru;266;11;277
28;Normandie;61;1;07;248;Mantilly;535;6;541
28;Normandie;61;1;17;251;Marchemaisons;152;6;158
28;Normandie;61;3;21;252;Mardilly;136;4;140
28;Normandie;61;3;16;255;Mauves-sur-Huisne;544;13;557
28;Normandie;61;1;19;256;Médavy;154;9;163
28;Normandie;61;1;15;257;Méhoudin;123;2;125
28;Normandie;61;1;17;258;Le Mêle-sur-Sarthe;686;13;699
28;Normandie;61;3;20;259;Le Ménil-Bérard;75;0;75
28;Normandie;61;1;17;261;Le Ménil-Broût;169;3;172
28;Normandie;61;2;11;262;Le Ménil-Ciboult;121;1;122
28;Normandie;61;2;06;260;Le Ménil-de-Briouze;562;10;572
28;Normandie;61;1;17;263;Ménil-Erreux;219;7;226
28;Normandie;61;3;18;264;Ménil-Froger;55;1;56
28;Normandie;61;2;06;265;Ménil-Gondouin;172;6;178
28;Normandie;61;1;17;266;Le Ménil-Guyon;77;0;77
28;Normandie;61;2;06;267;Ménil-Hermei;203;5;208
28;Normandie;61;3;21;268;Ménil-Hubert-en-Exmes;111;5;116
28;Normandie;61;2;06;269;Ménil-Hubert-sur-Orne;482;8;490
28;Normandie;61;1;15;271;Le Ménil-Scelleur;91;0;91
28;Normandie;61;3;18;272;Le Ménil-Vicomte;24;1;25
28;Normandie;61;2;06;273;Ménil-Vin;53;3;56
28;Normandie;61;3;20;274;Les Menus;237;6;243
28;Normandie;61;3;18;275;Le Merlerault;809;17;826
28;Normandie;61;2;05;276;Merri;163;6;169
28;Normandie;61;3;16;277;La Mesnière;286;6;292
28;Normandie;61;2;12;278;Messei;1908;58;1966
28;Normandie;61;1;10;279;Mieuxcé;624;15;639
28;Normandie;61;2;13;281;Moncy;251;7;258
28;Normandie;61;2;05;289;Mont-Ormel;53;0;53
28;Normandie;61;2;04;283;Montabard;286;10;296
28;Normandie;61;1;17;284;Montchevrel;234;2;236
28;Normandie;61;3;16;286;Montgaudry;79;0;79
28;Normandie;61;2;14;287;Montilly-sur-Noireau;724;19;743
28;Normandie;61;1;19;288;Montmerrei;515;7;522
28;Normandie;61;2;06;290;Montreuil-au-Houlme;134;4;138
28;Normandie;61;2;05;291;Montreuil-la-Cambe;70;0;70
28;Normandie;61;2;12;463;Les Monts d'Andaine;1779;34;1813
28;Normandie;61;2;15;194;Monts-sur-Orne;909;14;923
28;Normandie;61;2;11;292;Montsecret-Clairefougère;665;9;674
28;Normandie;61;3;16;293;Mortagne-au-Perche;3818;295;4113
28;Normandie;61;1;19;294;Mortrée;1175;29;1204
28;Normandie;61;1;15;295;La Motte-Fouquet;161;2;163
28;Normandie;61;3;20;297;Moulins-la-Marche;732;11;743
28;Normandie;61;2;04;298;Moulins-sur-Orne;311;9;320
28;Normandie;61;3;08;300;Moutiers-au-Perche;390;8;398
28;Normandie;61;1;19;301;Neauphe-sous-Essai;211;1;212
28;Normandie;61;2;05;302;Neauphe-sur-Dive;136;8;144
28;Normandie;61;2;04;303;Nécy;519;11;530
28;Normandie;61;1;17;304;Neuilly-le-Bisson;303;5;308
28;Normandie;61;3;21;307;Neuville-sur-Touques;226;2;228
28;Normandie;61;2;06;308;Neuvy-au-Houlme;208;4;212
28;Normandie;61;3;18;310;Nonant-le-Pin;498;39;537
28;Normandie;61;2;04;314;Occagnes;655;17;672
28;Normandie;61;2;05;316;Ommoy;124;3;127
28;Normandie;61;1;15;228;L' Orée-d'Écouves;737;15;752
28;Normandie;61;3;21;317;Orgères;165;5;170
28;Normandie;61;3;09;319;Origny-le-Roux;266;7;273
28;Normandie;61;1;10;321;Pacé;389;6;395
28;Normandie;61;3;16;322;Parfondeval;111;2;113
28;Normandie;61;3;20;323;Le Pas-Saint-l'Homer;133;2;135
28;Normandie;61;1;07;324;Passais Villages;1191;15;1206
28;Normandie;61;3;08;309;Perche en Nocé;2066;64;2130
28;Normandie;61;1;07;326;Perrou;295;6;301
28;Normandie;61;3;16;327;Pervenchères;344;11;355
28;Normandie;61;2;05;328;Le Pin-au-Haras;276;5;281
28;Normandie;61;3;16;329;Le Pin-la-Garenne;653;11;664
28;Normandie;61;3;18;330;Planches;189;3;192
28;Normandie;61;1;17;331;Le Plantis;147;2;149
28;Normandie;61;2;06;332;Pointel;330;59;389
28;Normandie;61;3;21;333;Pontchardon;180;4;184
28;Normandie;61;3;09;336;Pouvrai;107;7;114
28;Normandie;61;2;06;339;Putanges-le-Lac;2181;34;2215
28;Normandie;61;3;18;342;Rai;1425;27;1452
28;Normandie;61;2;15;344;Rânes;1045;13;1058
28;Normandie;61;3;08;345;Rémalard en Perche;1950;43;1993
28;Normandie;61;3;21;346;Le Renouard;202;6;208
28;Normandie;61;3;21;347;Résenlieu;171;3;174
28;Normandie;61;3;16;348;Réveillon;374;6;380
28;Normandie;61;2;04;349;Ri;167;4;171
28;Normandie;61;1;07;096;Rives d'Andaine;3054;112;3166
28;Normandie;61;1;10;350;La Roche-Mabile;157;8;165
28;Normandie;61;3;21;351;Roiville;131;3;134
28;Normandie;61;2;04;352;Rônai;171;5;176
28;Normandie;61;1;15;357;Rouperroux;188;3;191
28;Normandie;61;3;08;116;Sablons sur Huisne;2142;29;2171
28;Normandie;61;2;04;358;Sai;222;6;228
28;Normandie;61;1;17;360;Saint-Agnan-sur-Sarthe;104;2;106
28;Normandie;61;2;06;361;Saint-André-de-Briouze;179;6;185
28;Normandie;61;2;12;362;Saint-André-de-Messei;572;15;587
28;Normandie;61;3;16;363;Saint-Aquilin-de-Corbion;67;3;70
28;Normandie;61;1;17;365;Saint-Aubin-d'Appenai;403;11;414
28;Normandie;61;3;21;366;Saint-Aubin-de-Bonneval;135;3;138
28;Normandie;61;3;16;367;Saint-Aubin-de-Courteraie;132;1;133
28;Normandie;61;2;11;369;Saint-Bômer-les-Forges;1040;35;1075
28;Normandie;61;2;11;370;Saint-Brice;153;2;155
28;Normandie;61;2;15;371;Saint-Brice-sous-Rânes;136;2;138
28;Normandie;61;1;10;372;Saint-Céneri-le-Gérei;120;8;128
28;Normandie;61;2;11;374;Saint-Christophe-de-Chaulieu;97;4;101
28;Normandie;61;2;13;376;Saint-Clair-de-Halouze;863;18;881
28;Normandie;61;3;08;379;Saint-Cyr-la-Rosière;232;4;236
28;Normandie;61;3;16;381;Saint-Denis-sur-Huisne;56;5;61
28;Normandie;61;1;10;382;Saint-Denis-sur-Sarthon;1122;21;1143
28;Normandie;61;1;15;384;Saint-Ellier-les-Bois;248;2;250
28;Normandie;61;3;21;385;Saint-Evroult-de-Montfort;340;8;348
28;Normandie;61;3;18;386;Saint-Evroult-Notre-Dame-du-Bois;454;32;486
28;Normandie;61;1;07;387;Saint-Fraimbault;539;18;557
28;Normandie;61;3;09;388;Saint-Fulgent-des-Ormes;162;2;164
28;Normandie;61;2;15;390;Saint-Georges-d'Annebecq;147;1;148
28;Normandie;61;2;14;391;Saint-Georges-des-Groseillers;3196;115;3311
28;Normandie;61;3;21;392;Saint-Germain-d'Aunay;146;4;150
28;Normandie;61;3;18;393;Saint-Germain-de-Clairefeuille;146;5;151
28;Normandie;61;3;09;394;Saint-Germain-de-la-Coudre;755;27;782
28;Normandie;61;3;16;396;Saint-Germain-de-Martigny;76;5;81
28;Normandie;61;3;08;395;Saint-Germain-des-Grois;238;7;245
28;Normandie;61;1;03;397;Saint-Germain-du-Corbéis;3798;132;3930
28;Normandie;61;1;17;398;Saint-Germain-le-Vieux;59;1;60
28;Normandie;61;2;05;399;Saint-Gervais-des-Sablons;72;3;75
28;Normandie;61;1;19;400;Saint-Gervais-du-Perron;372;7;379
28;Normandie;61;2;11;401;Saint-Gilles-des-Marais;111;0;111
28;Normandie;61;2;06;402;Saint-Hilaire-de-Briouze;313;8;321
28;Normandie;61;3;16;404;Saint-Hilaire-le-Châtel;641;29;670
28;Normandie;61;3;09;405;Saint-Hilaire-sur-Erre;529;11;540
28;Normandie;61;3;20;406;Saint-Hilaire-sur-Risle;316;4;320
28;Normandie;61;3;16;411;Saint-Jouin-de-Blavou;282;9;291
28;Normandie;61;1;17;412;Saint-Julien-sur-Sarthe;677;15;692
28;Normandie;61;2;05;413;Saint-Lambert-sur-Dive;149;4;153
28;Normandie;61;3;16;414;Saint-Langis-lès-Mortagne;911;19;930
28;Normandie;61;1;17;415;Saint-Léger-sur-Sarthe;346;6;352
28;Normandie;61;1;17;416;Saint-Léonard-des-Parcs;75;1;76
28;Normandie;61;3;16;418;Saint-Mard-de-Réno;429;11;440
28;Normandie;61;1;07;421;Saint-Mars-d'Égrenne;677;23;700
28;Normandie;61;3;01;423;Saint-Martin-d'Écublei;651;20;671
28;Normandie;61;1;15;424;Saint-Martin-des-Landes;216;6;222
28;Normandie;61;3;16;425;Saint-Martin-des-Pézerits;138;2;140
28;Normandie;61;3;09;426;Saint-Martin-du-Vieux-Bellême;577;17;594
28;Normandie;61;1;15;427;Saint-Martin-l'Aiguillon;195;4;199
28;Normandie;61;3;01;432;Saint-Michel-Tubœuf;642;19;661
28;Normandie;61;3;18;435;Saint-Nicolas-de-Sommaire;270;4;274
28;Normandie;61;1;10;433;Saint-Nicolas-des-Bois;285;8;293
28;Normandie;61;3;16;438;Saint-Ouen-de-Sécherouvre;175;5;180
28;Normandie;61;1;15;439;Saint-Ouen-le-Brisoult;123;4;127
28;Normandie;61;3;01;440;Saint-Ouen-sur-Iton;825;31;856
28;Normandie;61;1;15;442;Saint-Patrice-du-Désert;199;4;203
28;Normandie;61;2;13;443;Saint-Paul;680;15;695
28;Normandie;61;2;06;444;Saint-Philbert-sur-Orne;114;3;117
28;Normandie;61;2;13;445;Saint-Pierre-d'Entremont;687;10;697
28;Normandie;61;3;18;446;Saint-Pierre-des-Loges;156;5;161
28;Normandie;61;2;14;447;Saint-Pierre-du-Regard;1422;19;1441
28;Normandie;61;3;08;448;Saint-Pierre-la-Bruyère;438;6;444
28;Normandie;61;1;17;450;Saint-Quentin-de-Blavou;71;1;72
28;Normandie;61;2;11;451;Saint-Quentin-les-Chardonnets;337;7;344
28;Normandie;61;1;07;452;Saint-Roch-sur-Égrenne;178;0;178
28;Normandie;61;1;15;453;Saint-Sauveur-de-Carrouges;247;7;254
28;Normandie;61;3;01;456;Saint-Sulpice-sur-Risle;1672;47;1719
28;Normandie;61;3;18;457;Saint-Symphorien-des-Bruyères;493;8;501
28;Normandie;61;3;16;373;Sainte-Céronne-lès-Mortagne;249;8;257
28;Normandie;61;3;18;389;Sainte-Gauburge-Sainte-Colombe;1077;25;1102
28;Normandie;61;2;06;407;Sainte-Honorine-la-Chardonne;725;13;738
28;Normandie;61;2;06;408;Sainte-Honorine-la-Guillaume;334;9;343
28;Normandie;61;1;15;419;Sainte-Marguerite-de-Carrouges;224;7;231
28;Normandie;61;1;15;420;Sainte-Marie-la-Robert;85;0;85
28;Normandie;61;2;06;436;Sainte-Opportune;244;2;246
28;Normandie;61;1;17;454;Sainte-Scolasse-sur-Sarthe;623;15;638
28;Normandie;61;2;12;459;Saires-la-Verrerie;305;6;311
28;Normandie;61;3;21;461;Le Sap-André;118;3;121
28;Normandie;61;3;21;460;Sap-en-Auge;968;10;978
28;Normandie;61;2;04;462;Sarceaux;1050;34;1084
28;Normandie;61;1;19;464;Sées;4179;446;4625
28;Normandie;61;2;14;466;La Selle-la-Forge;1466;38;1504
28;Normandie;61;1;17;467;Semallé;352;11;363
28;Normandie;61;2;04;472;Sévigny;308;12;320
28;Normandie;61;2;15;473;Sevrai;256;5;261
28;Normandie;61;3;16;475;Soligny-la-Trappe;674;14;688
28;Normandie;61;3;09;476;Suré;280;8;288
28;Normandie;61;2;15;479;Tanques;157;5;162
28;Normandie;61;1;19;480;Tanville;228;5;233
28;Normandie;61;1;17;481;Tellières-le-Plessis;75;3;78
28;Normandie;61;1;07;482;Tessé-Froulay;389;9;398
28;Normandie;61;3;21;485;Ticheville;205;7;212
28;Normandie;61;2;11;486;Tinchebray-Bocage;4933;91;5024
28;Normandie;61;1;07;487;Torchamp;295;3;298
28;Normandie;61;3;18;488;Touquettes;91;2;93
28;Normandie;61;2;05;490;Tournai-sur-Dive;307;1;308
28;Normandie;61;3;20;491;Tourouvre au Perche;3127;55;3182
28;Normandie;61;1;17;492;Trémont;120;4;124
28;Normandie;61;3;21;493;La Trinité-des-Laitiers;66;6;72
28;Normandie;61;2;05;494;Trun;1245;66;1311
28;Normandie;61;3;09;484;Val-au-Perche;3620;76;3696
28;Normandie;61;1;10;497;Valframbert;1779;29;1808
28;Normandie;61;3;09;498;Vaunoise;101;4;105
28;Normandie;61;1;17;499;Les Ventes-de-Bourse;154;3;157
28;Normandie;61;3;20;500;La Ventrouze;126;4;130
28;Normandie;61;3;08;501;Verrières;423;5;428
28;Normandie;61;1;17;502;Vidai;96;0;96
28;Normandie;61;2;15;503;Vieux-Pont;198;4;202
28;Normandie;61;2;05;505;Villedieu-lès-Bailleul;215;6;221
28;Normandie;61;3;16;507;Villiers-sous-Mortagne;284;5;289
28;Normandie;61;3;21;508;Vimoutiers;3332;96;3428
28;Normandie;61;3;01;510;Vitrai-sous-Laigle;232;4;236
28;Normandie;61;2;06;512;Les Yveteaux;103;3;106
32;Hauts-de-France;62;7;17;001;Ablain-Saint-Nazaire;1772;32;1804
32;Hauts-de-France;62;1;09;002;Ablainzevelle;222;4;226
32;Hauts-de-France;62;7;08;003;Acheville;627;23;650
32;Hauts-de-France;62;1;04;004;Achicourt;7799;104;7903
32;Hauts-de-France;62;1;09;005;Achiet-le-Grand;988;5;993
32;Hauts-de-France;62;1;09;006;Achiet-le-Petit;303;4;307
32;Hauts-de-France;62;1;02;007;Acq;769;5;774
32;Hauts-de-France;62;5;33;008;Acquin-Westbécourt;833;5;838
32;Hauts-de-France;62;1;07;009;Adinfer;259;5;264
32;Hauts-de-France;62;5;33;010;Affringues;239;0;239
32;Hauts-de-France;62;1;07;011;Agnez-lès-Duisans;653;16;669
32;Hauts-de-France;62;1;07;012;Agnières;249;4;253
32;Hauts-de-France;62;1;04;013;Agny;1929;29;1958
32;Hauts-de-France;62;5;01;014;Aire-sur-la-Lys;9871;257;10128
32;Hauts-de-France;62;4;10;015;Airon-Notre-Dame;223;2;225
32;Hauts-de-France;62;4;10;016;Airon-Saint-Vaast;186;5;191
32;Hauts-de-France;62;4;33;017;Aix-en-Ergny;189;1;190
32;Hauts-de-France;62;4;06;018;Aix-en-Issart;263;5;268
32;Hauts-de-France;62;7;17;019;Aix-Noulette;3906;43;3949
32;Hauts-de-France;62;6;19;020;Alembon;630;11;641
32;Hauts-de-France;62;4;33;021;Alette;386;1;387
32;Hauts-de-France;62;3;22;022;Alincthun;330;4;334
32;Hauts-de-France;62;2;31;023;Allouagne;2925;30;2955
32;Hauts-de-France;62;5;33;024;Alquines;999;12;1011
32;Hauts-de-France;62;3;22;025;Ambleteuse;1843;39;1882
32;Hauts-de-France;62;4;25;026;Ambricourt;112;2;114
32;Hauts-de-France;62;1;07;027;Ambrines;239;0;239
32;Hauts-de-France;62;2;31;028;Ames;636;8;644
32;Hauts-de-France;62;2;31;029;Amettes;475;1;476
32;Hauts-de-France;62;1;07;030;Amplier;302;4;306
32;Hauts-de-France;62;6;19;031;Andres;1564;9;1573
32;Hauts-de-France;62;7;17;032;Angres;4526;57;4583
32;Hauts-de-France;62;7;29;033;Annay;4337;27;4364
32;Hauts-de-France;62;2;23;034;Annequin;2201;14;2215
32;Hauts-de-France;62;2;11;035;Annezin;5898;46;5944
32;Hauts-de-France;62;1;38;036;Anvin;772;24;796
32;Hauts-de-France;62;1;02;037;Anzin-Saint-Aubin;2742;86;2828
32;Hauts-de-France;62;6;19;038;Ardres;4405;70;4475
32;Hauts-de-France;62;1;15;039;Arleux-en-Gohelle;856;17;873
32;Hauts-de-France;62;5;32;040;Arques;9753;129;9882
32;Hauts-de-France;62;1;96;041;Arras;41019;794;41813
32;Hauts-de-France;62;1;03;042;Athies;1014;13;1027
32;Hauts-de-France;62;6;19;043;Les Attaques;1978;26;2004
32;Hauts-de-France;62;4;10;044;Attin;729;9;738
32;Hauts-de-France;62;1;07;045;Aubigny-en-Artois;1459;26;1485
32;Hauts-de-France;62;4;06;046;Aubin-Saint-Vaast;759;13;772
32;Hauts-de-France;62;1;38;047;Aubrometz;152;1;153
32;Hauts-de-France;62;2;05;048;Auchel;10291;53;10344
32;Hauts-de-France;62;2;31;049;Auchy-au-Bois;504;2;506
32;Hauts-de-France;62;4;06;050;Auchy-lès-Hesdin;1571;16;1587
32;Hauts-de-France;62;2;23;051;Auchy-les-Mines;4726;39;4765
32;Hauts-de-France;62;3;22;052;Audembert;432;12;444
32;Hauts-de-France;62;5;25;053;Audincthun;664;6;670
32;Hauts-de-France;62;3;22;054;Audinghen;582;7;589
32;Hauts-de-France;62;5;33;055;Audrehem;562;12;574
32;Hauts-de-France;62;3;22;056;Audresselles;649;5;654
32;Hauts-de-France;62;6;34;057;Audruicq;5412;53;5465
32;Hauts-de-France;62;1;38;058;Aumerval;198;5;203
32;Hauts-de-France;62;6;19;059;Autingues;291;8;299
32;Hauts-de-France;62;1;06;060;Auxi-le-Château;2639;24;2663
32;Hauts-de-France;62;1;38;061;Averdoingt;293;7;300
32;Hauts-de-France;62;4;33;062;Avesnes;52;1;53
32;Hauts-de-France;62;1;07;063;Avesnes-le-Comte;1902;30;1932
32;Hauts-de-France;62;1;09;064;Avesnes-lès-Bapaume;162;2;164
32;Hauts-de-France;62;7;08;065;Avion;17622;140;17762
32;Hauts-de-France;62;4;25;066;Avondance;38;2;40
32;Hauts-de-France;62;5;25;067;Avroult;607;4;611
32;Hauts-de-France;62;1;09;068;Ayette;324;7;331
32;Hauts-de-France;62;4;06;069;Azincourt;307;4;311
32;Hauts-de-France;62;1;07;070;Bailleul-aux-Cornailles;263;5;268
32;Hauts-de-France;62;1;38;071;Bailleul-lès-Pernes;422;7;429
32;Hauts-de-France;62;1;03;073;Bailleul-Sir-Berthoult;1412;17;1429
32;Hauts-de-France;62;1;07;072;Bailleulmont;240;2;242
32;Hauts-de-France;62;1;07;074;Bailleulval;240;8;248
32;Hauts-de-France;62;3;14;075;Baincthun;1291;30;1321
32;Hauts-de-France;62;6;19;076;Bainghen;227;1;228
32;Hauts-de-France;62;2;16;077;Bajus;365;6;371
32;Hauts-de-France;62;6;19;078;Balinghem;1169;10;1179
32;Hauts-de-France;62;1;09;079;Bancourt;87;0;87
32;Hauts-de-France;62;1;09;080;Bapaume;3887;315;4202
32;Hauts-de-France;62;1;09;081;Baralle;480;11;491
32;Hauts-de-France;62;1;09;082;Barastre;307;4;311
32;Hauts-de-France;62;2;35;083;Barlin;7661;43;7704
32;Hauts-de-France;62;1;07;084;Barly;221;5;226
32;Hauts-de-France;62;1;07;085;Basseux;137;5;142
32;Hauts-de-France;62;1;07;086;Bavincourt;378;7;385
32;Hauts-de-France;62;5;37;087;Bayenghem-lès-Éperlecques;1009;22;1031
32;Hauts-de-France;62;5;33;088;Bayenghem-lès-Seninghem;324;6;330
32;Hauts-de-France;62;3;22;089;Bazinghen;393;13;406
32;Hauts-de-France;62;4;06;090;Béalencourt;130;5;135
32;Hauts-de-France;62;1;07;091;Beaudricourt;90;1;91
32;Hauts-de-France;62;1;07;092;Beaufort-Blavincourt;397;7;404
32;Hauts-de-France;62;1;09;093;Beaulencourt;235;0;235
32;Hauts-de-France;62;4;10;094;Beaumerie-Saint-Martin;397;4;401
32;Hauts-de-France;62;5;25;095;Beaumetz-lès-Aire;239;1;240
32;Hauts-de-France;62;1;09;096;Beaumetz-lès-Cambrai;581;4;585
32;Hauts-de-France;62;1;02;097;Beaumetz-lès-Loges;999;15;1014
32;Hauts-de-France;62;1;04;099;Beaurains;5662;67;5729
32;Hauts-de-France;62;4;06;100;Beaurainville;2095;28;2123
32;Hauts-de-France;62;1;06;881;Beauvoir-Wavans;380;10;390
32;Hauts-de-France;62;1;38;101;Beauvois;142;1;143
32;Hauts-de-France;62;4;33;102;Bécourt;272;3;275
32;Hauts-de-France;62;1;09;103;Béhagnies;126;2;128
32;Hauts-de-France;62;3;22;105;Belle-et-Houllefort;560;18;578
32;Hauts-de-France;62;3;22;104;Bellebrune;400;7;407
32;Hauts-de-France;62;5;25;471;Bellinghem;1070;23;1093
32;Hauts-de-France;62;1;15;106;Bellonne;211;7;218
32;Hauts-de-France;62;7;39;107;Bénifontaine;356;9;365
32;Hauts-de-France;62;4;10;108;Berck;14189;330;14519
32;Hauts-de-France;62;1;38;109;Bergueneuse;218;1;219
32;Hauts-de-France;62;1;07;111;Berlencourt-le-Cauroy;275;81;356
32;Hauts-de-France;62;1;07;112;Berles-au-Bois;515;8;523
32;Hauts-de-France;62;1;07;113;Berles-Monchel;488;14;502
32;Hauts-de-France;62;1;38;114;Bermicourt;165;4;169
32;Hauts-de-France;62;1;07;115;Berneville;480;18;498
32;Hauts-de-France;62;4;10;116;Bernieulles;184;1;185
32;Hauts-de-France;62;1;09;117;Bertincourt;918;15;933
32;Hauts-de-France;62;1;07;118;Béthonsart;147;4;151
32;Hauts-de-France;62;2;11;119;Béthune;24895;333;25228
32;Hauts-de-France;62;2;16;120;Beugin;471;7;478
32;Hauts-de-France;62;1;09;121;Beugnâtre;170;3;173
32;Hauts-de-France;62;1;09;122;Beugny;376;4;380
32;Hauts-de-France;62;4;33;123;Beussent;548;3;551
32;Hauts-de-France;62;4;10;124;Beutin;466;11;477
32;Hauts-de-France;62;3;22;125;Beuvrequen;457;13;470
32;Hauts-de-France;62;2;12;126;Beuvry;9442;175;9617
32;Hauts-de-France;62;4;33;127;Bezinghem;363;10;373
32;Hauts-de-France;62;1;15;128;Biache-Saint-Vaast;4083;32;4115
32;Hauts-de-France;62;1;09;129;Biefvillers-lès-Bapaume;94;2;96
32;Hauts-de-France;62;1;07;130;Bienvillers-au-Bois;643;13;656
32;Hauts-de-France;62;1;09;131;Bihucourt;351;3;354
32;Hauts-de-France;62;2;23;132;Billy-Berclau;4624;37;4661
32;Hauts-de-France;62;7;26;133;Billy-Montigny;8150;42;8192
32;Hauts-de-France;62;4;33;134;Bimont;114;2;116
32;Hauts-de-France;62;1;07;135;Blairville;314;3;317
32;Hauts-de-France;62;1;38;137;Blangerval-Blangermont;106;1;107
32;Hauts-de-France;62;4;06;138;Blangy-sur-Ternoise;720;13;733
32;Hauts-de-France;62;5;32;139;Blendecques;5002;133;5135
32;Hauts-de-France;62;5;33;140;Bléquin;519;4;523
32;Hauts-de-France;62;2;01;141;Blessy;870;13;883
32;Hauts-de-France;62;4;06;142;Blingel;166;1;167
32;Hauts-de-France;62;1;06;143;Boffles;50;1;51
32;Hauts-de-France;62;1;04;144;Boiry-Becquerelle;447;8;455
32;Hauts-de-France;62;1;15;145;Boiry-Notre-Dame;454;6;460
32;Hauts-de-France;62;1;07;146;Boiry-Saint-Martin;277;0;277
32;Hauts-de-France;62;1;07;147;Boiry-Sainte-Rictrude;406;4;410
32;Hauts-de-France;62;7;26;148;Bois-Bernard;827;9;836
32;Hauts-de-France;62;5;33;149;Boisdinghem;249;8;257
32;Hauts-de-France;62;4;06;150;Boisjean;505;7;512
32;Hauts-de-France;62;1;04;151;Boisleux-au-Mont;517;10;527
32;Hauts-de-France;62;1;04;152;Boisleux-Saint-Marc;251;3;254
32;Hauts-de-France;62;5;25;153;Bomy;631;7;638
32;Hauts-de-France;62;1;38;154;Bonnières;674;14;688
32;Hauts-de-France;62;5;33;155;Bonningues-lès-Ardres;656;14;670
32;Hauts-de-France;62;6;18;156;Bonningues-lès-Calais;565;13;578
32;Hauts-de-France;62;4;06;157;Boubers-lès-Hesmond;88;3;91
32;Hauts-de-France;62;1;38;158;Boubers-sur-Canche;589;13;602
32;Hauts-de-France;62;4;06;661;Bouin-Plumoison;494;9;503
32;Hauts-de-France;62;3;97;160;Boulogne-sur-Mer;40874;446;41320
32;Hauts-de-France;62;6;19;161;Bouquehault;765;4;769
32;Hauts-de-France;62;2;31;162;Bourecq;639;2;641
32;Hauts-de-France;62;1;38;163;Bouret-sur-Canche;256;3;259
32;Hauts-de-France;62;1;09;164;Bourlon;1156;18;1174
32;Hauts-de-France;62;3;22;165;Bournonville;240;5;245
32;Hauts-de-France;62;1;38;166;Bours;617;7;624
32;Hauts-de-France;62;6;19;167;Boursin;255;4;259
32;Hauts-de-France;62;4;33;168;Bourthes;853;12;865
32;Hauts-de-France;62;5;33;169;Bouvelinghem;219;5;224
32;Hauts-de-France;62;7;17;170;Bouvigny-Boyeffles;2403;90;2493
32;Hauts-de-France;62;1;38;171;Boyaval;133;2;135
32;Hauts-de-France;62;1;04;172;Boyelles;358;3;361
32;Hauts-de-France;62;1;15;173;Brebières;5023;60;5083
32;Hauts-de-France;62;6;19;174;Brêmes;1290;13;1303
32;Hauts-de-France;62;4;06;175;Brévillers;158;5;163
32;Hauts-de-France;62;4;24;176;Bréxent-Énocq;681;12;693
32;Hauts-de-France;62;1;38;180;Brias;294;6;300
32;Hauts-de-France;62;4;06;177;Brimeux;847;21;868
32;Hauts-de-France;62;2;16;178;Bruay-la-Buissière;21831;436;22267
32;Hauts-de-France;62;3;22;179;Brunembert;418;7;425
32;Hauts-de-France;62;1;09;181;Bucquoy;1461;91;1552
32;Hauts-de-France;62;1;06;182;Buire-au-Bois;230;7;237
32;Hauts-de-France;62;4;06;183;Buire-le-Sec;777;10;787
32;Hauts-de-France;62;1;09;184;Buissy;263;3;266
32;Hauts-de-France;62;1;09;185;Bullecourt;236;1;237
32;Hauts-de-France;62;7;17;186;Bully-les-Mines;12163;71;12234
32;Hauts-de-France;62;1;38;187;Buneville;180;2;182
32;Hauts-de-France;62;2;31;188;Burbure;2865;30;2895
32;Hauts-de-France;62;1;09;189;Bus;126;2;128
32;Hauts-de-France;62;2;31;190;Busnes;1290;23;1313
32;Hauts-de-France;62;6;19;191;Caffiers;749;3;752
32;Hauts-de-France;62;1;15;192;Cagnicourt;432;7;439
32;Hauts-de-France;62;6;98;193;Calais;73911;670;74581
32;Hauts-de-France;62;2;05;194;Calonne-Ricouart;5454;33;5487
32;Hauts-de-France;62;2;31;195;Calonne-sur-la-Lys;1545;19;1564
32;Hauts-de-France;62;4;10;196;La Calotterie;643;7;650
32;Hauts-de-France;62;2;05;197;Camblain-Châtelain;1764;17;1781
32;Hauts-de-France;62;1;07;199;Camblain-l'Abbé;650;129;779
32;Hauts-de-France;62;1;07;198;Cambligneul;337;10;347
32;Hauts-de-France;62;2;23;200;Cambrin;1244;15;1259
32;Hauts-de-France;62;4;24;201;Camiers;2717;43;2760
32;Hauts-de-France;62;4;33;202;Campagne-lès-Boulonnais;634;97;731
32;Hauts-de-France;62;6;19;203;Campagne-lès-Guines;445;11;456
32;Hauts-de-France;62;4;06;204;Campagne-lès-Hesdin;1920;36;1956
32;Hauts-de-France;62;5;32;205;Campagne-lès-Wardrecques;1243;36;1279
32;Hauts-de-France;62;4;10;206;Campigneulles-les-Grandes;299;18;317
32;Hauts-de-France;62;4;10;207;Campigneulles-les-Petites;552;21;573
32;Hauts-de-France;62;1;07;208;Canettemont;70;1;71
32;Hauts-de-France;62;4;25;209;Canlers;159;10;169
32;Hauts-de-France;62;1;07;211;Capelle-Fermont;217;4;221
32;Hauts-de-France;62;3;13;908;La Capelle-lès-Boulogne;1629;38;1667
32;Hauts-de-France;62;4;06;212;Capelle-lès-Hesdin;485;11;496
32;Hauts-de-France;62;7;17;213;Carency;750;10;760
32;Hauts-de-France;62;3;22;214;Carly;551;10;561
32;Hauts-de-France;62;7;21;215;Carvin;17124;111;17235
32;Hauts-de-France;62;1;07;216;La Cauchie;211;2;213
32;Hauts-de-France;62;2;05;217;Cauchy-à-la-Tour;2814;15;2829
32;Hauts-de-France;62;2;16;218;Caucourt;346;7;353
32;Hauts-de-France;62;4;06;219;Caumont;162;4;166
32;Hauts-de-France;62;4;06;220;Cavron-Saint-Martin;457;6;463
32;Hauts-de-France;62;1;07;221;Chelers;259;7;266
32;Hauts-de-France;62;4;06;222;Chériennes;155;2;157
32;Hauts-de-France;62;1;09;223;Chérisy;293;7;300
32;Hauts-de-France;62;2;11;224;Chocques;2881;27;2908
32;Hauts-de-France;62;5;37;225;Clairmarais;624;11;635
32;Hauts-de-France;62;4;33;227;Clenleu;195;3;198
32;Hauts-de-France;62;5;33;228;Clerques;327;3;330
32;Hauts-de-France;62;5;33;229;Cléty;772;16;788
32;Hauts-de-France;62;3;22;230;Colembert;942;13;955
32;Hauts-de-France;62;4;10;231;Colline-Beaumont;137;5;142
32;Hauts-de-France;62;2;16;232;La Comté;935;16;951
32;Hauts-de-France;62;4;10;233;Conchil-le-Temple;1135;14;1149
32;Hauts-de-France;62;1;38;234;Conchy-sur-Canche;216;4;220
32;Hauts-de-France;62;3;36;235;Condette;2506;91;2597
32;Hauts-de-France;62;4;06;236;Contes;331;8;339
32;Hauts-de-France;62;1;38;238;Conteville-en-Ternois;91;1;92
32;Hauts-de-France;62;3;13;237;Conteville-lès-Boulogne;478;14;492
32;Hauts-de-France;62;6;18;239;Coquelles;2611;37;2648
32;Hauts-de-France;62;1;15;240;Corbehem;2366;18;2384
32;Hauts-de-France;62;4;24;241;Cormont;319;5;324
32;Hauts-de-France;62;1;07;242;Couin;113;1;114
32;Hauts-de-France;62;1;07;243;Coullemont;122;3;125
32;Hauts-de-France;62;6;19;244;Coulogne;5372;209;5581
32;Hauts-de-France;62;5;33;245;Coulomby;737;7;744
32;Hauts-de-France;62;4;25;246;Coupelle-Neuve;161;0;161
32;Hauts-de-France;62;4;25;247;Coupelle-Vieille;601;11;612
32;Hauts-de-France;62;1;09;248;Courcelles-le-Comte;461;7;468
32;Hauts-de-France;62;7;28;249;Courcelles-lès-Lens;7774;39;7813
32;Hauts-de-France;62;7;21;250;Courrières;10512;98;10610
32;Hauts-de-France;62;3;22;251;Courset;515;191;706
32;Hauts-de-France;62;2;12;252;La Couture;2764;72;2836
32;Hauts-de-France;62;1;07;253;Couturelle;65;2;67
32;Hauts-de-France;62;5;25;254;Coyecques;606;16;622
32;Hauts-de-France;62;3;22;255;Crémarest;786;4;790
32;Hauts-de-France;62;4;25;256;Crépy;149;3;152
32;Hauts-de-France;62;4;25;257;Créquy;485;8;493
32;Hauts-de-France;62;1;38;258;Croisette;278;5;283
32;Hauts-de-France;62;1;09;259;Croisilles;1929;26;1955
32;Hauts-de-France;62;1;38;260;Croix-en-Ternois;322;3;325
32;Hauts-de-France;62;4;24;261;Cucq;5121;90;5211
32;Hauts-de-France;62;2;23;262;Cuinchy;1741;16;1757
32;Hauts-de-France;62;1;02;263;Dainville;5646;107;5753
32;Hauts-de-France;62;3;36;264;Dannes;1316;5;1321
32;Hauts-de-France;62;5;25;265;Delettes;1178;16;1194
32;Hauts-de-France;62;1;07;266;Denier;86;1;87
32;Hauts-de-France;62;5;25;267;Dennebrœucq;389;6;395
32;Hauts-de-France;62;3;22;268;Desvres;4985;39;5024
32;Hauts-de-France;62;2;05;269;Diéval;750;6;756
32;Hauts-de-France;62;2;05;270;Divion;6978;39;7017
32;Hauts-de-France;62;5;33;271;Dohem;828;17;845
32;Hauts-de-France;62;1;09;272;Douchy-lès-Ayette;308;2;310
32;Hauts-de-France;62;3;22;273;Doudeauville;600;10;610
32;Hauts-de-France;62;7;27;274;Dourges;5891;40;5931
32;Hauts-de-France;62;4;06;275;Douriez;326;7;333
32;Hauts-de-France;62;2;23;276;Douvrin;5407;42;5449
32;Hauts-de-France;62;7;28;277;Drocourt;2936;12;2948
32;Hauts-de-France;62;2;35;278;Drouvin-le-Marais;594;17;611
32;Hauts-de-France;62;1;07;279;Duisans;1309;124;1433
32;Hauts-de-France;62;1;15;280;Dury;350;5;355
32;Hauts-de-France;62;3;14;281;Echinghen;390;6;396
32;Hauts-de-France;62;4;06;282;Éclimeux;176;0;176
32;Hauts-de-France;62;1;38;283;Écoivres;131;0;131
32;Hauts-de-France;62;1;09;284;Écourt-Saint-Quentin;1672;16;1688
32;Hauts-de-France;62;1;09;285;Écoust-Saint-Mein;491;8;499
32;Hauts-de-France;62;2;31;286;Ecquedecques;513;3;516
32;Hauts-de-France;62;5;25;288;Ecques;2139;47;2186
32;Hauts-de-France;62;4;10;289;Écuires;717;21;738
32;Hauts-de-France;62;1;02;290;Écurie;386;6;392
32;Hauts-de-France;62;7;30;291;Éleu-dit-Leauwette;2920;33;2953
32;Hauts-de-France;62;5;33;292;Elnes;914;15;929
32;Hauts-de-France;62;4;25;293;Embry;239;5;244
32;Hauts-de-France;62;5;25;295;Enquin-lez-Guinegatte;1616;26;1642
32;Hauts-de-France;62;4;33;296;Enquin-sur-Baillons;280;1;281
32;Hauts-de-France;62;5;37;297;Éperlecques;3640;44;3684
32;Hauts-de-France;62;1;09;298;Épinoy;546;10;556
32;Hauts-de-France;62;1;38;299;Eps;250;5;255
32;Hauts-de-France;62;3;36;300;Équihen-Plage;2738;35;2773
32;Hauts-de-France;62;1;38;301;Équirre;76;1;77
32;Hauts-de-France;62;4;33;302;Ergny;233;2;235
32;Hauts-de-France;62;1;38;303;Érin;234;5;239
32;Hauts-de-France;62;5;25;304;Erny-Saint-Julien;325;4;329
32;Hauts-de-France;62;1;09;306;Ervillers;399;3;402
32;Hauts-de-France;62;6;18;307;Escalles;228;9;237
32;Hauts-de-France;62;5;33;308;Escœuilles;479;10;489
32;Hauts-de-France;62;5;33;309;Esquerdes;1629;20;1649
32;Hauts-de-France;62;2;12;310;Essars;1725;19;1744
32;Hauts-de-France;62;7;39;311;Estevelles;2044;11;2055
32;Hauts-de-France;62;4;10;312;Estrée;290;6;296
32;Hauts-de-France;62;2;01;313;Estrée-Blanche;951;6;957
32;Hauts-de-France;62;2;16;314;Estrée-Cauchy;373;2;375
32;Hauts-de-France;62;1;07;316;Estrée-Wamin;172;3;175
32;Hauts-de-France;62;4;10;315;Estréelles;352;9;361
32;Hauts-de-France;62;1;15;317;Étaing;450;3;453
32;Hauts-de-France;62;4;24;318;Étaples;10865;98;10963
32;Hauts-de-France;62;1;15;319;Éterpigny;258;3;261
32;Hauts-de-France;62;1;02;320;Étrun;314;8;322
32;Hauts-de-France;62;7;28;321;Évin-Malmaison;4551;17;4568
32;Hauts-de-France;62;1;07;322;Famechon;120;3;123
32;Hauts-de-France;62;1;03;323;Fampoux;1181;21;1202
32;Hauts-de-France;62;1;03;324;Farbus;557;14;571
32;Hauts-de-France;62;5;25;325;Fauquembergues;984;15;999
32;Hauts-de-France;62;1;09;326;Favreuil;237;5;242
32;Hauts-de-France;62;5;25;327;Febvin-Palfart;600;4;604
32;Hauts-de-France;62;2;31;328;Ferfay;912;11;923
32;Hauts-de-France;62;3;22;329;Ferques;1802;14;1816
32;Hauts-de-France;62;2;23;330;Festubert;1313;20;1333
32;Hauts-de-France;62;1;03;331;Feuchy;1028;20;1048
32;Hauts-de-France;62;1;07;332;Ficheux;523;4;527
32;Hauts-de-France;62;1;38;333;Fiefs;385;6;391
32;Hauts-de-France;62;6;19;334;Fiennes;891;8;899
32;Hauts-de-France;62;4;06;335;Fillièvres;509;5;514
32;Hauts-de-France;62;5;25;336;Fléchin;479;7;486
32;Hauts-de-France;62;1;38;337;Flers;225;5;230
32;Hauts-de-France;62;2;12;338;Fleurbaix;2732;55;2787
32;Hauts-de-France;62;1;38;339;Fleury;122;1;123
32;Hauts-de-France;62;1;38;340;Floringhem;898;7;905
32;Hauts-de-France;62;1;07;341;Foncquevillers;435;9;444
32;Hauts-de-France;62;1;06;345;Fontaine-l'Étalon;102;0;102
32;Hauts-de-France;62;1;38;342;Fontaine-lès-Boulans;100;1;101
32;Hauts-de-France;62;1;09;343;Fontaine-lès-Croisilles;278;2;280
32;Hauts-de-France;62;1;38;344;Fontaine-lès-Hermans;108;3;111
32;Hauts-de-France;62;1;38;346;Fortel-en-Artois;211;2;213
32;Hauts-de-France;62;1;07;347;Fosseux;136;3;139
32;Hauts-de-France;62;1;38;348;Foufflin-Ricametz;160;2;162
32;Hauts-de-France;62;2;35;349;Fouquereuil;1570;12;1582
32;Hauts-de-France;62;2;35;350;Fouquières-lès-Béthune;1060;20;1080
32;Hauts-de-France;62;7;26;351;Fouquières-lès-Lens;6362;38;6400
32;Hauts-de-France;62;1;38;352;Framecourt;105;2;107
32;Hauts-de-France;62;1;09;353;Frémicourt;244;6;250
32;Hauts-de-France;62;4;24;354;Frencq;843;18;861
32;Hauts-de-France;62;1;15;355;Fresnes-lès-Montauban;572;7;579
32;Hauts-de-France;62;2;16;356;Fresnicourt-le-Dolmen;772;8;780
32;Hauts-de-France;62;4;06;357;Fresnoy;69;1;70
32;Hauts-de-France;62;1;15;358;Fresnoy-en-Gohelle;214;5;219
32;Hauts-de-France;62;4;25;359;Fressin;575;10;585
32;Hauts-de-France;62;6;18;360;Fréthun;1322;14;1336
32;Hauts-de-France;62;1;38;361;Frévent;3570;58;3628
32;Hauts-de-France;62;1;07;362;Frévillers;239;3;242
32;Hauts-de-France;62;1;07;363;Frévin-Capelle;380;9;389
32;Hauts-de-France;62;4;25;364;Fruges;2371;240;2611
32;Hauts-de-France;62;4;06;365;Galametz;199;0;199
32;Hauts-de-France;62;2;16;366;Gauchin-Légal;321;10;331
32;Hauts-de-France;62;1;38;367;Gauchin-Verloingt;838;35;873
32;Hauts-de-France;62;1;07;368;Gaudiempré;199;0;199
32;Hauts-de-France;62;1;03;369;Gavrelle;627;14;641
32;Hauts-de-France;62;1;06;370;Gennes-Ivergny;128;1;129
32;Hauts-de-France;62;7;30;371;Givenchy-en-Gohelle;1947;43;1990
32;Hauts-de-France;62;1;07;372;Givenchy-le-Noble;150;3;153
32;Hauts-de-France;62;2;23;373;Givenchy-lès-la-Bassée;1012;11;1023
32;Hauts-de-France;62;1;09;374;Gomiécourt;156;8;164
32;Hauts-de-France;62;1;07;375;Gommecourt;96;1;97
32;Hauts-de-France;62;2;31;376;Gonnehem;2536;36;2572
32;Hauts-de-France;62;2;35;377;Gosnay;951;7;958
32;Hauts-de-France;62;1;07;378;Gouves;197;4;201
32;Hauts-de-France;62;1;07;379;Gouy-en-Artois;330;8;338
32;Hauts-de-France;62;1;38;381;Gouy-en-Ternois;133;2;135
32;Hauts-de-France;62;4;06;382;Gouy-Saint-André;643;13;656
32;Hauts-de-France;62;7;17;380;Gouy-Servins;344;2;346
32;Hauts-de-France;62;1;15;383;Gouy-sous-Bellonne;1368;19;1387
32;Hauts-de-France;62;1;09;384;Graincourt-lès-Havrincourt;638;8;646
32;Hauts-de-France;62;1;07;385;Grand-Rullecourt;410;5;415
32;Hauts-de-France;62;7;39;386;Grenay;6932;40;6972
32;Hauts-de-France;62;1;09;387;Grévillers;365;10;375
32;Hauts-de-France;62;4;06;388;Grigny;296;1;297
32;Hauts-de-France;62;1;07;389;Grincourt-lès-Pas;30;2;32
32;Hauts-de-France;62;4;10;390;Groffliers;1508;46;1554
32;Hauts-de-France;62;2;01;391;Guarbecque;1425;14;1439
32;Hauts-de-France;62;1;04;392;Guémappe;336;8;344
32;Hauts-de-France;62;6;34;393;Guemps;1092;21;1113
32;Hauts-de-France;62;4;06;395;Guigny;139;4;143
32;Hauts-de-France;62;1;38;396;Guinecourt;17;1;18
32;Hauts-de-France;62;6;19;397;Guînes;5626;77;5703
32;Hauts-de-France;62;4;06;398;Guisy;270;12;282
32;Hauts-de-France;62;1;07;399;Habarcq;676;14;690
32;Hauts-de-France;62;2;35;400;Haillicourt;4886;37;4923
32;Hauts-de-France;62;2;23;401;Haisnes;4337;26;4363
32;Hauts-de-France;62;3;22;402;Halinghen;325;6;331
32;Hauts-de-France;62;5;32;403;Hallines;1195;20;1215
32;Hauts-de-France;62;1;07;404;Halloy;217;2;219
32;Hauts-de-France;62;2;31;407;Ham-en-Artois;992;13;1005
32;Hauts-de-France;62;1;15;405;Hamblain-les-Prés;504;4;508
32;Hauts-de-France;62;1;09;406;Hamelincourt;255;5;260
32;Hauts-de-France;62;6;18;408;Hames-Boucres;1469;18;1487
32;Hauts-de-France;62;1;07;409;Hannescamps;196;3;199
32;Hauts-de-France;62;1;09;410;Haplincourt;184;6;190
32;Hauts-de-France;62;1;06;411;Haravesnes;50;0;50
32;Hauts-de-France;62;6;19;412;Hardinghen;1210;6;1216
32;Hauts-de-France;62;7;26;413;Harnes;12354;96;12450
32;Hauts-de-France;62;1;15;414;Haucourt;238;2;240
32;Hauts-de-France;62;5;33;419;Haut-Loquin;185;1;186
32;Hauts-de-France;62;1;07;415;Haute-Avesnes;445;9;454
32;Hauts-de-France;62;1;38;416;Hautecloque;218;1;219
32;Hauts-de-France;62;1;07;418;Hauteville;316;8;324
32;Hauts-de-France;62;1;09;421;Havrincourt;403;11;414
32;Hauts-de-France;62;1;07;422;Hébuterne;524;6;530
32;Hauts-de-France;62;5;32;423;Helfaut;1697;30;1727
32;Hauts-de-France;62;1;15;424;Hendecourt-lès-Cagnicourt;312;11;323
32;Hauts-de-France;62;1;07;425;Hendecourt-lès-Ransart;135;4;139
32;Hauts-de-France;62;7;99;427;Hénin-Beaumont;26022;363;26385
32;Hauts-de-France;62;1;04;428;Hénin-sur-Cojeul;527;7;534
32;Hauts-de-France;62;1;04;426;Héninel;177;5;182
32;Hauts-de-France;62;3;22;429;Henneveux;300;6;306
32;Hauts-de-France;62;1;07;430;Hénu;164;2;166
32;Hauts-de-France;62;6;19;432;Herbinghen;378;8;386
32;Hauts-de-France;62;1;38;433;Héricourt;95;3;98
32;Hauts-de-France;62;1;07;434;La Herlière;149;5;154
32;Hauts-de-France;62;1;38;436;Herlin-le-Sec;171;3;174
32;Hauts-de-France;62;1;38;435;Herlincourt;104;8;112
32;Hauts-de-France;62;4;33;437;Herly;313;7;320
32;Hauts-de-France;62;1;07;438;Hermaville;540;8;548
32;Hauts-de-France;62;6;19;439;Hermelinghen;422;3;425
32;Hauts-de-France;62;1;09;440;Hermies;1180;21;1201
32;Hauts-de-France;62;2;16;441;Hermin;213;2;215
32;Hauts-de-France;62;1;38;442;Hernicourt;567;5;572
32;Hauts-de-France;62;2;35;443;Hersin-Coupigny;6245;42;6287
32;Hauts-de-France;62;3;22;444;Hervelinghen;232;6;238
32;Hauts-de-France;62;2;35;445;Hesdigneul-lès-Béthune;822;17;839
32;Hauts-de-France;62;3;36;446;Hesdigneul-lès-Boulogne;677;23;700
32;Hauts-de-France;62;4;06;447;Hesdin;2225;12;2237
32;Hauts-de-France;62;3;36;448;Hesdin-l'Abbé;1863;26;1889
32;Hauts-de-France;62;4;06;449;Hesmond;165;6;171
32;Hauts-de-France;62;1;38;450;Hestrus;243;1;244
32;Hauts-de-France;62;1;38;451;Heuchin;529;11;540
32;Hauts-de-France;62;5;25;452;Heuringhem;1339;33;1372
32;Hauts-de-France;62;4;25;453;Hézecques;122;0;122
32;Hauts-de-France;62;2;12;454;Hinges;2452;49;2501
32;Hauts-de-France;62;6;19;455;Hocquinghen;112;1;113
32;Hauts-de-France;62;2;35;456;Houchin;718;12;730
32;Hauts-de-France;62;2;16;457;Houdain;7246;61;7307
32;Hauts-de-France;62;5;37;458;Houlle;1127;12;1139
32;Hauts-de-France;62;1;07;459;Houvin-Houvigneul;232;4;236
32;Hauts-de-France;62;4;10;460;Hubersent;269;7;276
32;Hauts-de-France;62;4;06;461;Huby-Saint-Leu;886;10;896
32;Hauts-de-France;62;1;38;462;Huclier;137;5;142
32;Hauts-de-France;62;4;33;463;Hucqueliers;464;37;501
32;Hauts-de-France;62;7;39;464;Hulluch;3448;31;3479
32;Hauts-de-France;62;1;07;465;Humbercamps;218;0;218
32;Hauts-de-France;62;4;33;466;Humbert;232;1;233
32;Hauts-de-France;62;1;38;467;Humerœuille;176;0;176
32;Hauts-de-France;62;1;38;468;Humières;229;2;231
32;Hauts-de-France;62;1;09;469;Inchy-en-Artois;624;9;633
32;Hauts-de-France;62;4;06;470;Incourt;86;2;88
32;Hauts-de-France;62;4;10;472;Inxent;162;6;168
32;Hauts-de-France;62;2;01;473;Isbergues;8845;78;8923
32;Hauts-de-France;62;3;36;474;Isques;1153;22;1175
32;Hauts-de-France;62;1;07;475;Ivergny;259;2;261
32;Hauts-de-France;62;1;15;476;Izel-lès-Équerchin;1011;10;1021
32;Hauts-de-France;62;1;07;477;Izel-lès-Hameau;727;15;742
32;Hauts-de-France;62;5;33;478;Journy;287;5;292
32;Hauts-de-France;62;2;11;479;Labeuvrière;1645;14;1659
32;Hauts-de-France;62;2;35;480;Labourse;2847;22;2869
32;Hauts-de-France;62;4;06;481;Labroye;165;3;168
32;Hauts-de-France;62;3;22;483;Lacres;247;2;249
32;Hauts-de-France;62;1;09;484;Lagnicourt-Marcel;331;4;335
32;Hauts-de-France;62;5;25;485;Laires;364;1;365
32;Hauts-de-France;62;2;01;486;Lambres;1061;14;1075
32;Hauts-de-France;62;3;22;487;Landrethun-le-Nord;1299;10;1309
32;Hauts-de-France;62;6;19;488;Landrethun-lès-Ardres;753;20;773
32;Hauts-de-France;62;2;11;489;Lapugnoy;3459;30;3489
32;Hauts-de-France;62;1;07;490;Lattre-Saint-Quentin;267;3;270
32;Hauts-de-France;62;2;12;491;Laventie;4994;81;5075
32;Hauts-de-France;62;4;25;492;Lebiez;250;2;252
32;Hauts-de-France;62;1;09;493;Lebucquière;234;3;237
32;Hauts-de-France;62;1;09;494;Léchelle;49;1;50
32;Hauts-de-France;62;5;33;495;Ledinghem;338;1;339
32;Hauts-de-France;62;4;24;496;Lefaux;238;6;244
32;Hauts-de-France;62;7;28;497;Leforest;7167;48;7215
32;Hauts-de-France;62;7;29;498;Lens;31415;199;31614
32;Hauts-de-France;62;4;10;499;Lépine;273;8;281
32;Hauts-de-France;62;2;31;500;Lespesses;405;3;408
32;Hauts-de-France;62;4;06;501;Lespinoy;222;2;224
32;Hauts-de-France;62;2;31;502;Lestrem;4532;69;4601
32;Hauts-de-France;62;3;22;503;Leubringhen;295;8;303
32;Hauts-de-France;62;5;33;504;Leulinghem;252;6;258
32;Hauts-de-France;62;3;22;505;Leulinghen-Bernes;470;5;475
32;Hauts-de-France;62;7;21;907;Libercourt;8355;43;8398
32;Hauts-de-France;62;6;19;506;Licques;1631;19;1650
32;Hauts-de-France;62;1;07;507;Liencourt;291;2;293
32;Hauts-de-France;62;2;31;508;Lières;380;10;390
32;Hauts-de-France;62;2;01;509;Liettres;327;4;331
32;Hauts-de-France;62;7;30;510;Liévin;30785;369;31154
32;Hauts-de-France;62;1;07;511;Lignereuil;137;1;138
32;Hauts-de-France;62;2;01;512;Ligny-lès-Aire;598;15;613
32;Hauts-de-France;62;1;38;514;Ligny-Saint-Flochel;258;3;261
32;Hauts-de-France;62;1;38;513;Ligny-sur-Canche;194;6;200
32;Hauts-de-France;62;1;09;515;Ligny-Thilloy;532;17;549
32;Hauts-de-France;62;2;31;516;Lillers;9931;83;10014
32;Hauts-de-France;62;2;01;517;Linghem;205;6;211
32;Hauts-de-France;62;1;38;518;Linzeux;153;3;156
32;Hauts-de-France;62;1;38;519;Lisbourg;591;8;599
32;Hauts-de-France;62;2;12;520;Locon;2465;36;2501
32;Hauts-de-France;62;4;06;521;La Loge;201;4;205
32;Hauts-de-France;62;7;29;523;Loison-sous-Lens;5410;47;5457
32;Hauts-de-France;62;4;06;522;Loison-sur-Créquoise;266;2;268
32;Hauts-de-France;62;3;22;524;Longfossé;1452;16;1468
32;Hauts-de-France;62;5;32;525;Longuenesse;11023;540;11563
32;Hauts-de-France;62;3;22;526;Longueville;138;2;140
32;Hauts-de-France;62;4;24;527;Longvilliers;247;6;253
32;Hauts-de-France;62;7;39;528;Loos-en-Gohelle;6751;57;6808
32;Hauts-de-France;62;2;23;529;Lorgies;1586;18;1604
32;Hauts-de-France;62;3;22;530;Lottinghen;545;9;554
32;Hauts-de-France;62;6;19;531;Louches;960;14;974
32;Hauts-de-France;62;2;05;532;Lozinghem;1262;14;1276
32;Hauts-de-France;62;4;25;533;Lugy;147;3;150
32;Hauts-de-France;62;5;33;534;Lumbres;3626;75;3701
32;Hauts-de-France;62;4;10;535;La Madelaine-sous-Montreuil;161;8;169
32;Hauts-de-France;62;1;07;536;Magnicourt-en-Comte;649;10;659
32;Hauts-de-France;62;1;07;537;Magnicourt-sur-Canche;117;4;121
32;Hauts-de-France;62;4;06;538;Maintenay;426;8;434
32;Hauts-de-France;62;1;38;539;Maisnil;242;3;245
32;Hauts-de-France;62;2;16;540;Maisnil-lès-Ruitz;1680;14;1694
32;Hauts-de-France;62;4;06;541;Maisoncelle;125;4;129
32;Hauts-de-France;62;1;07;542;Maizières;193;4;197
32;Hauts-de-France;62;5;25;543;Mametz;1997;31;2028
32;Hauts-de-France;62;1;07;544;Manin;185;1;186
32;Hauts-de-France;62;4;33;545;Maninghem;151;0;151
32;Hauts-de-France;62;3;22;546;Maninghen-Henne;314;15;329
32;Hauts-de-France;62;4;06;547;Marant;66;1;67
32;Hauts-de-France;62;6;34;548;Marck;10676;143;10819
32;Hauts-de-France;62;4;06;549;Marconne;1093;63;1156
32;Hauts-de-France;62;4;06;550;Marconnelle;1134;22;1156
32;Hauts-de-France;62;4;06;551;Marenla;243;2;245
32;Hauts-de-France;62;4;06;552;Maresquel-Ecquemicourt;986;8;994
32;Hauts-de-France;62;1;38;553;Marest;285;6;291
32;Hauts-de-France;62;4;24;554;Maresville;102;0;102
32;Hauts-de-France;62;2;05;555;Marles-les-Mines;5579;29;5608
32;Hauts-de-France;62;4;06;556;Marles-sur-Canche;299;4;303
32;Hauts-de-France;62;1;38;558;Marquay;179;1;180
32;Hauts-de-France;62;1;09;559;Marquion;976;14;990
32;Hauts-de-France;62;3;22;560;Marquise;5088;60;5148
32;Hauts-de-France;62;1;09;561;Martinpuich;196;1;197
32;Hauts-de-France;62;1;02;557;Marœuil;2464;63;2527
32;Hauts-de-France;62;4;25;562;Matringhem;185;2;187
32;Hauts-de-France;62;7;17;563;Mazingarbe;8053;50;8103
32;Hauts-de-France;62;2;01;564;Mazinghem;474;8;482
32;Hauts-de-France;62;4;25;565;Mencas;77;0;77
32;Hauts-de-France;62;3;22;566;Menneville;700;19;719
32;Hauts-de-France;62;5;37;567;Mentque-Nortbécourt;651;9;660
32;Hauts-de-France;62;1;04;568;Mercatel;697;7;704
32;Hauts-de-France;62;5;25;569;Merck-Saint-Liévin;656;6;662
32;Hauts-de-France;62;7;08;570;Méricourt;11363;75;11438
32;Hauts-de-France;62;4;24;571;Merlimont;3348;66;3414
32;Hauts-de-France;62;1;09;572;Metz-en-Couture;664;11;675
32;Hauts-de-France;62;7;39;573;Meurchin;3786;24;3810
32;Hauts-de-France;62;1;07;574;Mingoval;230;5;235
32;Hauts-de-France;62;1;38;576;Moncheaux-lès-Frévent;139;0;139
32;Hauts-de-France;62;1;38;577;Monchel-sur-Canche;90;0;90
32;Hauts-de-France;62;1;07;578;Monchiet;96;2;98
32;Hauts-de-France;62;1;07;579;Monchy-au-Bois;561;15;576
32;Hauts-de-France;62;1;38;580;Monchy-Breton;476;11;487
32;Hauts-de-France;62;1;38;581;Monchy-Cayeux;300;3;303
32;Hauts-de-France;62;1;03;582;Monchy-le-Preux;651;36;687
32;Hauts-de-France;62;1;07;583;Mondicourt;592;9;601
32;Hauts-de-France;62;2;31;584;Mont-Bernanchon;1359;22;1381
32;Hauts-de-France;62;1;02;589;Mont-Saint-Éloi;1023;20;1043
32;Hauts-de-France;62;4;10;585;Montcavrel;413;5;418
32;Hauts-de-France;62;1;07;586;Montenescourt;460;6;466
32;Hauts-de-France;62;7;27;587;Montigny-en-Gohelle;10198;60;10258
32;Hauts-de-France;62;4;10;588;Montreuil;2014;130;2144
32;Hauts-de-France;62;1;38;590;Monts-en-Ternois;63;0;63
32;Hauts-de-France;62;1;09;591;Morchies;210;3;213
32;Hauts-de-France;62;5;37;592;Moringhem;558;8;566
32;Hauts-de-France;62;1;09;593;Morval;94;2;96
32;Hauts-de-France;62;1;09;594;Mory;309;3;312
32;Hauts-de-France;62;5;37;595;Moulle;1117;28;1145
32;Hauts-de-France;62;4;06;596;Mouriez;249;5;254
32;Hauts-de-France;62;1;09;597;Moyenneville;272;3;275
32;Hauts-de-France;62;6;34;598;Muncq-Nieurlet;734;7;741
32;Hauts-de-France;62;3;22;599;Nabringhen;212;6;218
32;Hauts-de-France;62;1;38;600;Nédon;153;3;156
32;Hauts-de-France;62;1;38;601;Nédonchel;282;5;287
32;Hauts-de-France;62;4;10;602;Nempont-Saint-Firmin;198;2;200
32;Hauts-de-France;62;3;36;603;Nesles;953;18;971
32;Hauts-de-France;62;3;36;604;Neufchâtel-Hardelot;3746;74;3820
32;Hauts-de-France;62;4;06;605;Neulette;28;0;28
32;Hauts-de-France;62;2;12;606;Neuve-Chapelle;1440;12;1452
32;Hauts-de-France;62;1;38;607;Neuville-au-Cornet;71;2;73
32;Hauts-de-France;62;1;09;608;Neuville-Bourjonval;168;1;169
32;Hauts-de-France;62;1;02;609;Neuville-Saint-Vaast;1526;29;1555
32;Hauts-de-France;62;4;10;610;Neuville-sous-Montreuil;650;9;659
32;Hauts-de-France;62;1;04;611;Neuville-Vitasse;505;8;513
32;Hauts-de-France;62;1;15;612;Neuvireuil;574;12;586
32;Hauts-de-France;62;6;19;614;Nielles-lès-Ardres;557;14;571
32;Hauts-de-France;62;5;33;613;Nielles-lès-Bléquin;847;9;856
32;Hauts-de-France;62;6;18;615;Nielles-lès-Calais;281;5;286
32;Hauts-de-France;62;5;37;618;Nordausques;1273;14;1287
32;Hauts-de-France;62;1;09;619;Noreuil;160;2;162
32;Hauts-de-France;62;2;31;620;Norrent-Fontes;1398;23;1421
32;Hauts-de-France;62;5;37;622;Nort-Leulinghem;234;3;237
32;Hauts-de-France;62;6;34;621;Nortkerque;1613;25;1638
32;Hauts-de-France;62;6;34;623;Nouvelle-Église;679;8;687
32;Hauts-de-France;62;1;07;630;Noyelle-Vion;294;5;299
32;Hauts-de-France;62;7;28;624;Noyelles-Godault;5973;34;6007
32;Hauts-de-France;62;4;06;625;Noyelles-lès-Humières;53;2;55
32;Hauts-de-France;62;2;23;626;Noyelles-lès-Vermelles;2401;15;2416
32;Hauts-de-France;62;1;15;627;Noyelles-sous-Bellonne;812;17;829
32;Hauts-de-France;62;7;26;628;Noyelles-sous-Lens;6561;46;6607
32;Hauts-de-France;62;1;07;629;Noyellette;173;1;174
32;Hauts-de-France;62;1;38;631;Nuncq-Hautecôte;476;7;483
32;Hauts-de-France;62;1;06;616;Nœux-lès-Auxi;179;2;181
32;Hauts-de-France;62;2;35;617;Nœux-les-Mines;12074;72;12146
32;Hauts-de-France;62;2;11;632;Oblinghem;379;2;381
32;Hauts-de-France;62;6;34;634;Offekerque;1167;19;1186
32;Hauts-de-France;62;4;06;635;Offin;207;2;209
32;Hauts-de-France;62;3;22;636;Offrethun;264;13;277
32;Hauts-de-France;62;7;27;637;Oignies;9767;50;9817
32;Hauts-de-France;62;1;09;638;Oisy-le-Verger;1217;14;1231
32;Hauts-de-France;62;1;15;639;Oppy;399;9;408
32;Hauts-de-France;62;1;07;640;Orville;402;8;410
32;Hauts-de-France;62;1;38;641;Ostreville;239;3;242
32;Hauts-de-France;62;2;05;642;Ourton;769;9;778
32;Hauts-de-France;62;3;36;643;Outreau;13422;174;13596
32;Hauts-de-France;62;5;33;644;Ouve-Wirquin;506;7;513
32;Hauts-de-France;62;6;34;645;Oye-Plage;5373;82;5455
32;Hauts-de-France;62;1;09;646;Palluel;563;3;566
32;Hauts-de-France;62;4;06;647;Le Parcq;776;16;792
32;Hauts-de-France;62;4;33;648;Parenty;520;10;530
32;Hauts-de-France;62;1;07;649;Pas-en-Artois;762;10;772
32;Hauts-de-France;62;1;15;650;Pelves;740;7;747
32;Hauts-de-France;62;1;07;651;Penin;474;4;478
32;Hauts-de-France;62;1;38;652;Pernes;1686;28;1714
32;Hauts-de-France;62;3;13;653;Pernes-lès-Boulogne;421;19;440
32;Hauts-de-France;62;6;18;654;Peuplingues;777;10;787
32;Hauts-de-France;62;1;38;655;Pierremont;292;7;299
32;Hauts-de-France;62;5;33;656;Pihem;948;24;972
32;Hauts-de-France;62;6;18;657;Pihen-lès-Guînes;499;7;506
32;Hauts-de-France;62;3;13;658;Pittefaux;124;13;137
32;Hauts-de-France;62;4;25;659;Planques;81;1;82
32;Hauts-de-France;62;1;15;660;Plouvain;454;7;461
32;Hauts-de-France;62;6;34;662;Polincove;853;15;868
32;Hauts-de-France;62;1;07;663;Pommera;306;4;310
32;Hauts-de-France;62;1;07;664;Pommier;232;4;236
32;Hauts-de-France;62;1;06;665;Le Ponchel;207;6;213
32;Hauts-de-France;62;7;39;666;Pont-à-Vendin;3187;17;3204
32;Hauts-de-France;62;3;14;667;Le Portel;9240;103;9343
32;Hauts-de-France;62;1;38;668;Prédefin;190;2;192
32;Hauts-de-France;62;1;38;669;Pressy;317;5;322
32;Hauts-de-France;62;4;33;670;Preures;605;7;612
32;Hauts-de-France;62;1;09;671;Pronville-en-Artois;324;4;328
32;Hauts-de-France;62;1;07;672;Puisieux;661;5;666
32;Hauts-de-France;62;1;09;673;Quéant;657;10;667
32;Hauts-de-France;62;5;33;674;Quelmes;576;10;586
32;Hauts-de-France;62;5;33;675;Quercamps;269;2;271
32;Hauts-de-France;62;2;01;676;Quernes;458;7;465
32;Hauts-de-France;62;4;06;677;Le Quesnoy-en-Artois;347;5;352
32;Hauts-de-France;62;3;22;678;Quesques;676;3;679
32;Hauts-de-France;62;3;22;679;Questrecques;307;9;316
32;Hauts-de-France;62;1;15;680;Quiéry-la-Motte;737;13;750
32;Hauts-de-France;62;5;25;681;Quiestède;614;22;636
32;Hauts-de-France;62;4;33;682;Quilen;60;0;60
32;Hauts-de-France;62;1;06;683;Quœux-Haut-Maînil;257;1;258
32;Hauts-de-France;62;5;25;684;Racquinghem;2276;34;2310
32;Hauts-de-France;62;4;25;685;Radinghem;275;163;438
32;Hauts-de-France;62;1;38;686;Ramecourt;382;11;393
32;Hauts-de-France;62;4;10;688;Rang-du-Fliers;4171;118;4289
32;Hauts-de-France;62;1;07;689;Ransart;404;2;406
32;Hauts-de-France;62;4;06;690;Raye-sur-Authie;250;4;254
32;Hauts-de-France;62;5;33;692;Rebergues;375;4;379
32;Hauts-de-France;62;2;16;693;Rebreuve-Ranchicourt;1074;22;1096
32;Hauts-de-France;62;1;07;694;Rebreuve-sur-Canche;194;0;194
32;Hauts-de-France;62;1;07;695;Rebreuviette;268;3;271
32;Hauts-de-France;62;5;25;696;Reclinghem;241;2;243
32;Hauts-de-France;62;1;15;697;Récourt;211;0;211
32;Hauts-de-France;62;4;10;698;Recques-sur-Course;279;5;284
32;Hauts-de-France;62;6;34;699;Recques-sur-Hem;631;14;645
32;Hauts-de-France;62;4;06;700;Regnauville;213;1;214
32;Hauts-de-France;62;2;01;701;Rely;454;2;456
32;Hauts-de-France;62;5;33;702;Remilly-Wirquin;349;6;355
32;Hauts-de-France;62;1;15;703;Rémy;395;6;401
32;Hauts-de-France;62;5;25;704;Renty;624;20;644
32;Hauts-de-France;62;3;22;705;Rety;2096;16;2112
32;Hauts-de-France;62;2;12;706;Richebourg;2622;56;2678
32;Hauts-de-France;62;1;09;708;Riencourt-lès-Bapaume;35;1;36
32;Hauts-de-France;62;1;15;709;Riencourt-lès-Cagnicourt;262;5;267
32;Hauts-de-France;62;4;25;710;Rimboval;142;0;142
32;Hauts-de-France;62;3;22;711;Rinxent;3001;30;3031
32;Hauts-de-France;62;1;07;712;Rivière;1123;27;1150
32;Hauts-de-France;62;2;31;713;Robecq;1359;23;1382
32;Hauts-de-France;62;1;02;714;Roclincourt;782;19;801
32;Hauts-de-France;62;1;09;715;Rocquigny;285;0;285
32;Hauts-de-France;62;6;19;716;Rodelinghem;528;6;534
32;Hauts-de-France;62;1;38;717;Roëllecourt;538;10;548
32;Hauts-de-France;62;4;06;719;Rollancourt;307;39;346
32;Hauts-de-France;62;2;01;720;Rombly;46;2;48
32;Hauts-de-France;62;5;01;721;Roquetoire;1944;49;1993
32;Hauts-de-France;62;1;06;722;Rougefay;86;3;89
32;Hauts-de-France;62;4;06;723;Roussent;241;0;241
32;Hauts-de-France;62;7;26;724;Rouvroy;8738;37;8775
32;Hauts-de-France;62;4;25;725;Royon;135;0;135
32;Hauts-de-France;62;4;25;726;Ruisseauville;199;5;204
32;Hauts-de-France;62;2;35;727;Ruitz;1583;34;1617
32;Hauts-de-France;62;1;09;728;Rumaucourt;685;12;697
32;Hauts-de-France;62;4;33;729;Rumilly;254;5;259
32;Hauts-de-France;62;6;34;730;Ruminghem;1650;23;1673
32;Hauts-de-France;62;1;09;731;Ruyaulcourt;294;3;297
32;Hauts-de-France;62;1;15;718;Rœux;1446;20;1466
32;Hauts-de-France;62;1;38;732;Sachin;345;5;350
32;Hauts-de-France;62;1;07;733;Sailly-au-Bois;309;1;310
32;Hauts-de-France;62;1;15;734;Sailly-en-Ostrevent;722;11;733
32;Hauts-de-France;62;2;23;735;Sailly-Labourse;2336;17;2353
32;Hauts-de-France;62;2;12;736;Sailly-sur-la-Lys;3982;72;4054
32;Hauts-de-France;62;7;17;737;Sains-en-Gohelle;6145;38;6183
32;Hauts-de-France;62;4;25;738;Sains-lès-Fressin;162;4;166
32;Hauts-de-France;62;1;09;739;Sains-lès-Marquion;322;3;325
32;Hauts-de-France;62;1;38;740;Sains-lès-Pernes;292;9;301
32;Hauts-de-France;62;1;07;741;Saint-Amand;122;3;125
32;Hauts-de-France;62;4;24;742;Saint-Aubin;264;6;270
32;Hauts-de-France;62;5;25;691;Saint-Augustin;805;13;818
32;Hauts-de-France;62;4;06;745;Saint-Denœux;160;0;160
32;Hauts-de-France;62;3;36;746;Saint-Étienne-au-Mont;5076;64;5140
32;Hauts-de-France;62;2;31;747;Saint-Floris;592;15;607
32;Hauts-de-France;62;6;34;748;Saint-Folquin;2248;39;2287
32;Hauts-de-France;62;4;06;749;Saint-Georges;326;6;332
32;Hauts-de-France;62;2;01;750;Saint-Hilaire-Cottes;807;9;816
32;Hauts-de-France;62;3;22;751;Saint-Inglevert;783;9;792
32;Hauts-de-France;62;4;24;752;Saint-Josse;1136;26;1162
32;Hauts-de-France;62;1;03;753;Saint-Laurent-Blangy;6606;64;6670
32;Hauts-de-France;62;1;09;754;Saint-Léger;450;4;454
32;Hauts-de-France;62;3;36;755;Saint-Léonard;3452;53;3505
32;Hauts-de-France;62;3;14;758;Saint-Martin-Boulogne;11204;186;11390
32;Hauts-de-France;62;3;22;759;Saint-Martin-Choquel;482;8;490
32;Hauts-de-France;62;5;25;760;Saint-Martin-d'Hardinghem;286;3;289
32;Hauts-de-France;62;5;37;757;Saint-Martin-lez-Tatinghem;5906;136;6042
32;Hauts-de-France;62;1;04;761;Saint-Martin-sur-Cojeul;210;4;214
32;Hauts-de-France;62;4;33;762;Saint-Michel-sous-Bois;119;5;124
32;Hauts-de-France;62;1;38;763;Saint-Michel-sur-Ternoise;878;15;893
32;Hauts-de-France;62;1;03;764;Saint-Nicolas;4738;50;4788
32;Hauts-de-France;62;5;37;765;Saint-Omer;14782;688;15470
32;Hauts-de-France;62;6;34;766;Saint-Omer-Capelle;1095;12;1107
32;Hauts-de-France;62;1;38;767;Saint-Pol-sur-Ternoise;4971;174;5145
32;Hauts-de-France;62;4;06;768;Saint-Rémy-au-Bois;101;2;103
32;Hauts-de-France;62;6;18;769;Saint-Tricat;760;14;774
32;Hauts-de-France;62;2;31;770;Saint-Venant;3027;85;3112
32;Hauts-de-France;62;4;06;743;Sainte-Austreberthe;401;9;410
32;Hauts-de-France;62;1;02;744;Sainte-Catherine;3511;56;3567
32;Hauts-de-France;62;6;34;756;Sainte-Marie-Kerque;1648;30;1678
32;Hauts-de-France;62;7;08;771;Sallaumines;9715;37;9752
32;Hauts-de-France;62;5;37;772;Salperwick;486;25;511
32;Hauts-de-France;62;3;22;773;Samer;4496;143;4639
32;Hauts-de-France;62;6;18;774;Sangatte;4820;126;4946
32;Hauts-de-France;62;6;19;775;Sanghen;329;2;331
32;Hauts-de-France;62;1;09;776;Sapignies;196;4;200
32;Hauts-de-France;62;1;09;777;Le Sars;180;1;181
32;Hauts-de-France;62;1;07;778;Sars-le-Bois;82;1;83
32;Hauts-de-France;62;1;07;779;Sarton;183;0;183
32;Hauts-de-France;62;1;09;780;Sauchy-Cauchy;364;4;368
32;Hauts-de-France;62;1;09;781;Sauchy-Lestrée;455;3;458
32;Hauts-de-France;62;1;15;782;Saudemont;449;8;457
32;Hauts-de-France;62;4;06;783;Saulchoy;317;1;318
32;Hauts-de-France;62;1;07;784;Saulty;765;12;777
32;Hauts-de-France;62;1;07;785;Savy-Berlette;916;183;1099
32;Hauts-de-France;62;3;22;786;Selles;333;3;336
32;Hauts-de-France;62;4;06;787;Sempy;325;3;328
32;Hauts-de-France;62;5;33;788;Seninghem;722;17;739
32;Hauts-de-France;62;3;22;789;Senlecques;269;1;270
32;Hauts-de-France;62;4;25;790;Senlis;163;4;167
32;Hauts-de-France;62;1;38;791;Séricourt;54;0;54
32;Hauts-de-France;62;5;37;792;Serques;1148;32;1180
32;Hauts-de-France;62;7;17;793;Servins;1093;12;1105
32;Hauts-de-France;62;5;33;794;Setques;608;6;614
32;Hauts-de-France;62;1;38;795;Sibiville;111;2;113
32;Hauts-de-France;62;1;07;796;Simencourt;557;12;569
32;Hauts-de-France;62;1;38;797;Siracourt;269;3;272
32;Hauts-de-France;62;1;07;798;Sombrin;240;7;247
32;Hauts-de-France;62;4;10;799;Sorrus;817;13;830
32;Hauts-de-France;62;1;07;800;Souastre;379;3;382
32;Hauts-de-France;62;7;17;801;Souchez;2496;35;2531
32;Hauts-de-France;62;1;07;802;Le Souich;154;1;155
32;Hauts-de-France;62;5;33;803;Surques;640;5;645
32;Hauts-de-France;62;1;07;804;Sus-Saint-Léger;376;2;378
32;Hauts-de-France;62;1;38;805;Tangry;252;1;253
32;Hauts-de-France;62;3;22;806;Tardinghen;151;4;155
32;Hauts-de-France;62;1;38;808;Teneur;260;0;260
32;Hauts-de-France;62;1;38;809;Ternas;137;3;140
32;Hauts-de-France;62;1;03;810;Thélus;1204;36;1240
32;Hauts-de-France;62;5;25;811;Thérouanne;1115;24;1139
32;Hauts-de-France;62;5;25;812;Thiembronne;834;7;841
32;Hauts-de-France;62;1;38;813;La Thieuloye;493;2;495
32;Hauts-de-France;62;1;07;814;Thièvres;123;1;124
32;Hauts-de-France;62;4;10;815;Tigny-Noyelle;174;0;174
32;Hauts-de-France;62;1;07;816;Tilloy-lès-Hermaville;223;5;228
32;Hauts-de-France;62;1;04;817;Tilloy-lès-Mofflaines;1434;116;1550
32;Hauts-de-France;62;1;38;818;Tilly-Capelle;159;1;160
32;Hauts-de-France;62;5;37;819;Tilques;1099;30;1129
32;Hauts-de-France;62;1;07;820;Tincques;825;16;841
32;Hauts-de-France;62;3;22;821;Tingry;290;7;297
32;Hauts-de-France;62;1;06;822;Tollent;91;3;94
32;Hauts-de-France;62;4;25;823;Torcy;165;5;170
32;Hauts-de-France;62;4;06;824;Tortefontaine;222;5;227
32;Hauts-de-France;62;1;15;825;Tortequesne;826;8;834
32;Hauts-de-France;62;4;24;826;Le Touquet-Paris-Plage;4223;239;4462
32;Hauts-de-France;62;5;37;827;Tournehem-sur-la-Hem;1436;17;1453
32;Hauts-de-France;62;4;06;828;Tramecourt;60;0;60
32;Hauts-de-France;62;1;09;829;Le Transloy;411;3;414
32;Hauts-de-France;62;1;09;830;Trescault;178;2;180
32;Hauts-de-France;62;1;38;831;Troisvaux;279;7;286
32;Hauts-de-France;62;4;24;832;Tubersent;538;3;541
32;Hauts-de-France;62;1;38;833;Vacquerie-le-Boucq;84;2;86
32;Hauts-de-France;62;4;06;834;Vacqueriette-Erquières;253;4;257
32;Hauts-de-France;62;1;38;835;Valhuon;569;19;588
32;Hauts-de-France;62;2;35;836;Vaudricourt;971;26;997
32;Hauts-de-France;62;5;33;837;Vaudringhem;532;8;540
32;Hauts-de-France;62;1;06;838;Vaulx;90;3;93
32;Hauts-de-France;62;1;09;839;Vaulx-Vraucourt;1018;9;1027
32;Hauts-de-France;62;1;09;840;Vélu;135;0;135
32;Hauts-de-France;62;7;39;842;Vendin-le-Vieil;8608;42;8650
32;Hauts-de-France;62;2;11;841;Vendin-lès-Béthune;2443;24;2467
32;Hauts-de-France;62;4;25;843;Verchin;241;5;246
32;Hauts-de-France;62;4;33;844;Verchocq;645;14;659
32;Hauts-de-France;62;3;22;845;Verlincthun;444;5;449
32;Hauts-de-France;62;2;23;846;Vermelles;4726;39;4765
32;Hauts-de-France;62;2;12;847;Verquigneul;1929;23;1952
32;Hauts-de-France;62;2;12;848;Verquin;3452;34;3486
32;Hauts-de-France;62;4;10;849;Verton;2425;56;2481
32;Hauts-de-France;62;4;06;850;Vieil-Hesdin;356;6;362
32;Hauts-de-France;62;3;22;853;Vieil-Moutier;386;10;396
32;Hauts-de-France;62;2;12;851;Vieille-Chapelle;778;16;794
32;Hauts-de-France;62;6;34;852;Vieille-Église;1382;14;1396
32;Hauts-de-France;62;7;17;854;Villers-au-Bois;568;11;579
32;Hauts-de-France;62;1;09;855;Villers-au-Flos;272;2;274
32;Hauts-de-France;62;1;07;856;Villers-Brûlin;365;4;369
32;Hauts-de-France;62;1;07;857;Villers-Châtel;135;11;146
32;Hauts-de-France;62;1;06;859;Villers-l'Hôpital;265;4;269
32;Hauts-de-France;62;1;15;858;Villers-lès-Cagnicourt;264;5;269
32;Hauts-de-France;62;1;07;860;Villers-Sir-Simon;118;3;121
32;Hauts-de-France;62;7;30;861;Vimy;4265;77;4342
32;Hauts-de-France;62;4;25;862;Vincly;158;3;161
32;Hauts-de-France;62;2;23;863;Violaines;3667;30;3697
32;Hauts-de-France;62;1;15;864;Vis-en-Artois;654;15;669
32;Hauts-de-France;62;1;15;865;Vitry-en-Artois;4677;49;4726
32;Hauts-de-France;62;4;10;866;Waben;431;15;446
32;Hauts-de-France;62;3;22;867;Wacquinghen;262;7;269
32;Hauts-de-France;62;4;06;868;Wail;262;6;268
32;Hauts-de-France;62;1;02;869;Wailly;1099;32;1131
32;Hauts-de-France;62;4;10;870;Wailly-Beaucamp;1004;19;1023
32;Hauts-de-France;62;4;06;871;Wambercourt;245;5;250
32;Hauts-de-France;62;4;06;872;Wamin;237;5;242
32;Hauts-de-France;62;1;04;873;Wancourt;649;10;659
32;Hauts-de-France;62;1;07;874;Wanquetin;719;15;734
32;Hauts-de-France;62;5;25;875;Wardrecques;1333;23;1356
32;Hauts-de-France;62;1;09;876;Warlencourt-Eaucourt;138;2;140
32;Hauts-de-France;62;1;07;877;Warlincourt-lès-Pas;174;5;179
32;Hauts-de-France;62;1;07;878;Warlus;377;7;384
32;Hauts-de-France;62;1;07;879;Warluzel;232;3;235
32;Hauts-de-France;62;3;22;880;Le Wast;206;3;209
32;Hauts-de-France;62;5;33;882;Wavrans-sur-l'Aa;1270;35;1305
32;Hauts-de-France;62;1;38;883;Wavrans-sur-Ternoise;201;0;201
32;Hauts-de-France;62;2;31;885;Westrehem;244;1;245
32;Hauts-de-France;62;4;33;886;Wicquinghem;252;3;255
32;Hauts-de-France;62;4;24;887;Widehem;244;1;245
32;Hauts-de-France;62;3;22;888;Wierre-au-Bois;226;0;226
32;Hauts-de-France;62;3;22;889;Wierre-Effroy;857;19;876
32;Hauts-de-France;62;4;06;890;Willeman;188;1;189
32;Hauts-de-France;62;1;06;891;Willencourt;134;2;136
32;Hauts-de-France;62;1;03;892;Willerval;651;20;671
32;Hauts-de-France;62;3;13;893;Wimereux;6575;168;6743
32;Hauts-de-France;62;3;13;894;Wimille;4083;80;4163
32;Hauts-de-France;62;7;39;895;Wingles;8770;60;8830
32;Hauts-de-France;62;3;22;896;Wirwignes;746;21;767
32;Hauts-de-France;62;5;33;897;Wismes;491;9;500
32;Hauts-de-France;62;5;33;898;Wisques;226;9;235
32;Hauts-de-France;62;3;22;899;Wissant;939;18;957
32;Hauts-de-France;62;2;01;900;Witternesse;587;16;603
32;Hauts-de-France;62;5;01;901;Wittes;961;12;973
32;Hauts-de-France;62;5;32;902;Wizernes;3344;53;3397
32;Hauts-de-France;62;1;09;909;Ytres;435;5;440
32;Hauts-de-France;62;4;33;903;Zoteux;615;4;619
32;Hauts-de-France;62;5;37;904;Zouafques;609;10;619
32;Hauts-de-France;62;5;33;905;Zudausques;915;45;960
32;Hauts-de-France;62;6;34;906;Zutkerque;1753;21;1774
32;Hauts-de-France;62;1;38;633;Œuf-en-Ternois;249;3;252
84;Auvergne-Rhône-Alpes;63;4;01;001;Aigueperse;2732;31;2763
84;Auvergne-Rhône-Alpes;63;1;22;002;Aix-la-Fayette;93;0;93
84;Auvergne-Rhône-Alpes;63;1;02;003;Ambert;6671;252;6923
84;Auvergne-Rhône-Alpes;63;4;27;004;Les Ancizes-Comps;1610;29;1639
84;Auvergne-Rhône-Alpes;63;3;06;005;Antoingt;397;4;401
84;Auvergne-Rhône-Alpes;63;3;06;006;Anzat-le-Luguet;178;2;180
84;Auvergne-Rhône-Alpes;63;3;06;007;Apchat;166;3;169
84;Auvergne-Rhône-Alpes;63;5;30;008;Arconsat;604;12;616
84;Auvergne-Rhône-Alpes;63;3;06;009;Ardes;561;6;567
84;Auvergne-Rhône-Alpes;63;1;02;010;Arlanc;1892;40;1932
84;Auvergne-Rhône-Alpes;63;4;26;011;Ars-les-Favets;225;6;231
84;Auvergne-Rhône-Alpes;63;4;01;012;Artonne;898;17;915
84;Auvergne-Rhône-Alpes;63;4;01;013;Aubiat;890;12;902
84;Auvergne-Rhône-Alpes;63;2;03;014;Aubière;10061;150;10211
84;Auvergne-Rhône-Alpes;63;5;22;015;Aubusson-d'Auvergne;261;4;265
84;Auvergne-Rhône-Alpes;63;5;22;016;Augerolles;888;19;907
84;Auvergne-Rhône-Alpes;63;3;06;017;Augnat;172;1;173
84;Auvergne-Rhône-Alpes;63;3;18;160;Aulhat-Flat;911;31;942
84;Auvergne-Rhône-Alpes;63;2;17;019;Aulnat;4046;39;4085
84;Auvergne-Rhône-Alpes;63;3;23;020;Aurières;331;11;342
84;Auvergne-Rhône-Alpes;63;2;21;021;Authezat;679;8;687
84;Auvergne-Rhône-Alpes;63;3;06;022;Auzat-la-Combelle;2076;34;2110
84;Auvergne-Rhône-Alpes;63;1;22;023;Auzelles;364;9;373
84;Auvergne-Rhône-Alpes;63;3;29;024;Avèze;178;4;182
84;Auvergne-Rhône-Alpes;63;4;26;025;Ayat-sur-Sioule;145;4;149
84;Auvergne-Rhône-Alpes;63;2;23;026;Aydat;2373;41;2414
84;Auvergne-Rhône-Alpes;63;1;02;027;Baffie;112;1;113
84;Auvergne-Rhône-Alpes;63;3;29;028;Bagnols;440;8;448
84;Auvergne-Rhône-Alpes;63;3;06;029;Bansat;253;3;256
84;Auvergne-Rhône-Alpes;63;4;20;030;Bas-et-Lezat;333;6;339
84;Auvergne-Rhône-Alpes;63;3;06;031;Beaulieu;461;4;465
84;Auvergne-Rhône-Alpes;63;2;04;032;Beaumont;10787;236;11023
84;Auvergne-Rhône-Alpes;63;4;20;033;Beaumont-lès-Randan;295;2;297
84;Auvergne-Rhône-Alpes;63;2;05;034;Beauregard-l'Évêque;1518;28;1546
84;Auvergne-Rhône-Alpes;63;4;27;035;Beauregard-Vendon;1194;18;1212
84;Auvergne-Rhône-Alpes;63;3;06;036;Bergonne;339;4;343
84;Auvergne-Rhône-Alpes;63;1;22;037;Bertignat;455;14;469
84;Auvergne-Rhône-Alpes;63;3;29;038;Besse-et-Saint-Anastaise;1504;67;1571
84;Auvergne-Rhône-Alpes;63;1;02;039;Beurières;297;10;307
84;Auvergne-Rhône-Alpes;63;2;05;040;Billom;4741;84;4825
84;Auvergne-Rhône-Alpes;63;4;26;041;Biollet;329;6;335
84;Auvergne-Rhône-Alpes;63;2;07;042;Blanzat;3749;55;3804
84;Auvergne-Rhône-Alpes;63;4;27;043;Blot-l'Église;421;3;424
84;Auvergne-Rhône-Alpes;63;2;05;044;Bongheat;427;4;431
84;Auvergne-Rhône-Alpes;63;5;19;045;Bort-l'Étang;657;4;661
84;Auvergne-Rhône-Alpes;63;3;06;046;Boudes;287;4;291
84;Auvergne-Rhône-Alpes;63;3;29;047;La Bourboule;1789;49;1838
84;Auvergne-Rhône-Alpes;63;4;28;048;Bourg-Lastic;877;26;903
84;Auvergne-Rhône-Alpes;63;2;05;049;Bouzel;727;7;734
84;Auvergne-Rhône-Alpes;63;3;06;050;Brassac-les-Mines;3311;119;3430
84;Auvergne-Rhône-Alpes;63;3;18;051;Brenat;622;13;635
84;Auvergne-Rhône-Alpes;63;3;06;052;Le Breuil-sur-Couze;1046;93;1139
84;Auvergne-Rhône-Alpes;63;4;28;053;Briffons;269;12;281
84;Auvergne-Rhône-Alpes;63;3;18;054;Le Broc;679;16;695
84;Auvergne-Rhône-Alpes;63;4;28;055;Bromont-Lamothe;976;16;992
84;Auvergne-Rhône-Alpes;63;1;22;056;Brousse;339;4;343
84;Auvergne-Rhône-Alpes;63;1;22;057;Le Brugeron;245;6;251
84;Auvergne-Rhône-Alpes;63;5;19;058;Bulhon;530;9;539
84;Auvergne-Rhône-Alpes;63;2;31;059;Busséol;218;5;223
84;Auvergne-Rhône-Alpes;63;4;26;060;Bussières;92;0;92
84;Auvergne-Rhône-Alpes;63;4;01;061;Bussières-et-Pruns;450;7;457
84;Auvergne-Rhône-Alpes;63;4;26;062;Buxières-sous-Montaigut;237;3;240
84;Auvergne-Rhône-Alpes;63;2;07;063;Cébazat;8604;107;8711
84;Auvergne-Rhône-Alpes;63;1;22;065;Ceilloux;177;5;182
84;Auvergne-Rhône-Alpes;63;4;28;064;La Celle;84;0;84
84;Auvergne-Rhône-Alpes;63;5;30;066;Celles-sur-Durolle;1738;23;1761
84;Auvergne-Rhône-Alpes;63;4;26;067;La Cellette;169;2;171
84;Auvergne-Rhône-Alpes;63;2;16;069;Le Cendre;5426;57;5483
84;Auvergne-Rhône-Alpes;63;2;04;070;Ceyrat;6416;134;6550
84;Auvergne-Rhône-Alpes;63;3;23;071;Ceyssat;693;11;704
84;Auvergne-Rhône-Alpes;63;5;30;072;Chabreloche;1220;19;1239
84;Auvergne-Rhône-Alpes;63;3;31;073;Chadeleuf;428;12;440
84;Auvergne-Rhône-Alpes;63;3;06;074;Chalus;178;0;178
84;Auvergne-Rhône-Alpes;63;2;08;075;Chamalières;17173;653;17826
84;Auvergne-Rhône-Alpes;63;4;25;244;Chambaron sur Morge;1749;24;1773
84;Auvergne-Rhône-Alpes;63;1;22;076;Chambon-sur-Dolore;161;8;169
84;Auvergne-Rhône-Alpes;63;3;29;077;Chambon-sur-Lac;417;3;420
84;Auvergne-Rhône-Alpes;63;3;06;079;Champagnat-le-Jeune;149;2;151
84;Auvergne-Rhône-Alpes;63;3;29;080;Champeix;1360;22;1382
84;Auvergne-Rhône-Alpes;63;1;02;081;Champétières;272;6;278
84;Auvergne-Rhône-Alpes;63;4;27;082;Champs;399;8;407
84;Auvergne-Rhône-Alpes;63;4;23;083;Chanat-la-Mouteyre;941;28;969
84;Auvergne-Rhône-Alpes;63;2;21;084;Chanonat;1685;39;1724
84;Auvergne-Rhône-Alpes;63;4;28;085;Chapdes-Beaufort;1100;8;1108
84;Auvergne-Rhône-Alpes;63;1;22;086;La Chapelle-Agnon;346;12;358
84;Auvergne-Rhône-Alpes;63;3;06;087;La Chapelle-Marcousse;63;0;63
84;Auvergne-Rhône-Alpes;63;3;06;088;La Chapelle-sur-Usson;74;0;74
84;Auvergne-Rhône-Alpes;63;4;01;089;Chappes;1655;27;1682
84;Auvergne-Rhône-Alpes;63;4;01;090;Chaptuzat;491;8;499
84;Auvergne-Rhône-Alpes;63;3;06;091;Charbonnier-les-Mines;898;15;913
84;Auvergne-Rhône-Alpes;63;4;28;092;Charbonnières-les-Varennes;1728;26;1754
84;Auvergne-Rhône-Alpes;63;4;27;093;Charbonnières-les-Vieilles;1075;20;1095
84;Auvergne-Rhône-Alpes;63;4;26;094;Charensat;506;4;510
84;Auvergne-Rhône-Alpes;63;5;20;095;Charnat;210;3;213
84;Auvergne-Rhône-Alpes;63;2;05;096;Chas;379;7;386
84;Auvergne-Rhône-Alpes;63;3;06;097;Chassagne;73;0;73
84;Auvergne-Rhône-Alpes;63;3;29;098;Chastreix;226;8;234
84;Auvergne-Rhône-Alpes;63;4;26;101;Château-sur-Cher;74;1;75
84;Auvergne-Rhône-Alpes;63;2;09;099;Châteaugay;3135;55;3190
84;Auvergne-Rhône-Alpes;63;4;26;100;Châteauneuf-les-Bains;316;4;320
84;Auvergne-Rhône-Alpes;63;4;09;103;Châtel-Guyon;6152;146;6298
84;Auvergne-Rhône-Alpes;63;5;20;102;Châteldon;773;12;785
84;Auvergne-Rhône-Alpes;63;1;02;104;La Chaulme;115;5;120
84;Auvergne-Rhône-Alpes;63;1;02;105;Chaumont-le-Bourg;231;6;237
84;Auvergne-Rhône-Alpes;63;2;05;106;Chauriat;1677;18;1695
84;Auvergne-Rhône-Alpes;63;4;01;107;Chavaroux;477;9;486
84;Auvergne-Rhône-Alpes;63;4;25;108;Le Cheix;663;14;677
84;Auvergne-Rhône-Alpes;63;3;29;109;Chidrac;523;12;535
84;Auvergne-Rhône-Alpes;63;4;28;110;Cisternes-la-Forêt;461;5;466
84;Auvergne-Rhône-Alpes;63;3;29;111;Clémensat;118;4;122
84;Auvergne-Rhône-Alpes;63;4;01;112;Clerlande;564;7;571
84;Auvergne-Rhône-Alpes;63;2;99;113;Clermont-Ferrand;143886;2746;146632
84;Auvergne-Rhône-Alpes;63;3;06;114;Collanges;158;1;159
84;Auvergne-Rhône-Alpes;63;4;28;115;Combrailles;218;4;222
84;Auvergne-Rhône-Alpes;63;4;27;116;Combronde;2206;34;2240
84;Auvergne-Rhône-Alpes;63;3;29;117;Compains;126;3;129
84;Auvergne-Rhône-Alpes;63;4;28;118;Condat-en-Combraille;422;7;429
84;Auvergne-Rhône-Alpes;63;1;22;119;Condat-lès-Montboissier;226;3;229
84;Auvergne-Rhône-Alpes;63;2;21;120;Corent;747;9;756
84;Auvergne-Rhône-Alpes;63;3;31;121;Coudes;1249;12;1261
84;Auvergne-Rhône-Alpes;63;3;29;122;Courgoul;66;1;67
84;Auvergne-Rhône-Alpes;63;2;23;123;Cournols;242;5;247
84;Auvergne-Rhône-Alpes;63;2;16;124;Cournon-d'Auvergne;20043;397;20440
84;Auvergne-Rhône-Alpes;63;5;22;125;Courpière;4050;144;4194
84;Auvergne-Rhône-Alpes;63;2;21;126;Le Crest;1267;27;1294
84;Auvergne-Rhône-Alpes;63;5;19;128;Crevant-Laveine;967;14;981
84;Auvergne-Rhône-Alpes;63;3;29;129;Cros;175;1;176
84;Auvergne-Rhône-Alpes;63;4;26;130;La Crouzille;262;11;273
84;Auvergne-Rhône-Alpes;63;5;19;131;Culhat;1130;18;1148
84;Auvergne-Rhône-Alpes;63;1;22;132;Cunlhat;1248;38;1286
84;Auvergne-Rhône-Alpes;63;3;06;134;Dauzat-sur-Vodable;80;2;82
84;Auvergne-Rhône-Alpes;63;4;27;135;Davayat;610;6;616
84;Auvergne-Rhône-Alpes;63;1;22;136;Domaize;389;8;397
84;Auvergne-Rhône-Alpes;63;1;02;137;Doranges;159;4;163
84;Auvergne-Rhône-Alpes;63;5;30;138;Dorat;705;7;712
84;Auvergne-Rhône-Alpes;63;1;02;139;Dore-l'Église;634;8;642
84;Auvergne-Rhône-Alpes;63;4;26;140;Durmignat;205;5;210
84;Auvergne-Rhône-Alpes;63;2;07;141;Durtol;2015;47;2062
84;Auvergne-Rhône-Alpes;63;1;22;142;Échandelys;258;8;266
84;Auvergne-Rhône-Alpes;63;4;01;143;Effiat;1119;18;1137
84;Auvergne-Rhône-Alpes;63;3;29;144;Égliseneuve-d'Entraigues;352;8;360
84;Auvergne-Rhône-Alpes;63;3;06;145;Égliseneuve-des-Liards;143;7;150
84;Auvergne-Rhône-Alpes;63;2;05;146;Égliseneuve-près-Billom;799;63;862
84;Auvergne-Rhône-Alpes;63;1;02;147;Églisolles;261;3;264
84;Auvergne-Rhône-Alpes;63;4;01;148;Ennezat;2484;52;2536
84;Auvergne-Rhône-Alpes;63;4;01;149;Entraigues;661;9;670
84;Auvergne-Rhône-Alpes;63;4;09;150;Enval;1486;29;1515
84;Auvergne-Rhône-Alpes;63;5;30;151;Escoutoux;1348;40;1388
84;Auvergne-Rhône-Alpes;63;4;26;152;Espinasse;294;4;298
84;Auvergne-Rhône-Alpes;63;3;29;153;Espinchal;104;2;106
84;Auvergne-Rhône-Alpes;63;2;05;154;Espirat;408;5;413
84;Auvergne-Rhône-Alpes;63;2;05;155;Estandeuil;452;7;459
84;Auvergne-Rhône-Alpes;63;3;06;156;Esteil;63;1;64
84;Auvergne-Rhône-Alpes;63;2;05;157;Fayet-le-Château;357;11;368
84;Auvergne-Rhône-Alpes;63;1;22;158;Fayet-Ronaye;106;6;112
84;Auvergne-Rhône-Alpes;63;4;28;159;Fernoël;131;2;133
84;Auvergne-Rhône-Alpes;63;1;02;161;La Forie;321;11;332
84;Auvergne-Rhône-Alpes;63;1;22;162;Fournols;317;9;326
84;Auvergne-Rhône-Alpes;63;3;23;163;Gelles;977;48;1025
84;Auvergne-Rhône-Alpes;63;2;17;164;Gerzat;10365;88;10453
84;Auvergne-Rhône-Alpes;63;4;28;165;Giat;816;39;855
84;Auvergne-Rhône-Alpes;63;3;06;166;Gignat;239;5;244
84;Auvergne-Rhône-Alpes;63;4;27;167;Gimeaux;401;5;406
84;Auvergne-Rhône-Alpes;63;2;05;168;Glaine-Montaigut;572;13;585
84;Auvergne-Rhône-Alpes;63;3;06;169;La Godivelle;14;0;14
84;Auvergne-Rhône-Alpes;63;4;28;170;La Goutelle;626;22;648
84;Auvergne-Rhône-Alpes;63;4;26;171;Gouttières;342;11;353
84;Auvergne-Rhône-Alpes;63;3;29;172;Grandeyrolles;53;1;54
84;Auvergne-Rhône-Alpes;63;1;02;173;Grandrif;186;6;192
84;Auvergne-Rhône-Alpes;63;1;22;174;Grandval;116;3;119
84;Auvergne-Rhône-Alpes;63;4;28;175;Herment;245;8;253
84;Auvergne-Rhône-Alpes;63;3;23;176;Heume-l'Église;105;3;108
84;Auvergne-Rhône-Alpes;63;2;05;177;Isserteaux;414;10;424
84;Auvergne-Rhône-Alpes;63;3;18;178;Issoire;14822;404;15226
84;Auvergne-Rhône-Alpes;63;1;02;179;Job;1018;28;1046
84;Auvergne-Rhône-Alpes;63;5;19;180;Joze;1101;18;1119
84;Auvergne-Rhône-Alpes;63;4;27;181;Jozerand;554;14;568
84;Auvergne-Rhône-Alpes;63;3;06;182;Jumeaux;635;13;648
84;Auvergne-Rhône-Alpes;63;3;29;183;Labessette;62;0;62
84;Auvergne-Rhône-Alpes;63;5;20;184;Lachaux;280;3;283
84;Auvergne-Rhône-Alpes;63;3;06;185;Lamontgie;649;8;657
84;Auvergne-Rhône-Alpes;63;4;28;186;Landogne;238;4;242
84;Auvergne-Rhône-Alpes;63;4;26;187;Lapeyrouse;551;12;563
84;Auvergne-Rhône-Alpes;63;2;31;188;Laps;594;14;608
84;Auvergne-Rhône-Alpes;63;3;23;189;Laqueuille;369;4;373
84;Auvergne-Rhône-Alpes;63;3;29;190;Larodde;265;7;272
84;Auvergne-Rhône-Alpes;63;4;28;191;Lastic;109;2;111
84;Auvergne-Rhône-Alpes;63;3;06;448;Le Vernet-Chaméane;808;64;872
84;Auvergne-Rhône-Alpes;63;2;24;193;Lempdes;8409;423;8832
84;Auvergne-Rhône-Alpes;63;5;19;194;Lempty;389;7;396
84;Auvergne-Rhône-Alpes;63;5;19;195;Lezoux;6152;73;6225
84;Auvergne-Rhône-Alpes;63;4;20;196;Limons;754;13;767
84;Auvergne-Rhône-Alpes;63;4;27;197;Lisseuil;122;1;123
84;Auvergne-Rhône-Alpes;63;4;27;198;Loubeyrat;1342;20;1362
84;Auvergne-Rhône-Alpes;63;3;29;199;Ludesse;489;6;495
84;Auvergne-Rhône-Alpes;63;4;01;200;Lussat;917;17;934
84;Auvergne-Rhône-Alpes;63;4;20;201;Luzillat;1131;18;1149
84;Auvergne-Rhône-Alpes;63;3;06;202;Madriat;109;3;112
84;Auvergne-Rhône-Alpes;63;4;09;203;Malauzat;1145;17;1162
84;Auvergne-Rhône-Alpes;63;4;17;204;Malintrat;1132;22;1154
84;Auvergne-Rhône-Alpes;63;2;31;205;Manglieu;468;4;472
84;Auvergne-Rhône-Alpes;63;4;27;206;Manzat;1371;20;1391
84;Auvergne-Rhône-Alpes;63;1;22;207;Marat;816;12;828
84;Auvergne-Rhône-Alpes;63;4;27;208;Marcillat;284;5;289
84;Auvergne-Rhône-Alpes;63;3;06;209;Mareugheol;198;6;204
84;Auvergne-Rhône-Alpes;63;4;20;210;Maringues;3154;26;3180
84;Auvergne-Rhône-Alpes;63;1;02;211;Marsac-en-Livradois;1458;45;1503
84;Auvergne-Rhône-Alpes;63;4;09;212;Marsat;1360;37;1397
84;Auvergne-Rhône-Alpes;63;4;01;213;Les Martres-d'Artière;2156;22;2178
84;Auvergne-Rhône-Alpes;63;2;21;214;Les Martres-de-Veyre;3976;56;4032
84;Auvergne-Rhône-Alpes;63;4;01;215;Martres-sur-Morge;670;8;678
84;Auvergne-Rhône-Alpes;63;2;05;216;Mauzun;115;4;119
84;Auvergne-Rhône-Alpes;63;1;02;218;Mayres;200;5;205
84;Auvergne-Rhône-Alpes;63;3;23;219;Mazaye;723;11;734
84;Auvergne-Rhône-Alpes;63;3;06;220;Mazoires;98;3;101
84;Auvergne-Rhône-Alpes;63;1;02;221;Medeyrolles;118;0;118
84;Auvergne-Rhône-Alpes;63;3;18;222;Meilhaud;496;9;505
84;Auvergne-Rhône-Alpes;63;4;26;223;Menat;547;12;559
84;Auvergne-Rhône-Alpes;63;4;09;224;Ménétrol;1635;25;1660
84;Auvergne-Rhône-Alpes;63;4;28;225;Messeix;1045;40;1085
84;Auvergne-Rhône-Alpes;63;2;31;227;Mirefleurs;2436;45;2481
84;Auvergne-Rhône-Alpes;63;4;28;228;Miremont;298;9;307
84;Auvergne-Rhône-Alpes;63;5;19;229;Moissat;1225;22;1247
84;Auvergne-Rhône-Alpes;63;1;22;230;Le Monestier;210;3;213
84;Auvergne-Rhône-Alpes;63;5;30;231;La Monnerie-le-Montel;1722;32;1754
84;Auvergne-Rhône-Alpes;63;4;20;232;Mons;538;13;551
84;Auvergne-Rhône-Alpes;63;3;29;236;Mont-Dore;1278;18;1296
84;Auvergne-Rhône-Alpes;63;4;26;233;Montaigut;987;8;995
84;Auvergne-Rhône-Alpes;63;3;29;234;Montaigut-le-Blanc;864;14;878
84;Auvergne-Rhône-Alpes;63;4;27;235;Montcel;504;7;511
84;Auvergne-Rhône-Alpes;63;4;28;237;Montel-de-Gelat;438;8;446
84;Auvergne-Rhône-Alpes;63;4;28;238;Montfermy;228;1;229
84;Auvergne-Rhône-Alpes;63;2;05;239;Montmorin;722;22;744
84;Auvergne-Rhône-Alpes;63;4;01;240;Montpensier;447;9;456
84;Auvergne-Rhône-Alpes;63;3;31;241;Montpeyroux;335;15;350
84;Auvergne-Rhône-Alpes;63;3;06;242;Moriat;366;9;375
84;Auvergne-Rhône-Alpes;63;4;26;243;Moureuille;363;5;368
84;Auvergne-Rhône-Alpes;63;4;09;245;Mozac;3878;64;3942
84;Auvergne-Rhône-Alpes;63;2;89;226;Mur-sur-Allier;3412;74;3486
84;Auvergne-Rhône-Alpes;63;3;29;246;Murat-le-Quaire;472;16;488
84;Auvergne-Rhône-Alpes;63;3;29;247;Murol;588;10;598
84;Auvergne-Rhône-Alpes;63;3;23;248;Nébouzat;836;14;850
84;Auvergne-Rhône-Alpes;63;5;22;249;Néronde-sur-Dore;514;8;522
84;Auvergne-Rhône-Alpes;63;3;31;250;Neschers;834;18;852
84;Auvergne-Rhône-Alpes;63;4;26;251;Neuf-Église;291;7;298
84;Auvergne-Rhône-Alpes;63;2;05;252;Neuville;382;7;389
84;Auvergne-Rhône-Alpes;63;5;20;253;Noalhat;247;5;252
84;Auvergne-Rhône-Alpes;63;2;07;254;Nohanent;2225;36;2261
84;Auvergne-Rhône-Alpes;63;3;06;255;Nonette-Orsonnette;575;14;589
84;Auvergne-Rhône-Alpes;63;1;02;256;Novacelles;145;2;147
84;Auvergne-Rhône-Alpes;63;3;23;257;Olby;795;10;805
84;Auvergne-Rhône-Alpes;63;1;22;258;Olliergues;752;20;772
84;Auvergne-Rhône-Alpes;63;2;23;259;Olloix;315;9;324
84;Auvergne-Rhône-Alpes;63;5;22;260;Olmet;165;5;170
84;Auvergne-Rhône-Alpes;63;3;18;261;Orbeil;841;28;869
84;Auvergne-Rhône-Alpes;63;2;21;262;Orcet;2669;38;2707
84;Auvergne-Rhône-Alpes;63;2;23;263;Orcines;3388;87;3475
84;Auvergne-Rhône-Alpes;63;3;23;264;Orcival;243;1;244
84;Auvergne-Rhône-Alpes;63;5;19;265;Orléat;2157;42;2199
84;Auvergne-Rhône-Alpes;63;5;30;267;Palladuc;549;13;562
84;Auvergne-Rhône-Alpes;63;3;18;268;Pardines;279;5;284
84;Auvergne-Rhône-Alpes;63;3;31;269;Parent;859;16;875
84;Auvergne-Rhône-Alpes;63;3;06;270;Parentignat;523;19;542
84;Auvergne-Rhône-Alpes;63;5;20;271;Paslières;1513;36;1549
84;Auvergne-Rhône-Alpes;63;2;03;272;Pérignat-lès-Sarliève;2680;68;2748
84;Auvergne-Rhône-Alpes;63;2;31;273;Pérignat-sur-Allier;1509;30;1539
84;Auvergne-Rhône-Alpes;63;3;23;274;Perpezat;432;6;438
84;Auvergne-Rhône-Alpes;63;3;18;275;Perrier;888;19;907
84;Auvergne-Rhône-Alpes;63;5;19;276;Peschadoires;2132;64;2196
84;Auvergne-Rhône-Alpes;63;3;06;277;Peslières;66;0;66
84;Auvergne-Rhône-Alpes;63;4;25;278;Pessat-Villeneuve;667;5;672
84;Auvergne-Rhône-Alpes;63;3;29;279;Picherande;347;6;353
84;Auvergne-Rhône-Alpes;63;2;31;280;Pignols;338;6;344
84;Auvergne-Rhône-Alpes;63;4;26;281;Pionsat;1087;21;1108
84;Auvergne-Rhône-Alpes;63;3;31;282;Plauzat;1667;21;1688
84;Auvergne-Rhône-Alpes;63;2;24;284;Pont-du-Château;11441;295;11736
84;Auvergne-Rhône-Alpes;63;4;28;283;Pontaumur;645;114;759
84;Auvergne-Rhône-Alpes;63;4;28;285;Pontgibaud;756;17;773
84;Auvergne-Rhône-Alpes;63;4;27;286;Pouzol;276;12;288
84;Auvergne-Rhône-Alpes;63;3;06;287;Les Pradeaux;337;7;344
84;Auvergne-Rhône-Alpes;63;4;27;288;Prompsat;429;13;442
84;Auvergne-Rhône-Alpes;63;4;28;289;Prondines;260;9;269
84;Auvergne-Rhône-Alpes;63;4;28;290;Pulvérières;406;8;414
84;Auvergne-Rhône-Alpes;63;5;20;291;Puy-Guillaume;2752;44;2796
84;Auvergne-Rhône-Alpes;63;4;28;292;Puy-Saint-Gulmier;159;4;163
84;Auvergne-Rhône-Alpes;63;4;26;293;Le Quartier;214;7;221
84;Auvergne-Rhône-Alpes;63;4;27;294;Queuille;276;6;282
84;Auvergne-Rhône-Alpes;63;4;20;295;Randan;1573;16;1589
84;Auvergne-Rhône-Alpes;63;5;19;296;Ravel;727;14;741
84;Auvergne-Rhône-Alpes;63;2;05;297;Reignat;389;1;390
84;Auvergne-Rhône-Alpes;63;5;22;298;La Renaudie;123;4;127
84;Auvergne-Rhône-Alpes;63;3;06;299;Rentières;113;0;113
84;Auvergne-Rhône-Alpes;63;4;25;300;Riom;19180;819;19999
84;Auvergne-Rhône-Alpes;63;5;20;301;Ris;765;8;773
84;Auvergne-Rhône-Alpes;63;2;21;302;La Roche-Blanche;3422;67;3489
84;Auvergne-Rhône-Alpes;63;3;06;303;Roche-Charles-la-Mayrand;40;0;40
84;Auvergne-Rhône-Alpes;63;4;26;304;Roche-d'Agoux;105;1;106
84;Auvergne-Rhône-Alpes;63;2;31;306;La Roche-Noire;618;9;627
84;Auvergne-Rhône-Alpes;63;3;23;305;Rochefort-Montagne;859;144;1003
84;Auvergne-Rhône-Alpes;63;2;03;307;Romagnat;7705;177;7882
84;Auvergne-Rhône-Alpes;63;2;08;308;Royat;4651;126;4777
84;Auvergne-Rhône-Alpes;63;1;02;309;Saillant;288;1;289
84;Auvergne-Rhône-Alpes;63;4;01;311;Saint-Agoulin;334;2;336
84;Auvergne-Rhône-Alpes;63;1;02;312;Saint-Alyre-d'Arlanc;170;4;174
84;Auvergne-Rhône-Alpes;63;3;06;313;Saint-Alyre-ès-Montagne;126;5;131
84;Auvergne-Rhône-Alpes;63;1;22;314;Saint-Amant-Roche-Savine;508;28;536
84;Auvergne-Rhône-Alpes;63;2;21;315;Saint-Amant-Tallende;1743;37;1780
84;Auvergne-Rhône-Alpes;63;4;20;317;Saint-André-le-Coq;526;3;529
84;Auvergne-Rhône-Alpes;63;4;27;318;Saint-Angel;427;9;436
84;Auvergne-Rhône-Alpes;63;1;02;319;Saint-Anthème;698;22;720
84;Auvergne-Rhône-Alpes;63;4;28;320;Saint-Avit;234;5;239
84;Auvergne-Rhône-Alpes;63;3;18;321;Saint-Babel;944;15;959
84;Auvergne-Rhône-Alpes;63;4;17;322;Saint-Beauzire;2180;31;2211
84;Auvergne-Rhône-Alpes;63;1;22;323;Saint-Bonnet-le-Bourg;163;3;166
84;Auvergne-Rhône-Alpes;63;1;22;324;Saint-Bonnet-le-Chastel;208;7;215
84;Auvergne-Rhône-Alpes;63;2;05;325;Saint-Bonnet-lès-Allier;427;6;433
84;Auvergne-Rhône-Alpes;63;3;23;326;Saint-Bonnet-près-Orcival;487;8;495
84;Auvergne-Rhône-Alpes;63;4;25;327;Saint-Bonnet-près-Riom;2114;40;2154
84;Auvergne-Rhône-Alpes;63;3;29;330;Saint-Cirgues-sur-Couze;351;5;356
84;Auvergne-Rhône-Alpes;63;4;20;332;Saint-Clément-de-Régnat;557;6;563
84;Auvergne-Rhône-Alpes;63;1;02;331;Saint-Clément-de-Valorgue;231;5;236
84;Auvergne-Rhône-Alpes;63;4;20;333;Saint-Denis-Combarnazat;223;8;231
84;Auvergne-Rhône-Alpes;63;2;05;334;Saint-Dier-d'Auvergne;519;22;541
84;Auvergne-Rhône-Alpes;63;3;29;335;Saint-Diéry;498;11;509
84;Auvergne-Rhône-Alpes;63;3;29;336;Saint-Donat;206;4;210
84;Auvergne-Rhône-Alpes;63;1;22;337;Saint-Éloy-la-Glacière;56;0;56
84;Auvergne-Rhône-Alpes;63;4;26;338;Saint-Éloy-les-Mines;3709;172;3881
84;Auvergne-Rhône-Alpes;63;4;28;339;Saint-Étienne-des-Champs;142;1;143
84;Auvergne-Rhône-Alpes;63;3;06;340;Saint-Étienne-sur-Usson;276;3;279
84;Auvergne-Rhône-Alpes;63;1;02;341;Saint-Ferréol-des-Côtes;544;17;561
84;Auvergne-Rhône-Alpes;63;3;29;342;Saint-Floret;251;7;258
84;Auvergne-Rhône-Alpes;63;5;22;343;Saint-Flour;285;3;288
84;Auvergne-Rhône-Alpes;63;4;27;344;Saint-Gal-sur-Sioule;135;4;139
84;Auvergne-Rhône-Alpes;63;2;04;345;Saint-Genès-Champanelle;3612;105;3717
84;Auvergne-Rhône-Alpes;63;3;29;346;Saint-Genès-Champespe;219;7;226
84;Auvergne-Rhône-Alpes;63;4;01;347;Saint-Genès-du-Retz;483;19;502
84;Auvergne-Rhône-Alpes;63;3;06;348;Saint-Genès-la-Tourette;180;1;181
84;Auvergne-Rhône-Alpes;63;4;27;349;Saint-Georges-de-Mons;1955;48;2003
84;Auvergne-Rhône-Alpes;63;2;31;350;Saint-Georges-sur-Allier;1250;16;1266
84;Auvergne-Rhône-Alpes;63;1;22;353;Saint-Germain-l'Herm;487;27;514
84;Auvergne-Rhône-Alpes;63;3;06;352;Saint-Germain-Lembron;1980;37;2017
84;Auvergne-Rhône-Alpes;63;4;28;351;Saint-Germain-près-Herment;84;1;85
84;Auvergne-Rhône-Alpes;63;4;26;354;Saint-Gervais-d'Auvergne;1340;120;1460
84;Auvergne-Rhône-Alpes;63;1;22;355;Saint-Gervais-sous-Meymont;235;6;241
84;Auvergne-Rhône-Alpes;63;3;06;356;Saint-Gervazy;329;12;341
84;Auvergne-Rhône-Alpes;63;3;06;357;Saint-Hérent;114;2;116
84;Auvergne-Rhône-Alpes;63;4;26;360;Saint-Hilaire;161;5;166
84;Auvergne-Rhône-Alpes;63;4;27;358;Saint-Hilaire-la-Croix;348;3;351
84;Auvergne-Rhône-Alpes;63;4;28;359;Saint-Hilaire-les-Monges;91;1;92
84;Auvergne-Rhône-Alpes;63;4;01;362;Saint-Ignat;903;16;919
84;Auvergne-Rhône-Alpes;63;4;28;363;Saint-Jacques-d'Ambur;276;6;282
84;Auvergne-Rhône-Alpes;63;5;19;364;Saint-Jean-d'Heurs;659;6;665
84;Auvergne-Rhône-Alpes;63;2;05;365;Saint-Jean-des-Ollières;451;11;462
84;Auvergne-Rhône-Alpes;63;3;06;366;Saint-Jean-en-Val;354;3;357
84;Auvergne-Rhône-Alpes;63;3;06;367;Saint-Jean-Saint-Gervais;124;1;125
84;Auvergne-Rhône-Alpes;63;2;05;368;Saint-Julien-de-Coppel;1276;25;1301
84;Auvergne-Rhône-Alpes;63;4;26;369;Saint-Julien-la-Geneste;121;3;124
84;Auvergne-Rhône-Alpes;63;3;28;370;Saint-Julien-Puy-Lavèze;359;4;363
84;Auvergne-Rhône-Alpes;63;1;02;371;Saint-Just;157;1;158
84;Auvergne-Rhône-Alpes;63;4;01;372;Saint-Laure;653;5;658
84;Auvergne-Rhône-Alpes;63;4;26;373;Saint-Maigner;190;3;193
84;Auvergne-Rhône-Alpes;63;3;06;376;Saint-Martin-d'Ollières;150;7;157
84;Auvergne-Rhône-Alpes;63;1;02;374;Saint-Martin-des-Olmes;287;7;294
84;Auvergne-Rhône-Alpes;63;3;06;375;Saint-Martin-des-Plains;155;1;156
84;Auvergne-Rhône-Alpes;63;2;31;378;Saint-Maurice;869;8;877
84;Auvergne-Rhône-Alpes;63;4;26;377;Saint-Maurice-près-Pionsat;371;5;376
84;Auvergne-Rhône-Alpes;63;4;27;379;Saint-Myon;485;6;491
84;Auvergne-Rhône-Alpes;63;3;29;380;Saint-Nectaire;741;3;744
84;Auvergne-Rhône-Alpes;63;4;28;381;Saint-Ours;1670;23;1693
84;Auvergne-Rhône-Alpes;63;4;27;382;Saint-Pardoux;404;14;418
84;Auvergne-Rhône-Alpes;63;3;29;383;Saint-Pierre-Colamine;249;5;254
84;Auvergne-Rhône-Alpes;63;1;22;384;Saint-Pierre-la-Bourlhonne;128;3;131
84;Auvergne-Rhône-Alpes;63;4;28;385;Saint-Pierre-le-Chastel;434;9;443
84;Auvergne-Rhône-Alpes;63;3;23;386;Saint-Pierre-Roche;463;4;467
84;Auvergne-Rhône-Alpes;63;4;20;387;Saint-Priest-Bramefant;865;17;882
84;Auvergne-Rhône-Alpes;63;4;26;388;Saint-Priest-des-Champs;702;14;716
84;Auvergne-Rhône-Alpes;63;3;06;389;Saint-Quentin-sur-Sauxillanges;112;0;112
84;Auvergne-Rhône-Alpes;63;4;27;390;Saint-Quintin-sur-Sioule;381;12;393
84;Auvergne-Rhône-Alpes;63;4;27;391;Saint-Rémy-de-Blot;230;4;234
84;Auvergne-Rhône-Alpes;63;3;06;392;Saint-Rémy-de-Chargnat;572;9;581
84;Auvergne-Rhône-Alpes;63;5;30;393;Saint-Rémy-sur-Durolle;1741;28;1769
84;Auvergne-Rhône-Alpes;63;1;02;394;Saint-Romain;212;6;218
84;Auvergne-Rhône-Alpes;63;2;23;395;Saint-Sandoux;955;18;973
84;Auvergne-Rhône-Alpes;63;2;23;396;Saint-Saturnin;1172;96;1268
84;Auvergne-Rhône-Alpes;63;3;29;397;Saint-Sauves-d'Auvergne;1133;20;1153
84;Auvergne-Rhône-Alpes;63;1;02;398;Saint-Sauveur-la-Sagne;95;1;96
84;Auvergne-Rhône-Alpes;63;4;28;399;Saint-Sulpice;87;6;93
84;Auvergne-Rhône-Alpes;63;4;20;400;Saint-Sylvestre-Pragoulin;1085;19;1104
84;Auvergne-Rhône-Alpes;63;3;29;401;Saint-Victor-la-Rivière;247;6;253
84;Auvergne-Rhône-Alpes;63;5;30;402;Saint-Victor-Montvianeix;249;6;255
84;Auvergne-Rhône-Alpes;63;3;29;403;Saint-Vincent;411;10;421
84;Auvergne-Rhône-Alpes;63;3;18;404;Saint-Yvoine;595;11;606
84;Auvergne-Rhône-Alpes;63;5;30;310;Sainte-Agathe;180;2;182
84;Auvergne-Rhône-Alpes;63;1;22;328;Sainte-Catherine;52;2;54
84;Auvergne-Rhône-Alpes;63;4;26;329;Sainte-Christine;126;3;129
84;Auvergne-Rhône-Alpes;63;2;31;405;Sallèdes;588;13;601
84;Auvergne-Rhône-Alpes;63;4;01;406;Sardon;314;2;316
84;Auvergne-Rhône-Alpes;63;2;23;407;Saulzet-le-Froid;272;7;279
84;Auvergne-Rhône-Alpes;63;4;26;408;Sauret-Besserve;164;3;167
84;Auvergne-Rhône-Alpes;63;3;29;409;Saurier;270;2;272
84;Auvergne-Rhône-Alpes;63;4;28;410;Sauvagnat;129;2;131
84;Auvergne-Rhône-Alpes;63;3;31;411;Sauvagnat-Sainte-Marthe;481;9;490
84;Auvergne-Rhône-Alpes;63;1;02;412;Sauvessanges;527;6;533
84;Auvergne-Rhône-Alpes;63;2;21;413;La Sauvetat;720;8;728
84;Auvergne-Rhône-Alpes;63;5;22;414;Sauviat;542;10;552
84;Auvergne-Rhône-Alpes;63;3;06;415;Sauxillanges;1255;13;1268
84;Auvergne-Rhône-Alpes;63;4;28;416;Savennes;94;8;102
84;Auvergne-Rhône-Alpes;63;4;07;417;Sayat;2344;32;2376
84;Auvergne-Rhône-Alpes;63;5;22;418;Sermentizon;576;8;584
84;Auvergne-Rhône-Alpes;63;4;26;419;Servant;531;11;542
84;Auvergne-Rhône-Alpes;63;5;19;420;Seychalles;785;11;796
84;Auvergne-Rhône-Alpes;63;3;29;421;Singles;167;5;172
84;Auvergne-Rhône-Alpes;63;3;29;422;Solignat;497;9;506
84;Auvergne-Rhône-Alpes;63;3;06;423;Sugères;605;9;614
84;Auvergne-Rhône-Alpes;63;4;01;424;Surat;567;12;579
84;Auvergne-Rhône-Alpes;63;2;21;425;Tallende;1521;42;1563
84;Auvergne-Rhône-Alpes;63;3;29;426;Tauves;780;16;796
84;Auvergne-Rhône-Alpes;63;4;27;427;Teilhède;457;13;470
84;Auvergne-Rhône-Alpes;63;4;26;428;Teilhet;289;2;291
84;Auvergne-Rhône-Alpes;63;3;06;429;Ternant-les-Eaux;37;2;39
84;Auvergne-Rhône-Alpes;63;5;30;430;Thiers;11847;322;12169
84;Auvergne-Rhône-Alpes;63;1;02;431;Thiolières;161;1;162
84;Auvergne-Rhône-Alpes;63;4;01;432;Thuret;921;49;970
84;Auvergne-Rhône-Alpes;63;4;28;433;Tortebesse;69;3;72
84;Auvergne-Rhône-Alpes;63;3;29;192;La Tour-d'Auvergne;640;30;670
84;Auvergne-Rhône-Alpes;63;1;22;434;Tours-sur-Meymont;516;23;539
84;Auvergne-Rhône-Alpes;63;3;29;435;Tourzel-Ronzières;246;1;247
84;Auvergne-Rhône-Alpes;63;4;28;436;Tralaigues;78;0;78
84;Auvergne-Rhône-Alpes;63;3;29;437;Trémouille-Saint-Loup;147;4;151
84;Auvergne-Rhône-Alpes;63;2;05;438;Trézioux;476;6;482
84;Auvergne-Rhône-Alpes;63;3;06;439;Usson;286;2;288
84;Auvergne-Rhône-Alpes;63;3;29;440;Valbeleix;127;0;127
84;Auvergne-Rhône-Alpes;63;1;02;441;Valcivières;209;3;212
84;Auvergne-Rhône-Alpes;63;3;06;442;Valz-sous-Châteauneuf;51;2;53
84;Auvergne-Rhône-Alpes;63;4;01;443;Varennes-sur-Morge;404;7;411
84;Auvergne-Rhône-Alpes;63;3;06;444;Varennes-sur-Usson;285;4;289
84;Auvergne-Rhône-Alpes;63;2;05;445;Vassel;289;5;294
84;Auvergne-Rhône-Alpes;63;4;01;446;Vensat;505;4;509
84;Auvergne-Rhône-Alpes;63;4;26;447;Vergheas;62;1;63
84;Auvergne-Rhône-Alpes;63;3;23;449;Le Vernet-Sainte-Marguerite;298;6;304
84;Auvergne-Rhône-Alpes;63;4;28;450;Verneugheol;241;11;252
84;Auvergne-Rhône-Alpes;63;3;23;451;Vernines;420;28;448
84;Auvergne-Rhône-Alpes;63;3;29;452;Verrières;71;2;73
84;Auvergne-Rhône-Alpes;63;2;05;453;Vertaizon;3187;31;3218
84;Auvergne-Rhône-Alpes;63;1;22;454;Vertolaye;535;11;546
84;Auvergne-Rhône-Alpes;63;2;21;455;Veyre-Monton;3542;58;3600
84;Auvergne-Rhône-Alpes;63;2;31;457;Vic-le-Comte;5197;107;5304
84;Auvergne-Rhône-Alpes;63;3;06;456;Vichel;352;10;362
84;Auvergne-Rhône-Alpes;63;3;06;458;Villeneuve;161;0;161
84;Auvergne-Rhône-Alpes;63;4;20;459;Villeneuve-les-Cerfs;532;4;536
84;Auvergne-Rhône-Alpes;63;4;28;460;Villosanges;349;9;358
84;Auvergne-Rhône-Alpes;63;5;19;461;Vinzelles;351;4;355
84;Auvergne-Rhône-Alpes;63;4;26;462;Virlet;272;4;276
84;Auvergne-Rhône-Alpes;63;5;30;463;Viscomtat;530;9;539
84;Auvergne-Rhône-Alpes;63;4;27;464;Vitrac;349;12;361
84;Auvergne-Rhône-Alpes;63;1;02;465;Viverols;408;9;417
84;Auvergne-Rhône-Alpes;63;3;29;466;Vodable;196;3;199
84;Auvergne-Rhône-Alpes;63;4;28;467;Voingt;33;1;34
84;Auvergne-Rhône-Alpes;63;5;30;468;Vollore-Montagne;305;8;313
84;Auvergne-Rhône-Alpes;63;5;22;469;Vollore-Ville;743;14;757
84;Auvergne-Rhône-Alpes;63;4;09;470;Volvic;4487;69;4556
84;Auvergne-Rhône-Alpes;63;4;26;471;Youx;915;19;934
84;Auvergne-Rhône-Alpes;63;2;31;472;Yronde-et-Buron;648;18;666
84;Auvergne-Rhône-Alpes;63;4;27;473;Yssac-la-Tourette;384;7;391
75;Nouvelle-Aquitaine;64;3;27;001;Aast;181;7;188
75;Nouvelle-Aquitaine;64;3;23;002;Abère;162;1;163
75;Nouvelle-Aquitaine;64;3;09;003;Abidos;226;7;233
75;Nouvelle-Aquitaine;64;2;16;004;Abitain;102;1;103
75;Nouvelle-Aquitaine;64;3;09;005;Abos;542;14;556
75;Nouvelle-Aquitaine;64;2;14;006;Accous;461;13;474
75;Nouvelle-Aquitaine;64;2;14;007;Agnos;1019;25;1044
75;Nouvelle-Aquitaine;64;1;12;008;Ahaxe-Alciette-Bascassan;274;13;287
75;Nouvelle-Aquitaine;64;1;26;009;Ahetze;2158;41;2199
75;Nouvelle-Aquitaine;64;1;22;010;Aïcirits-Camou-Suhast;670;16;686
75;Nouvelle-Aquitaine;64;1;12;011;Aincille;112;6;118
75;Nouvelle-Aquitaine;64;2;12;012;Ainharp;141;1;142
75;Nouvelle-Aquitaine;64;1;12;013;Ainhice-Mongelos;173;0;173
75;Nouvelle-Aquitaine;64;1;26;014;Ainhoa;672;7;679
75;Nouvelle-Aquitaine;64;1;12;016;Aldudes;322;6;328
75;Nouvelle-Aquitaine;64;2;12;017;Alos-Sibas-Abense;319;6;325
75;Nouvelle-Aquitaine;64;2;12;015;Alçay-Alçabéhéty-Sunharette;226;7;233
75;Nouvelle-Aquitaine;64;1;22;018;Amendeuix-Oneix;448;9;457
75;Nouvelle-Aquitaine;64;1;22;019;Amorots-Succos;232;1;233
75;Nouvelle-Aquitaine;64;2;14;225;Ance Féas;612;15;627
75;Nouvelle-Aquitaine;64;3;23;021;Andoins;637;12;649
75;Nouvelle-Aquitaine;64;2;16;022;Andrein;131;1;132
75;Nouvelle-Aquitaine;64;3;27;023;Angaïs;889;23;912
75;Nouvelle-Aquitaine;64;1;96;024;Anglet;38929;1229;40158
75;Nouvelle-Aquitaine;64;2;09;025;Angous;102;0;102
75;Nouvelle-Aquitaine;64;1;12;026;Anhaux;387;10;397
75;Nouvelle-Aquitaine;64;3;23;027;Anos;192;3;195
75;Nouvelle-Aquitaine;64;3;25;028;Anoye;144;2;146
75;Nouvelle-Aquitaine;64;2;14;029;Aramits;669;16;685
75;Nouvelle-Aquitaine;64;1;22;031;Arancou;162;3;165
75;Nouvelle-Aquitaine;64;2;09;032;Araujuzon;194;8;202
75;Nouvelle-Aquitaine;64;2;09;033;Araux;142;1;143
75;Nouvelle-Aquitaine;64;1;22;034;Arbérats-Sillègue;257;7;264
75;Nouvelle-Aquitaine;64;1;26;035;Arbonne;2223;59;2282
75;Nouvelle-Aquitaine;64;1;22;036;Arbouet-Sussaute;322;3;325
75;Nouvelle-Aquitaine;64;3;11;037;Arbus;1205;22;1227
75;Nouvelle-Aquitaine;64;1;26;038;Arcangues;3160;80;3240
75;Nouvelle-Aquitaine;64;2;14;039;Aren;246;1;247
75;Nouvelle-Aquitaine;64;3;17;041;Aressy;712;10;722
75;Nouvelle-Aquitaine;64;2;14;040;Arette;1057;31;1088
75;Nouvelle-Aquitaine;64;3;02;042;Argagnon;702;23;725
75;Nouvelle-Aquitaine;64;3;25;043;Argelos;282;4;286
75;Nouvelle-Aquitaine;64;3;02;044;Arget;78;1;79
75;Nouvelle-Aquitaine;64;1;22;045;Arhansus;74;1;75
75;Nouvelle-Aquitaine;64;1;22;046;Armendarits;405;4;409
75;Nouvelle-Aquitaine;64;1;12;047;Arnéguy;238;3;241
75;Nouvelle-Aquitaine;64;3;02;048;Arnos;113;1;114
75;Nouvelle-Aquitaine;64;1;22;049;Aroue-Ithorots-Olhaïby;240;8;248
75;Nouvelle-Aquitaine;64;2;12;050;Arrast-Larrebieu;95;3;98
75;Nouvelle-Aquitaine;64;1;22;051;Arraute-Charritte;385;6;391
75;Nouvelle-Aquitaine;64;3;25;052;Arricau-Bordes;108;0;108
75;Nouvelle-Aquitaine;64;3;23;053;Arrien;185;3;188
75;Nouvelle-Aquitaine;64;3;17;054;Arros-de-Nay;783;22;805
75;Nouvelle-Aquitaine;64;3;25;056;Arrosès;139;2;141
75;Nouvelle-Aquitaine;64;3;17;058;Arthez-d'Asson;491;10;501
75;Nouvelle-Aquitaine;64;3;02;057;Arthez-de-Béarn;1862;43;1905
75;Nouvelle-Aquitaine;64;3;23;059;Artigueloutan;1090;29;1119
75;Nouvelle-Aquitaine;64;3;11;060;Artiguelouve;1621;45;1666
75;Nouvelle-Aquitaine;64;3;02;061;Artix;3428;60;3488
75;Nouvelle-Aquitaine;64;2;15;062;Arudy;2229;46;2275
75;Nouvelle-Aquitaine;64;3;02;063;Arzacq-Arraziguet;1089;22;1111
75;Nouvelle-Aquitaine;64;2;14;064;Asasp-Arros;461;9;470
75;Nouvelle-Aquitaine;64;1;26;065;Ascain;4194;111;4305
75;Nouvelle-Aquitaine;64;1;12;066;Ascarat;321;9;330
75;Nouvelle-Aquitaine;64;3;17;067;Assat;1828;42;1870
75;Nouvelle-Aquitaine;64;3;17;068;Asson;2031;51;2082
75;Nouvelle-Aquitaine;64;2;15;069;Aste-Béon;237;6;243
75;Nouvelle-Aquitaine;64;3;25;070;Astis;306;1;307
75;Nouvelle-Aquitaine;64;2;16;071;Athos-Aspis;211;5;216
75;Nouvelle-Aquitaine;64;3;08;072;Aubertin;656;14;670
75;Nouvelle-Aquitaine;64;3;25;073;Aubin;239;5;244
75;Nouvelle-Aquitaine;64;3;25;074;Aubous;48;0;48
75;Nouvelle-Aquitaine;64;2;09;075;Audaux;164;73;237
75;Nouvelle-Aquitaine;64;3;25;077;Auga;153;3;156
75;Nouvelle-Aquitaine;64;3;25;078;Auriac;238;6;244
75;Nouvelle-Aquitaine;64;3;25;079;Aurions-Idernes;104;3;107
75;Nouvelle-Aquitaine;64;3;02;080;Aussevielle;785;24;809
75;Nouvelle-Aquitaine;64;2;12;081;Aussurucq;245;2;247
75;Nouvelle-Aquitaine;64;2;16;082;Auterrive;130;1;131
75;Nouvelle-Aquitaine;64;2;16;083;Autevielle-Saint-Martin-Bideren;205;3;208
75;Nouvelle-Aquitaine;64;3;25;084;Aydie;140;2;142
75;Nouvelle-Aquitaine;64;2;14;085;Aydius;114;1;115
75;Nouvelle-Aquitaine;64;1;22;086;Ayherre;1042;27;1069
75;Nouvelle-Aquitaine;64;3;16;087;Baigts-de-Béarn;876;22;898
75;Nouvelle-Aquitaine;64;3;02;088;Balansun;287;7;294
75;Nouvelle-Aquitaine;64;3;23;089;Baleix;143;0;143
75;Nouvelle-Aquitaine;64;3;25;090;Baliracq-Maumusson;122;1;123
75;Nouvelle-Aquitaine;64;3;17;091;Baliros;475;5;480
75;Nouvelle-Aquitaine;64;1;12;092;Banca;346;7;353
75;Nouvelle-Aquitaine;64;2;12;093;Barcus;642;6;648
75;Nouvelle-Aquitaine;64;1;13;094;Bardos;1828;50;1878
75;Nouvelle-Aquitaine;64;3;23;095;Barinque;606;12;618
75;Nouvelle-Aquitaine;64;2;16;096;Barraute-Camu;174;1;175
75;Nouvelle-Aquitaine;64;3;27;097;Barzun;591;7;598
75;Nouvelle-Aquitaine;64;3;25;098;Bassillon-Vauzé;66;2;68
75;Nouvelle-Aquitaine;64;1;26;100;Bassussarry;3126;93;3219
75;Nouvelle-Aquitaine;64;2;09;099;Bastanès;99;4;103
75;Nouvelle-Aquitaine;64;1;22;289;La Bastide-Clairence;979;34;1013
75;Nouvelle-Aquitaine;64;3;27;101;Baudreix;611;117;728
75;Nouvelle-Aquitaine;64;1;97;102;Bayonne;51228;1170;52398
75;Nouvelle-Aquitaine;64;3;23;103;Bédeille;207;3;210
75;Nouvelle-Aquitaine;64;2;14;104;Bedous;597;15;612
75;Nouvelle-Aquitaine;64;1;22;105;Béguios;252;11;263
75;Nouvelle-Aquitaine;64;1;22;106;Béhasque-Lapiste;507;9;516
75;Nouvelle-Aquitaine;64;1;12;107;Béhorléguy;74;3;77
75;Nouvelle-Aquitaine;64;3;16;108;Bellocq;906;12;918
75;Nouvelle-Aquitaine;64;3;27;109;Bénéjacq;1942;44;1986
75;Nouvelle-Aquitaine;64;3;23;111;Bentayou-Sérée;109;1;110
75;Nouvelle-Aquitaine;64;2;15;110;Béost;217;3;220
75;Nouvelle-Aquitaine;64;2;16;112;Bérenx;435;4;439
75;Nouvelle-Aquitaine;64;1;22;113;Bergouey-Viellenave;116;2;118
75;Nouvelle-Aquitaine;64;3;23;114;Bernadets;577;9;586
75;Nouvelle-Aquitaine;64;2;12;115;Berrogain-Laruns;161;69;230
75;Nouvelle-Aquitaine;64;2;15;116;Bescat;255;5;260
75;Nouvelle-Aquitaine;64;3;09;117;Bésingrand;141;5;146
75;Nouvelle-Aquitaine;64;3;25;118;Bétracq;51;0;51
75;Nouvelle-Aquitaine;64;3;27;119;Beuste;637;20;657
75;Nouvelle-Aquitaine;64;3;02;121;Beyrie-en-Béarn;193;2;195
75;Nouvelle-Aquitaine;64;1;22;120;Beyrie-sur-Joyeuse;510;11;521
75;Nouvelle-Aquitaine;64;1;07;122;Biarritz;25404;704;26108
75;Nouvelle-Aquitaine;64;1;22;123;Bidache;1370;35;1405
75;Nouvelle-Aquitaine;64;1;12;124;Bidarray;677;15;692
75;Nouvelle-Aquitaine;64;1;24;125;Bidart;6811;134;6945
75;Nouvelle-Aquitaine;64;2;14;126;Bidos;1133;28;1161
75;Nouvelle-Aquitaine;64;2;15;127;Bielle;390;17;407
75;Nouvelle-Aquitaine;64;2;15;128;Bilhères;160;4;164
75;Nouvelle-Aquitaine;64;3;08;129;Billère;12804;229;13033
75;Nouvelle-Aquitaine;64;1;10;130;Biriatou;1222;21;1243
75;Nouvelle-Aquitaine;64;3;09;131;Biron;679;9;688
75;Nouvelle-Aquitaine;64;3;20;132;Bizanos;4626;126;4752
75;Nouvelle-Aquitaine;64;3;27;133;Boeil-Bezing;1287;25;1312
75;Nouvelle-Aquitaine;64;1;22;134;Bonloc;366;6;372
75;Nouvelle-Aquitaine;64;3;02;135;Bonnut;774;13;787
75;Nouvelle-Aquitaine;64;2;14;136;Borce;134;5;139
75;Nouvelle-Aquitaine;64;3;27;137;Bordères;646;19;665
75;Nouvelle-Aquitaine;64;3;27;138;Bordes;2884;40;2924
75;Nouvelle-Aquitaine;64;3;17;139;Bosdarros;1013;28;1041
75;Nouvelle-Aquitaine;64;1;05;140;Boucau;8350;149;8499
75;Nouvelle-Aquitaine;64;3;25;141;Boueilh-Boueilho-Lasque;348;8;356
75;Nouvelle-Aquitaine;64;3;02;142;Bougarber;852;27;879
75;Nouvelle-Aquitaine;64;3;02;143;Bouillon;157;5;162
75;Nouvelle-Aquitaine;64;3;02;144;Boumourt;158;2;160
75;Nouvelle-Aquitaine;64;3;17;145;Bourdettes;515;8;523
75;Nouvelle-Aquitaine;64;3;25;146;Bournos;331;4;335
75;Nouvelle-Aquitaine;64;1;13;147;Briscous;2806;44;2850
75;Nouvelle-Aquitaine;64;3;17;148;Bruges-Capbis-Mifaget;887;22;909
75;Nouvelle-Aquitaine;64;2;09;149;Bugnein;238;6;244
75;Nouvelle-Aquitaine;64;1;22;150;Bunus;127;0;127
75;Nouvelle-Aquitaine;64;2;16;151;Burgaronne;99;4;103
75;Nouvelle-Aquitaine;64;3;23;152;Buros;1883;52;1935
75;Nouvelle-Aquitaine;64;3;25;153;Burosse-Mendousse;66;1;67
75;Nouvelle-Aquitaine;64;1;12;154;Bussunarits-Sarrasquette;205;1;206
75;Nouvelle-Aquitaine;64;1;12;155;Bustince-Iriberry;96;1;97
75;Nouvelle-Aquitaine;64;2;15;156;Buziet;484;14;498
75;Nouvelle-Aquitaine;64;2;15;157;Buzy;974;22;996
75;Nouvelle-Aquitaine;64;3;02;158;Cabidos;180;7;187
75;Nouvelle-Aquitaine;64;3;25;159;Cadillon;110;4;114
75;Nouvelle-Aquitaine;64;1;03;160;Cambo-les-Bains;6551;109;6660
75;Nouvelle-Aquitaine;64;1;22;161;Came;978;19;997
75;Nouvelle-Aquitaine;64;2;12;162;Camou-Cihigue;101;4;105
75;Nouvelle-Aquitaine;64;3;09;165;Cardesse;296;1;297
75;Nouvelle-Aquitaine;64;1;12;166;Caro;204;5;209
75;Nouvelle-Aquitaine;64;3;25;167;Carrère;216;5;221
75;Nouvelle-Aquitaine;64;2;16;168;Carresse-Cassaber;676;10;686
75;Nouvelle-Aquitaine;64;2;16;170;Castagnède;207;2;209
75;Nouvelle-Aquitaine;64;3;02;171;Casteide-Cami;241;2;243
75;Nouvelle-Aquitaine;64;3;02;172;Casteide-Candau;290;3;293
75;Nouvelle-Aquitaine;64;3;23;173;Casteide-Doat;159;1;160
75;Nouvelle-Aquitaine;64;3;23;174;Castéra-Loubix;52;1;53
75;Nouvelle-Aquitaine;64;2;15;175;Castet;157;4;161
75;Nouvelle-Aquitaine;64;2;16;176;Castetbon;181;8;189
75;Nouvelle-Aquitaine;64;3;02;177;Castétis;618;25;643
75;Nouvelle-Aquitaine;64;2;09;178;Castetnau-Camblong;457;15;472
75;Nouvelle-Aquitaine;64;3;09;179;Castetner;134;6;140
75;Nouvelle-Aquitaine;64;3;25;180;Castetpugon;217;3;220
75;Nouvelle-Aquitaine;64;3;02;181;Castillon (Canton d'Arthez-de-Béarn);315;4;319
75;Nouvelle-Aquitaine;64;3;25;182;Castillon (Canton de Lembeye);69;1;70
75;Nouvelle-Aquitaine;64;3;25;183;Caubios-Loos;563;17;580
75;Nouvelle-Aquitaine;64;3;02;184;Cescau;598;17;615
75;Nouvelle-Aquitaine;64;2;14;185;Cette-Eygun;68;1;69
75;Nouvelle-Aquitaine;64;2;09;186;Charre;213;3;216
75;Nouvelle-Aquitaine;64;2;12;187;Charritte-de-Bas;268;9;277
75;Nouvelle-Aquitaine;64;2;12;188;Chéraute;1089;154;1243
75;Nouvelle-Aquitaine;64;1;24;189;Ciboure;6251;179;6430
75;Nouvelle-Aquitaine;64;3;25;190;Claracq;227;3;230
75;Nouvelle-Aquitaine;64;3;27;191;Coarraze;2176;141;2317
75;Nouvelle-Aquitaine;64;3;25;192;Conchez-de-Béarn;120;1;121
75;Nouvelle-Aquitaine;64;3;25;193;Corbère-Abères;108;2;110
75;Nouvelle-Aquitaine;64;3;25;194;Coslédaà-Lube-Boast;392;1;393
75;Nouvelle-Aquitaine;64;3;02;195;Coublucq;102;2;104
75;Nouvelle-Aquitaine;64;3;25;196;Crouseilles;125;0;125
75;Nouvelle-Aquitaine;64;3;09;197;Cuqueron;189;5;194
75;Nouvelle-Aquitaine;64;3;02;198;Denguin;1747;40;1787
75;Nouvelle-Aquitaine;64;3;25;199;Diusse;143;4;147
75;Nouvelle-Aquitaine;64;3;02;200;Doazon;186;3;189
75;Nouvelle-Aquitaine;64;2;09;201;Dognen;220;9;229
75;Nouvelle-Aquitaine;64;1;22;202;Domezain-Berraute;505;27;532
75;Nouvelle-Aquitaine;64;3;25;203;Doumy;305;7;312
75;Nouvelle-Aquitaine;64;2;15;204;Eaux-Bonnes;243;4;247
75;Nouvelle-Aquitaine;64;2;16;205;Escos;236;4;240
75;Nouvelle-Aquitaine;64;2;14;206;Escot;127;1;128
75;Nouvelle-Aquitaine;64;2;15;207;Escou;414;15;429
75;Nouvelle-Aquitaine;64;3;23;208;Escoubès;411;8;419
75;Nouvelle-Aquitaine;64;2;15;209;Escout;438;8;446
75;Nouvelle-Aquitaine;64;3;25;210;Escurès;148;1;149
75;Nouvelle-Aquitaine;64;3;23;211;Eslourenties-Daban;332;4;336
75;Nouvelle-Aquitaine;64;3;23;212;Espéchède;142;2;144
75;Nouvelle-Aquitaine;64;1;03;213;Espelette;2024;49;2073
75;Nouvelle-Aquitaine;64;2;12;214;Espès-Undurein;495;17;512
75;Nouvelle-Aquitaine;64;2;16;215;Espiute;108;3;111
75;Nouvelle-Aquitaine;64;3;27;216;Espoey;1169;45;1214
75;Nouvelle-Aquitaine;64;2;14;217;Esquiule;537;12;549
75;Nouvelle-Aquitaine;64;1;12;218;Estérençuby;345;1;346
75;Nouvelle-Aquitaine;64;2;15;219;Estialescq;267;6;273
75;Nouvelle-Aquitaine;64;2;15;220;Estos;526;15;541
75;Nouvelle-Aquitaine;64;1;22;221;Etcharry;130;19;149
75;Nouvelle-Aquitaine;64;2;12;222;Etchebar;73;1;74
75;Nouvelle-Aquitaine;64;2;14;223;Etsaut;69;2;71
75;Nouvelle-Aquitaine;64;2;14;224;Eysus;645;17;662
75;Nouvelle-Aquitaine;64;3;02;226;Fichous-Riumayou;179;1;180
75;Nouvelle-Aquitaine;64;3;23;227;Gabaston;662;13;675
75;Nouvelle-Aquitaine;64;1;22;228;Gabat;256;2;258
75;Nouvelle-Aquitaine;64;1;12;229;Gamarthe;126;5;131
75;Nouvelle-Aquitaine;64;3;17;230;Gan;5510;105;5615
75;Nouvelle-Aquitaine;64;2;12;231;Garindein;500;9;509
75;Nouvelle-Aquitaine;64;3;25;232;Garlède-Mondebat;222;2;224
75;Nouvelle-Aquitaine;64;3;25;233;Garlin;1387;24;1411
75;Nouvelle-Aquitaine;64;3;02;234;Garos;257;9;266
75;Nouvelle-Aquitaine;64;1;22;235;Garris;282;8;290
75;Nouvelle-Aquitaine;64;3;25;236;Gayon;55;1;56
75;Nouvelle-Aquitaine;64;3;21;237;Gelos;3543;169;3712
75;Nouvelle-Aquitaine;64;3;27;238;Ger;1899;48;1947
75;Nouvelle-Aquitaine;64;3;25;239;Gerderest;137;1;138
75;Nouvelle-Aquitaine;64;2;15;240;Gère-Bélesten;190;7;197
75;Nouvelle-Aquitaine;64;2;14;241;Géronce;455;7;462
75;Nouvelle-Aquitaine;64;2;09;242;Gestas;70;0;70
75;Nouvelle-Aquitaine;64;3;02;243;Géus-d'Arzacq;200;2;202
75;Nouvelle-Aquitaine;64;2;14;244;Geüs-d'Oloron;252;9;261
75;Nouvelle-Aquitaine;64;2;15;245;Goès;624;17;641
75;Nouvelle-Aquitaine;64;3;27;246;Gomer;314;7;321
75;Nouvelle-Aquitaine;64;2;12;247;Gotein-Libarrenx;477;17;494
75;Nouvelle-Aquitaine;64;1;24;249;Guéthary;1320;36;1356
75;Nouvelle-Aquitaine;64;1;13;250;Guiche;970;31;1001
75;Nouvelle-Aquitaine;64;2;16;251;Guinarthe-Parenties;224;8;232
75;Nouvelle-Aquitaine;64;2;14;252;Gurmençon;884;27;911
75;Nouvelle-Aquitaine;64;2;09;253;Gurs;419;10;429
75;Nouvelle-Aquitaine;64;3;02;254;Hagetaubin;578;18;596
75;Nouvelle-Aquitaine;64;1;03;255;Halsou;595;5;600
75;Nouvelle-Aquitaine;64;1;03;256;Hasparren;6879;273;7152
75;Nouvelle-Aquitaine;64;3;17;257;Haut-de-Bosdarros;335;1;336
75;Nouvelle-Aquitaine;64;2;12;258;Haux;82;1;83
75;Nouvelle-Aquitaine;64;1;22;259;Hélette;717;11;728
75;Nouvelle-Aquitaine;64;1;10;260;Hendaye;16484;397;16881
75;Nouvelle-Aquitaine;64;2;15;261;Herrère;387;2;389
75;Nouvelle-Aquitaine;64;3;23;262;Higuères-Souye;274;9;283
75;Nouvelle-Aquitaine;64;2;16;263;L' Hôpital-d'Orion;138;3;141
75;Nouvelle-Aquitaine;64;2;12;264;L' Hôpital-Saint-Blaise;69;2;71
75;Nouvelle-Aquitaine;64;1;22;265;Hosta;80;0;80
75;Nouvelle-Aquitaine;64;3;27;266;Hours;268;3;271
75;Nouvelle-Aquitaine;64;1;22;267;Ibarrolle;82;1;83
75;Nouvelle-Aquitaine;64;2;12;268;Idaux-Mendy;270;4;274
75;Nouvelle-Aquitaine;64;3;19;269;Idron;4846;157;5003
75;Nouvelle-Aquitaine;64;3;27;270;Igon;968;59;1027
75;Nouvelle-Aquitaine;64;1;22;271;Iholdy;549;8;557
75;Nouvelle-Aquitaine;64;1;22;272;Ilharre;152;1;153
75;Nouvelle-Aquitaine;64;1;22;273;Irissarry;886;13;899
75;Nouvelle-Aquitaine;64;1;12;274;Irouléguy;363;3;366
75;Nouvelle-Aquitaine;64;1;12;275;Ispoure;673;13;686
75;Nouvelle-Aquitaine;64;2;14;276;Issor;236;6;242
75;Nouvelle-Aquitaine;64;1;22;277;Isturits;518;12;530
75;Nouvelle-Aquitaine;64;1;03;279;Itxassou;2133;64;2197
75;Nouvelle-Aquitaine;64;2;15;280;Izeste;425;3;428
75;Nouvelle-Aquitaine;64;2;09;281;Jasses;138;4;142
75;Nouvelle-Aquitaine;64;1;03;282;Jatxou;1154;29;1183
75;Nouvelle-Aquitaine;64;1;12;283;Jaxu;202;0;202
75;Nouvelle-Aquitaine;64;3;08;284;Jurançon;7094;247;7341
75;Nouvelle-Aquitaine;64;1;22;285;Juxue;209;6;215
75;Nouvelle-Aquitaine;64;3;09;286;Laà-Mondrans;429;13;442
75;Nouvelle-Aquitaine;64;2;16;287;Laàs;136;3;139
75;Nouvelle-Aquitaine;64;3;02;288;Labastide-Cézéracq;555;8;563
75;Nouvelle-Aquitaine;64;3;02;290;Labastide-Monréjeau;589;17;606
75;Nouvelle-Aquitaine;64;2;16;291;Labastide-Villefranche;335;4;339
75;Nouvelle-Aquitaine;64;3;27;292;Labatmale;254;2;256
75;Nouvelle-Aquitaine;64;3;23;293;Labatut;175;2;177
75;Nouvelle-Aquitaine;64;1;22;294;Labets-Biscay;160;3;163
75;Nouvelle-Aquitaine;64;3;02;295;Labeyrie;123;5;128
75;Nouvelle-Aquitaine;64;3;02;296;Lacadée;155;4;159
75;Nouvelle-Aquitaine;64;1;12;297;Lacarre;174;4;178
75;Nouvelle-Aquitaine;64;2;12;298;Lacarry-Arhan-Charritte-de-Haut;130;0;130
75;Nouvelle-Aquitaine;64;3;09;299;Lacommande;214;4;218
75;Nouvelle-Aquitaine;64;3;02;300;Lacq;732;11;743
75;Nouvelle-Aquitaine;64;3;09;301;Lagor;1194;20;1214
75;Nouvelle-Aquitaine;64;3;27;302;Lagos;468;12;480
75;Nouvelle-Aquitaine;64;2;12;303;Laguinge-Restoue;158;8;166
75;Nouvelle-Aquitaine;64;1;13;304;Lahonce;2418;53;2471
75;Nouvelle-Aquitaine;64;2;16;305;Lahontan;514;10;524
75;Nouvelle-Aquitaine;64;3;09;306;Lahourcade;698;21;719
75;Nouvelle-Aquitaine;64;3;25;307;Lalongue;212;3;215
75;Nouvelle-Aquitaine;64;3;25;308;Lalonquette;274;5;279
75;Nouvelle-Aquitaine;64;3;23;309;Lamayou;201;5;206
75;Nouvelle-Aquitaine;64;2;14;310;Lanne-en-Barétous;494;6;500
75;Nouvelle-Aquitaine;64;3;25;311;Lannecaube;159;2;161
75;Nouvelle-Aquitaine;64;3;16;312;Lanneplaà;306;6;312
75;Nouvelle-Aquitaine;64;1;22;313;Lantabat;284;5;289
75;Nouvelle-Aquitaine;64;1;22;314;Larceveau-Arros-Cibits;413;3;416
75;Nouvelle-Aquitaine;64;3;08;315;Laroin;1076;26;1102
75;Nouvelle-Aquitaine;64;2;12;316;Larrau;197;4;201
75;Nouvelle-Aquitaine;64;1;03;317;Larressore;2053;30;2083
75;Nouvelle-Aquitaine;64;3;02;318;Larreule;183;5;188
75;Nouvelle-Aquitaine;64;1;22;319;Larribar-Sorhapuru;188;0;188
75;Nouvelle-Aquitaine;64;2;15;320;Laruns;1194;23;1217
75;Nouvelle-Aquitaine;64;3;25;321;Lasclaveries;244;5;249
75;Nouvelle-Aquitaine;64;1;12;322;Lasse;333;6;339
75;Nouvelle-Aquitaine;64;3;25;323;Lasserre;89;5;94
75;Nouvelle-Aquitaine;64;2;15;324;Lasseube;1736;41;1777
75;Nouvelle-Aquitaine;64;2;15;325;Lasseubetat;207;4;211
75;Nouvelle-Aquitaine;64;2;09;326;Lay-Lamidou;118;4;122
75;Nouvelle-Aquitaine;64;1;12;327;Lecumberry;172;4;176
75;Nouvelle-Aquitaine;64;2;15;328;Ledeuix;1032;29;1061
75;Nouvelle-Aquitaine;64;3;23;329;Lée;1270;58;1328
75;Nouvelle-Aquitaine;64;2;14;330;Lées-Athas;265;12;277
75;Nouvelle-Aquitaine;64;3;25;331;Lembeye;773;16;789
75;Nouvelle-Aquitaine;64;3;25;332;Lème;166;1;167
75;Nouvelle-Aquitaine;64;2;16;334;Léren;220;3;223
75;Nouvelle-Aquitaine;64;3;11;335;Lescar;9804;421;10225
75;Nouvelle-Aquitaine;64;2;14;336;Lescun;172;1;173
75;Nouvelle-Aquitaine;64;3;25;337;Lespielle;155;3;158
75;Nouvelle-Aquitaine;64;3;23;338;Lespourcy;192;6;198
75;Nouvelle-Aquitaine;64;3;27;339;Lestelle-Bétharram;831;81;912
75;Nouvelle-Aquitaine;64;2;12;340;Lichans-Sunhar;81;1;82
75;Nouvelle-Aquitaine;64;2;12;341;Lichos;135;1;136
75;Nouvelle-Aquitaine;64;2;12;342;Licq-Athérey;207;6;213
75;Nouvelle-Aquitaine;64;3;27;343;Limendous;706;8;714
75;Nouvelle-Aquitaine;64;3;27;344;Livron;405;16;421
75;Nouvelle-Aquitaine;64;1;22;345;Lohitzun-Oyhercq;203;1;204
75;Nouvelle-Aquitaine;64;3;23;346;Lombia;207;1;208
75;Nouvelle-Aquitaine;64;3;11;348;Lons;13374;249;13623
75;Nouvelle-Aquitaine;64;3;02;347;Lonçon;199;3;202
75;Nouvelle-Aquitaine;64;3;09;349;Loubieng;516;5;521
75;Nouvelle-Aquitaine;64;1;03;350;Louhossoa;887;18;905
75;Nouvelle-Aquitaine;64;2;14;351;Lourdios-Ichère;141;9;150
75;Nouvelle-Aquitaine;64;3;27;352;Lourenties;362;4;366
75;Nouvelle-Aquitaine;64;2;15;353;Louvie-Juzon;1058;29;1087
75;Nouvelle-Aquitaine;64;2;15;354;Louvie-Soubiron;119;1;120
75;Nouvelle-Aquitaine;64;3;02;355;Louvigny;140;2;142
75;Nouvelle-Aquitaine;64;3;25;356;Luc-Armau;113;0;113
75;Nouvelle-Aquitaine;64;3;25;357;Lucarré;59;0;59
75;Nouvelle-Aquitaine;64;3;27;358;Lucgarier;251;1;252
75;Nouvelle-Aquitaine;64;3;09;359;Lucq-de-Béarn;934;20;954
75;Nouvelle-Aquitaine;64;2;14;360;Lurbe-Saint-Christau;195;6;201
75;Nouvelle-Aquitaine;64;3;25;361;Lussagnet-Lusson;172;6;178
75;Nouvelle-Aquitaine;64;1;22;362;Luxe-Sumberraute;404;24;428
75;Nouvelle-Aquitaine;64;2;15;363;Lys;334;4;338
75;Nouvelle-Aquitaine;64;1;03;364;Macaye;587;10;597
75;Nouvelle-Aquitaine;64;3;02;365;Malaussanne;428;7;435
75;Nouvelle-Aquitaine;64;3;25;366;Mascaraàs-Haron;127;0;127
75;Nouvelle-Aquitaine;64;3;09;367;Maslacq;890;23;913
75;Nouvelle-Aquitaine;64;1;22;368;Masparraute;234;7;241
75;Nouvelle-Aquitaine;64;3;25;369;Maspie-Lalonquère-Juillacq;261;4;265
75;Nouvelle-Aquitaine;64;3;23;370;Maucor;534;15;549
75;Nouvelle-Aquitaine;64;2;12;371;Mauléon-Licharre;2954;231;3185
75;Nouvelle-Aquitaine;64;3;23;372;Maure;104;1;105
75;Nouvelle-Aquitaine;64;3;20;373;Mazères-Lezons;1833;44;1877
75;Nouvelle-Aquitaine;64;3;02;374;Mazerolles;1115;18;1133
75;Nouvelle-Aquitaine;64;1;22;375;Méharin;273;4;277
75;Nouvelle-Aquitaine;64;3;17;376;Meillon;916;16;932
75;Nouvelle-Aquitaine;64;1;22;377;Mendionde;844;24;868
75;Nouvelle-Aquitaine;64;2;12;378;Menditte;200;129;329
75;Nouvelle-Aquitaine;64;1;12;379;Mendive;164;4;168
75;Nouvelle-Aquitaine;64;3;02;380;Méracq;229;5;234
75;Nouvelle-Aquitaine;64;2;09;381;Méritein;288;9;297
75;Nouvelle-Aquitaine;64;3;02;382;Mesplède;365;13;378
75;Nouvelle-Aquitaine;64;3;02;383;Mialos;126;0;126
75;Nouvelle-Aquitaine;64;3;25;385;Miossens-Lanusse;267;2;269
75;Nouvelle-Aquitaine;64;3;27;386;Mirepeix;1278;37;1315
75;Nouvelle-Aquitaine;64;3;02;387;Momas;577;12;589
75;Nouvelle-Aquitaine;64;3;23;388;Momy;127;1;128
75;Nouvelle-Aquitaine;64;3;25;389;Monassut-Audiracq;359;3;362
75;Nouvelle-Aquitaine;64;3;25;390;Moncaup;156;12;168
75;Nouvelle-Aquitaine;64;2;12;391;Moncayolle-Larrory-Mendibieu;314;7;321
75;Nouvelle-Aquitaine;64;3;25;392;Moncla;91;2;93
75;Nouvelle-Aquitaine;64;3;09;393;Monein;4438;107;4545
75;Nouvelle-Aquitaine;64;3;25;394;Monpezat;83;1;84
75;Nouvelle-Aquitaine;64;3;23;395;Monségur;129;0;129
75;Nouvelle-Aquitaine;64;3;02;396;Mont;1124;93;1217
75;Nouvelle-Aquitaine;64;3;25;401;Mont-Disse;72;4;76
75;Nouvelle-Aquitaine;64;3;02;397;Montagut;116;2;118
75;Nouvelle-Aquitaine;64;3;23;398;Montaner;432;8;440
75;Nouvelle-Aquitaine;64;3;25;399;Montardon;2300;278;2578
75;Nouvelle-Aquitaine;64;3;27;400;Montaut;1110;46;1156
75;Nouvelle-Aquitaine;64;2;16;403;Montfort;181;3;184
75;Nouvelle-Aquitaine;64;2;12;404;Montory;306;13;319
75;Nouvelle-Aquitaine;64;3;23;405;Morlaàs;4282;256;4538
75;Nouvelle-Aquitaine;64;3;02;406;Morlanne;591;15;606
75;Nouvelle-Aquitaine;64;1;13;407;Mouguerre;5108;140;5248
75;Nouvelle-Aquitaine;64;3;25;408;Mouhous;57;0;57
75;Nouvelle-Aquitaine;64;2;14;409;Moumour;841;22;863
75;Nouvelle-Aquitaine;64;3;09;410;Mourenx;6485;175;6660
75;Nouvelle-Aquitaine;64;2;12;411;Musculdy;236;3;239
75;Nouvelle-Aquitaine;64;2;09;412;Nabas;107;2;109
75;Nouvelle-Aquitaine;64;3;17;413;Narcastet;754;12;766
75;Nouvelle-Aquitaine;64;2;16;414;Narp;113;2;115
75;Nouvelle-Aquitaine;64;3;25;415;Navailles-Angos;1521;22;1543
75;Nouvelle-Aquitaine;64;2;09;416;Navarrenx;1051;14;1065
75;Nouvelle-Aquitaine;64;3;17;417;Nay;3288;236;3524
75;Nouvelle-Aquitaine;64;3;09;418;Noguères;140;3;143
75;Nouvelle-Aquitaine;64;3;27;419;Nousty;1608;30;1638
75;Nouvelle-Aquitaine;64;2;09;420;Ogenne-Camptort;245;6;251
75;Nouvelle-Aquitaine;64;2;15;421;Ogeu-les-Bains;1289;29;1318
75;Nouvelle-Aquitaine;64;2;98;422;Oloron-Sainte-Marie;10684;621;11305
75;Nouvelle-Aquitaine;64;2;16;423;Oraàs;176;3;179
75;Nouvelle-Aquitaine;64;2;12;424;Ordiarp;527;5;532
75;Nouvelle-Aquitaine;64;1;22;425;Orègue;485;9;494
75;Nouvelle-Aquitaine;64;2;14;426;Orin;241;9;250
75;Nouvelle-Aquitaine;64;2;16;427;Orion;144;9;153
75;Nouvelle-Aquitaine;64;2;16;428;Orriule;132;2;134
75;Nouvelle-Aquitaine;64;1;22;429;Orsanco;110;4;114
75;Nouvelle-Aquitaine;64;3;16;430;Orthez;10449;657;11106
75;Nouvelle-Aquitaine;64;3;09;431;Os-Marsillon;533;9;542
75;Nouvelle-Aquitaine;64;2;12;432;Ossas-Suhare;84;2;86
75;Nouvelle-Aquitaine;64;2;14;433;Osse-en-Aspe;325;15;340
75;Nouvelle-Aquitaine;64;2;16;434;Ossenx;52;1;53
75;Nouvelle-Aquitaine;64;1;22;435;Osserain-Rivareyte;212;9;221
75;Nouvelle-Aquitaine;64;1;12;436;Ossès;835;23;858
75;Nouvelle-Aquitaine;64;1;22;437;Ostabat-Asme;194;2;196
75;Nouvelle-Aquitaine;64;3;23;438;Ouillon;552;13;565
75;Nouvelle-Aquitaine;64;3;23;439;Ousse;1661;50;1711
75;Nouvelle-Aquitaine;64;3;09;440;Ozenx-Montestrucq;382;17;399
75;Nouvelle-Aquitaine;64;1;22;441;Pagolle;261;5;266
75;Nouvelle-Aquitaine;64;3;09;442;Parbayse;319;10;329
75;Nouvelle-Aquitaine;64;3;09;443;Pardies;849;22;871
75;Nouvelle-Aquitaine;64;3;17;444;Pardies-Piétat;448;11;459
75;Nouvelle-Aquitaine;64;3;99;445;Pau;77130;1405;78535
75;Nouvelle-Aquitaine;64;3;25;446;Peyrelongue-Abos;150;2;152
75;Nouvelle-Aquitaine;64;3;02;447;Piets-Plasence-Moustrou;139;1;140
75;Nouvelle-Aquitaine;64;2;15;449;Poey-d'Oloron;166;4;170
75;Nouvelle-Aquitaine;64;3;11;448;Poey-de-Lescar;1655;46;1701
75;Nouvelle-Aquitaine;64;3;02;450;Pomps;290;6;296
75;Nouvelle-Aquitaine;64;3;23;451;Ponson-Debat-Pouts;95;3;98
75;Nouvelle-Aquitaine;64;3;27;452;Ponson-Dessus;258;7;265
75;Nouvelle-Aquitaine;64;3;27;453;Pontacq;2936;45;2981
75;Nouvelle-Aquitaine;64;3;23;454;Pontiacq-Viellepinte;184;2;186
75;Nouvelle-Aquitaine;64;3;25;455;Portet;169;3;172
75;Nouvelle-Aquitaine;64;3;25;456;Pouliacq;54;3;57
75;Nouvelle-Aquitaine;64;3;02;457;Poursiugues-Boucoue;190;4;194
75;Nouvelle-Aquitaine;64;2;14;458;Préchacq-Josbaig;293;7;300
75;Nouvelle-Aquitaine;64;2;09;459;Préchacq-Navarrenx;165;2;167
75;Nouvelle-Aquitaine;64;2;15;460;Précilhon;401;9;410
75;Nouvelle-Aquitaine;64;3;16;461;Puyoô;1133;16;1149
75;Nouvelle-Aquitaine;64;3;16;462;Ramous;495;6;501
75;Nouvelle-Aquitaine;64;2;15;463;Rébénacq;682;11;693
75;Nouvelle-Aquitaine;64;3;25;464;Ribarrouy;83;1;84
75;Nouvelle-Aquitaine;64;3;23;465;Riupeyrous;214;3;217
75;Nouvelle-Aquitaine;64;2;09;466;Rivehaute;262;18;280
75;Nouvelle-Aquitaine;64;3;17;467;Rontignon;833;16;849
75;Nouvelle-Aquitaine;64;2;12;468;Roquiague;119;2;121
75;Nouvelle-Aquitaine;64;3;17;469;Saint-Abit;317;8;325
75;Nouvelle-Aquitaine;64;3;23;470;Saint-Armou;636;22;658
75;Nouvelle-Aquitaine;64;3;16;471;Saint-Boès;367;12;379
75;Nouvelle-Aquitaine;64;3;23;472;Saint-Castin;888;18;906
75;Nouvelle-Aquitaine;64;2;16;474;Saint-Dos;160;1;161
75;Nouvelle-Aquitaine;64;1;22;476;Saint-Esteben;411;6;417
75;Nouvelle-Aquitaine;64;1;12;477;Saint-Étienne-de-Baïgorry;1477;39;1516
75;Nouvelle-Aquitaine;64;3;08;478;Saint-Faust;746;26;772
75;Nouvelle-Aquitaine;64;3;16;479;Saint-Girons-en-Béarn;157;4;161
75;Nouvelle-Aquitaine;64;2;16;480;Saint-Gladie-Arrive-Munein;200;4;204
75;Nouvelle-Aquitaine;64;2;14;481;Saint-Goin;230;4;234
75;Nouvelle-Aquitaine;64;3;23;482;Saint-Jammes;628;8;636
75;Nouvelle-Aquitaine;64;1;24;483;Saint-Jean-de-Luz;14093;454;14547
75;Nouvelle-Aquitaine;64;1;12;484;Saint-Jean-le-Vieux;849;17;866
75;Nouvelle-Aquitaine;64;1;12;485;Saint-Jean-Pied-de-Port;1587;263;1850
75;Nouvelle-Aquitaine;64;3;25;486;Saint-Jean-Poudge;73;0;73
75;Nouvelle-Aquitaine;64;1;22;487;Saint-Just-Ibarre;223;5;228
75;Nouvelle-Aquitaine;64;3;23;488;Saint-Laurent-Bretagne;434;12;446
75;Nouvelle-Aquitaine;64;1;22;489;Saint-Martin-d'Arberoue;315;10;325
75;Nouvelle-Aquitaine;64;1;12;490;Saint-Martin-d'Arrossa;537;15;552
75;Nouvelle-Aquitaine;64;3;02;491;Saint-Médard;211;4;215
75;Nouvelle-Aquitaine;64;1;12;492;Saint-Michel;295;3;298
75;Nouvelle-Aquitaine;64;1;22;493;Saint-Palais;1838;68;1906
75;Nouvelle-Aquitaine;64;2;16;494;Saint-Pé-de-Léren;258;6;264
75;Nouvelle-Aquitaine;64;1;26;495;Saint-Pée-sur-Nivelle;6849;150;6999
75;Nouvelle-Aquitaine;64;1;13;496;Saint-Pierre-d'Irube;4844;106;4950
75;Nouvelle-Aquitaine;64;3;27;498;Saint-Vincent;398;10;408
75;Nouvelle-Aquitaine;64;2;15;473;Sainte-Colome;356;4;360
75;Nouvelle-Aquitaine;64;2;12;475;Sainte-Engrâce;193;3;196
75;Nouvelle-Aquitaine;64;2;16;499;Salies-de-Béarn;4638;132;4770
75;Nouvelle-Aquitaine;64;3;16;500;Salles-Mongiscard;308;5;313
75;Nouvelle-Aquitaine;64;3;02;501;Sallespisse;577;8;585
75;Nouvelle-Aquitaine;64;1;13;502;Sames;699;6;705
75;Nouvelle-Aquitaine;64;3;25;503;Samsons-Lion;88;1;89
75;Nouvelle-Aquitaine;64;1;26;504;Sare;2651;27;2678
75;Nouvelle-Aquitaine;64;3;09;505;Sarpourenx;338;6;344
75;Nouvelle-Aquitaine;64;2;14;506;Sarrance;165;4;169
75;Nouvelle-Aquitaine;64;3;23;507;Saubole;137;3;140
75;Nouvelle-Aquitaine;64;2;15;508;Saucède;126;2;128
75;Nouvelle-Aquitaine;64;2;12;509;Sauguis-Saint-Étienne;165;5;170
75;Nouvelle-Aquitaine;64;3;02;510;Sault-de-Navailles;898;16;914
75;Nouvelle-Aquitaine;64;3;25;511;Sauvagnon;3313;96;3409
75;Nouvelle-Aquitaine;64;3;09;512;Sauvelade;271;4;275
75;Nouvelle-Aquitaine;64;2;16;513;Sauveterre-de-Béarn;1375;105;1480
75;Nouvelle-Aquitaine;64;3;02;514;Séby;195;7;202
75;Nouvelle-Aquitaine;64;3;23;515;Sedze-Maubecq;275;5;280
75;Nouvelle-Aquitaine;64;3;23;516;Sedzère;390;3;393
75;Nouvelle-Aquitaine;64;3;25;517;Séméacq-Blachon;167;8;175
75;Nouvelle-Aquitaine;64;3;23;518;Sendets;1007;20;1027
75;Nouvelle-Aquitaine;64;3;25;519;Serres-Castet;4261;116;4377
75;Nouvelle-Aquitaine;64;3;23;520;Serres-Morlaàs;783;31;814
75;Nouvelle-Aquitaine;64;3;02;521;Serres-Sainte-Marie;562;17;579
75;Nouvelle-Aquitaine;64;3;25;523;Sévignacq;749;14;763
75;Nouvelle-Aquitaine;64;2;15;522;Sévignacq-Meyracq;538;15;553
75;Nouvelle-Aquitaine;64;3;25;524;Simacourbe;404;2;406
75;Nouvelle-Aquitaine;64;3;11;525;Siros;752;14;766
75;Nouvelle-Aquitaine;64;3;27;526;Soumoulou;1584;23;1607
75;Nouvelle-Aquitaine;64;1;03;527;Souraïde;1400;27;1427
75;Nouvelle-Aquitaine;64;1;22;528;Suhescun;173;8;181
75;Nouvelle-Aquitaine;64;2;09;529;Sus;375;11;386
75;Nouvelle-Aquitaine;64;2;09;530;Susmiou;357;7;364
75;Nouvelle-Aquitaine;64;2;16;531;Tabaille-Usquain;44;2;46
75;Nouvelle-Aquitaine;64;3;25;532;Tadousse-Ussau;67;0;67
75;Nouvelle-Aquitaine;64;2;12;533;Tardets-Sorholus;541;11;552
75;Nouvelle-Aquitaine;64;3;25;534;Taron-Sadirac-Viellenave;192;0;192
75;Nouvelle-Aquitaine;64;3;09;535;Tarsacq;521;6;527
75;Nouvelle-Aquitaine;64;3;25;536;Thèze;836;16;852
75;Nouvelle-Aquitaine;64;2;12;537;Trois-Villes;131;3;134
75;Nouvelle-Aquitaine;64;1;12;538;Uhart-Cize;806;16;822
75;Nouvelle-Aquitaine;64;1;22;539;Uhart-Mixe;210;5;215
75;Nouvelle-Aquitaine;64;1;13;540;Urcuit;2492;62;2554
75;Nouvelle-Aquitaine;64;3;02;541;Urdès;305;3;308
75;Nouvelle-Aquitaine;64;2;14;542;Urdos;64;2;66
75;Nouvelle-Aquitaine;64;1;12;543;Urepel;284;7;291
75;Nouvelle-Aquitaine;64;3;23;544;Urost;76;2;78
75;Nouvelle-Aquitaine;64;1;10;545;Urrugne;10317;191;10508
75;Nouvelle-Aquitaine;64;1;13;546;Urt;2301;34;2335
75;Nouvelle-Aquitaine;64;1;26;547;Ustaritz;6822;266;7088
75;Nouvelle-Aquitaine;64;3;02;548;Uzan;176;4;180
75;Nouvelle-Aquitaine;64;3;11;549;Uzein;1232;23;1255
75;Nouvelle-Aquitaine;64;3;17;550;Uzos;742;29;771
75;Nouvelle-Aquitaine;64;2;15;551;Verdets;270;4;274
75;Nouvelle-Aquitaine;64;3;25;552;Vialer;188;3;191
75;Nouvelle-Aquitaine;64;3;02;554;Viellenave-d'Arthez;205;3;208
75;Nouvelle-Aquitaine;64;2;09;555;Viellenave-de-Navarrenx;161;3;164
75;Nouvelle-Aquitaine;64;3;09;556;Vielleségure;375;10;385
75;Nouvelle-Aquitaine;64;3;02;557;Vignes;441;21;462
75;Nouvelle-Aquitaine;64;1;13;558;Villefranque;2671;73;2744
75;Nouvelle-Aquitaine;64;2;12;559;Viodos-Abense-de-Bas;712;20;732
75;Nouvelle-Aquitaine;64;3;25;560;Viven;187;0;187
76;Occitanie;65;1;16;001;Adast;292;7;299
76;Occitanie;65;1;06;002;Adé;802;10;812
76;Occitanie;65;2;08;003;Adervielle-Pouchergues;132;1;133
76;Occitanie;65;1;16;004;Agos-Vidalos;416;10;426
76;Occitanie;65;3;07;005;Allier;411;10;421
76;Occitanie;65;2;08;006;Ancizan;271;7;278
76;Occitanie;65;3;17;007;Andrest;1396;28;1424
76;Occitanie;65;2;15;009;Anères;174;3;177
76;Occitanie;65;1;06;011;Les Angles;126;3;129
76;Occitanie;65;3;07;010;Angos;223;4;227
76;Occitanie;65;2;15;012;Anla;91;2;93
76;Occitanie;65;3;13;013;Ansost;57;2;59
76;Occitanie;65;2;15;014;Antichan;35;0;35
76;Occitanie;65;3;03;015;Antin;106;7;113
76;Occitanie;65;2;04;016;Antist;181;3;184
76;Occitanie;65;2;08;017;Aragnouet;248;2;250
76;Occitanie;65;1;16;018;Arbéost;85;1;86
76;Occitanie;65;3;07;019;Arcizac-Adour;534;11;545
76;Occitanie;65;1;06;020;Arcizac-ez-Angles;259;5;264
76;Occitanie;65;1;16;021;Arcizans-Avant;394;15;409
76;Occitanie;65;1;16;022;Arcizans-Dessus;125;1;126
76;Occitanie;65;2;08;023;Ardengost;13;0;13
76;Occitanie;65;2;14;024;Argelès-Bagnères;110;3;113
76;Occitanie;65;1;16;025;Argelès-Gazost;2901;169;3070
76;Occitanie;65;3;03;026;Aries-Espénan;71;0;71
76;Occitanie;65;2;15;028;Arné;213;5;218
76;Occitanie;65;1;16;029;Arras-en-Lavedan;489;11;500
76;Occitanie;65;1;06;247;Arrayou-Lahitte;107;0;107
76;Occitanie;65;2;08;031;Arreau;773;26;799
76;Occitanie;65;1;16;032;Arrens-Marsous;727;10;737
76;Occitanie;65;2;14;034;Arrodets;20;0;20
76;Occitanie;65;1;06;033;Arrodets-ez-Angles;110;2;112
76;Occitanie;65;3;17;035;Artagnan;512;12;524
76;Occitanie;65;1;16;036;Artalens-Souin;133;3;136
76;Occitanie;65;2;14;037;Artiguemy;92;1;93
76;Occitanie;65;1;06;038;Artigues;16;1;17
76;Occitanie;65;2;08;039;Aspin-Aure;45;0;45
76;Occitanie;65;1;05;040;Aspin-en-Lavedan;334;3;337
76;Occitanie;65;2;14;041;Asque;118;7;125
76;Occitanie;65;2;04;042;Asté;559;11;570
76;Occitanie;65;2;04;043;Astugue;258;9;267
76;Occitanie;65;3;03;044;Aubarède;297;6;303
76;Occitanie;65;1;16;045;Aucun;237;9;246
76;Occitanie;65;2;08;046;Aulon;84;5;89
76;Occitanie;65;3;01;047;Aureilhan;7745;222;7967
76;Occitanie;65;3;17;048;Aurensan;789;10;799
76;Occitanie;65;3;13;049;Auriébat;246;3;249
76;Occitanie;65;2;08;050;Avajan;78;1;79
76;Occitanie;65;2;15;051;Aventignan;205;7;212
76;Occitanie;65;3;09;052;Averan;68;0;68
76;Occitanie;65;2;15;053;Aveux;41;1;42
76;Occitanie;65;2;08;054;Avezac-Prat-Lahitte;602;8;610
76;Occitanie;65;1;16;055;Ayros-Arbouix;314;3;317
76;Occitanie;65;1;16;056;Ayzac-Ost;450;13;463
76;Occitanie;65;3;09;057;Azereix;986;16;1002
76;Occitanie;65;2;08;058;Azet;148;2;150
76;Occitanie;65;2;04;059;Bagnères-de-Bigorre;7253;263;7516
76;Occitanie;65;2;14;060;Banios;53;3;56
76;Occitanie;65;3;13;061;Barbachen;53;0;53
76;Occitanie;65;3;07;062;Barbazan-Debat;3463;75;3538
76;Occitanie;65;3;14;063;Barbazan-Dessus;165;3;168
76;Occitanie;65;1;16;481;Barèges;163;5;168
76;Occitanie;65;2;08;064;Bareilles;47;0;47
76;Occitanie;65;1;05;065;Barlest;290;8;298
76;Occitanie;65;2;08;066;Barrancoueu;33;0;33
76;Occitanie;65;3;09;067;Barry;125;9;134
76;Occitanie;65;3;03;068;Barthe;18;1;19
76;Occitanie;65;2;08;069;La Barthe-de-Neste;1227;30;1257
76;Occitanie;65;1;05;070;Bartrès;514;17;531
76;Occitanie;65;2;14;071;Batsère;36;0;36
76;Occitanie;65;3;02;072;Bazet;1748;15;1763
76;Occitanie;65;3;13;073;Bazillac;347;4;351
76;Occitanie;65;3;03;074;Bazordan;113;1;114
76;Occitanie;65;2;08;075;Bazus-Aure;131;7;138
76;Occitanie;65;2;08;076;Bazus-Neste;59;2;61
76;Occitanie;65;1;16;077;Beaucens;409;17;426
76;Occitanie;65;2;04;078;Beaudéan;395;10;405
76;Occitanie;65;3;14;079;Bégole;203;4;207
76;Occitanie;65;3;09;080;Bénac;548;9;557
76;Occitanie;65;2;14;081;Benqué-Molère;126;3;129
76;Occitanie;65;1;06;082;Berbérust-Lias;50;0;50
76;Occitanie;65;3;07;083;Bernac-Debat;683;16;699
76;Occitanie;65;3;07;084;Bernac-Dessus;294;4;298
76;Occitanie;65;3;03;085;Bernadets-Debat;112;1;113
76;Occitanie;65;3;14;086;Bernadets-Dessus;155;0;155
76;Occitanie;65;2;15;087;Bertren;174;5;179
76;Occitanie;65;3;03;088;Betbèze;45;1;46
76;Occitanie;65;1;16;089;Betpouey;87;3;90
76;Occitanie;65;3;03;090;Betpouy;78;3;81
76;Occitanie;65;2;14;091;Bettes;51;0;51
76;Occitanie;65;2;08;092;Beyrède-Jumet-Camous;217;2;219
76;Occitanie;65;2;15;093;Bize;215;8;223
76;Occitanie;65;2;15;094;Bizous;110;2;112
76;Occitanie;65;3;03;095;Bonnefont;339;11;350
76;Occitanie;65;2;14;096;Bonnemazon;64;2;66
76;Occitanie;65;2;14;097;Bonrepos;187;5;192
76;Occitanie;65;1;16;098;Boô-Silhen;310;7;317
76;Occitanie;65;2;08;099;Bordères-Louron;155;3;158
76;Occitanie;65;3;02;100;Bordères-sur-l'Échez;5227;112;5339
76;Occitanie;65;3;14;101;Bordes;762;18;780
76;Occitanie;65;3;13;102;Bouilh-Devant;21;2;23
76;Occitanie;65;3;03;103;Bouilh-Péreuilh;94;1;95
76;Occitanie;65;3;03;104;Boulin;288;9;297
76;Occitanie;65;2;14;105;Bourg-de-Bigorre;197;3;200
76;Occitanie;65;2;08;106;Bourisp;163;4;167
76;Occitanie;65;1;06;107;Bourréac;108;2;110
76;Occitanie;65;3;02;108;Bours;829;17;846
76;Occitanie;65;2;15;109;Bramevaque;34;1;35
76;Occitanie;65;3;03;110;Bugard;89;0;89
76;Occitanie;65;2;14;111;Bulan;61;0;61
76;Occitanie;65;1;16;112;Bun;146;5;151
76;Occitanie;65;3;14;113;Burg;275;11;286
76;Occitanie;65;3;13;114;Buzon;78;4;82
76;Occitanie;65;3;03;115;Cabanac;290;10;300
76;Occitanie;65;2;08;116;Cadéac;305;5;310
76;Occitanie;65;2;08;117;Cadeilhan-Trachère;39;1;40
76;Occitanie;65;3;14;118;Caharet;37;1;38
76;Occitanie;65;3;17;119;Caixon;375;4;379
76;Occitanie;65;3;14;120;Calavanté;335;6;341
76;Occitanie;65;3;17;121;Camalès;384;9;393
76;Occitanie;65;2;04;123;Campan;1332;53;1385
76;Occitanie;65;2;08;124;Camparan;55;2;57
76;Occitanie;65;2;15;125;Campistrous;316;7;323
76;Occitanie;65;3;03;126;Campuzan;157;5;162
76;Occitanie;65;2;15;482;Cantaous;443;11;454
76;Occitanie;65;2;08;127;Capvern;1285;26;1311
76;Occitanie;65;2;14;128;Castelbajac;135;3;138
76;Occitanie;65;3;03;129;Castelnau-Magnoac;798;21;819
76;Occitanie;65;3;13;130;Castelnau-Rivière-Basse;627;13;640
76;Occitanie;65;3;03;131;Castelvieilh;245;2;247
76;Occitanie;65;3;14;132;Castéra-Lanusse;44;0;44
76;Occitanie;65;3;03;133;Castéra-Lou;231;4;235
76;Occitanie;65;3;03;134;Casterets;13;0;13
76;Occitanie;65;2;14;135;Castillon;83;0;83
76;Occitanie;65;3;03;136;Caubous;39;0;39
76;Occitanie;65;3;13;137;Caussade-Rivière;97;3;100
76;Occitanie;65;1;16;138;Cauterets;908;19;927
76;Occitanie;65;2;15;139;Cazarilh;53;1;54
76;Occitanie;65;2;08;140;Cazaux-Debat;32;1;33
76;Occitanie;65;2;08;141;Cazaux-Fréchet-Anéran-Camors;48;2;50
76;Occitanie;65;3;03;142;Chelle-Debat;210;4;214
76;Occitanie;65;2;14;143;Chelle-Spou;119;0;119
76;Occitanie;65;1;06;144;Cheust;86;2;88
76;Occitanie;65;1;16;145;Chèze;48;0;48
76;Occitanie;65;3;02;146;Chis;315;1;316
76;Occitanie;65;2;14;147;Cieutat;600;11;611
76;Occitanie;65;3;03;148;Cizos;127;1;128
76;Occitanie;65;3;14;149;Clarac;180;5;185
76;Occitanie;65;2;15;150;Clarens;507;23;530
76;Occitanie;65;3;03;151;Collongues;148;4;152
76;Occitanie;65;3;03;153;Coussan;122;5;127
76;Occitanie;65;2;15;154;Créchets;56;0;56
76;Occitanie;65;3;03;155;Devèze;59;2;61
76;Occitanie;65;3;03;156;Dours;223;5;228
76;Occitanie;65;2;08;157;Ens;24;2;26
76;Occitanie;65;2;15;158;Esbareich;82;0;82
76;Occitanie;65;2;08;159;Escala;376;12;388
76;Occitanie;65;3;17;160;Escaunets;126;3;129
76;Occitanie;65;3;13;161;Escondeaux;281;5;286
76;Occitanie;65;2;14;162;Esconnets;35;1;36
76;Occitanie;65;2;14;163;Escots;34;1;35
76;Occitanie;65;1;06;164;Escoubès-Pouts;106;2;108
76;Occitanie;65;2;08;165;Esparros;183;1;184
76;Occitanie;65;2;14;166;Espèche;53;0;53
76;Occitanie;65;2;14;167;Espieilh;26;1;27
76;Occitanie;65;1;16;168;Esquièze-Sère;401;12;413
76;Occitanie;65;1;16;169;Estaing;83;1;84
76;Occitanie;65;3;03;170;Estampures;78;2;80
76;Occitanie;65;2;08;171;Estarvielle;37;0;37
76;Occitanie;65;2;08;172;Estensan;40;0;40
76;Occitanie;65;1;16;173;Esterre;191;7;198
76;Occitanie;65;3;13;174;Estirac;103;4;107
76;Occitanie;65;2;15;175;Ferrère;42;2;44
76;Occitanie;65;1;16;176;Ferrières;90;0;90
76;Occitanie;65;3;03;177;Fontrailles;151;3;154
76;Occitanie;65;3;03;178;Fréchède;50;0;50
76;Occitanie;65;2;14;179;Fréchendets;29;0;29
76;Occitanie;65;2;08;180;Fréchet-Aure;12;0;12
76;Occitanie;65;3;14;181;Fréchou-Fréchet;163;3;166
76;Occitanie;65;1;16;182;Gaillagos;128;1;129
76;Occitanie;65;2;14;183;Galan;714;14;728
76;Occitanie;65;2;14;184;Galez;182;2;184
76;Occitanie;65;3;09;185;Gardères;443;11;454
76;Occitanie;65;2;15;186;Gaudent;39;1;40
76;Occitanie;65;3;03;187;Gaussan;111;4;115
76;Occitanie;65;1;16;192;Gavarnie-Gèdre;345;9;354
76;Occitanie;65;3;17;189;Gayan;277;2;279
76;Occitanie;65;2;08;190;Gazave;67;0;67
76;Occitanie;65;1;06;191;Gazost;126;2;128
76;Occitanie;65;2;15;193;Gembrie;77;3;80
76;Occitanie;65;2;15;194;Générest;101;1;102
76;Occitanie;65;2;08;195;Génos;137;0;137
76;Occitanie;65;3;13;196;Gensac;98;2;100
76;Occitanie;65;1;06;197;Ger;156;9;165
76;Occitanie;65;2;04;198;Gerde;1136;34;1170
76;Occitanie;65;2;08;199;Germ;36;0;36
76;Occitanie;65;1;06;200;Germs-sur-l'Oussouet;110;3;113
76;Occitanie;65;1;06;201;Geu;173;4;177
76;Occitanie;65;1;16;202;Gez;327;13;340
76;Occitanie;65;1;06;203;Gez-ez-Angles;27;1;28
76;Occitanie;65;3;03;204;Gonez;28;0;28
76;Occitanie;65;2;08;205;Gouaux;55;1;56
76;Occitanie;65;3;14;206;Goudon;231;6;237
76;Occitanie;65;2;14;207;Gourgue;62;0;62
76;Occitanie;65;2;08;208;Grailhen;22;2;24
76;Occitanie;65;2;08;209;Grézian;81;0;81
76;Occitanie;65;1;16;210;Grust;37;1;38
76;Occitanie;65;2;08;211;Guchan;140;5;145
76;Occitanie;65;2;08;212;Guchen;343;11;354
76;Occitanie;65;3;03;213;Guizerix;123;3;126
76;Occitanie;65;3;03;214;Hachan;43;0;43
76;Occitanie;65;3;13;215;Hagedet;46;2;48
76;Occitanie;65;2;14;216;Hauban;111;2;113
76;Occitanie;65;2;15;217;Hautaget;54;2;56
76;Occitanie;65;2;08;218;Hèches;616;13;629
76;Occitanie;65;3;13;219;Hères;124;2;126
76;Occitanie;65;3;09;220;Hibarette;246;1;247
76;Occitanie;65;2;04;221;Hiis;251;5;256
76;Occitanie;65;3;14;222;Hitte;163;1;164
76;Occitanie;65;3;07;223;Horgues;1198;37;1235
76;Occitanie;65;2;14;224;Houeydets;267;6;273
76;Occitanie;65;3;03;225;Hourc;109;1;110
76;Occitanie;65;3;02;226;Ibos;2895;137;3032
76;Occitanie;65;2;08;228;Ilhet;118;0;118
76;Occitanie;65;2;15;229;Ilheu;38;0;38
76;Occitanie;65;2;15;230;Izaourt;257;6;263
76;Occitanie;65;2;08;231;Izaux;202;9;211
76;Occitanie;65;3;03;232;Jacque;74;1;75
76;Occitanie;65;1;06;233;Jarret;320;4;324
76;Occitanie;65;2;08;234;Jézeau;97;3;100
76;Occitanie;65;3;09;235;Juillan;4106;97;4203
76;Occitanie;65;1;06;236;Julos;405;11;416
76;Occitanie;65;1;06;237;Juncalas;166;5;171
76;Occitanie;65;2;04;238;Labassère;235;9;244
76;Occitanie;65;2;08;239;Labastide;157;5;162
76;Occitanie;65;3;13;240;Labatut-Rivière;397;5;402
76;Occitanie;65;2;08;241;Laborde;84;1;85
76;Occitanie;65;3;13;242;Lacassagne;232;2;234
76;Occitanie;65;3;13;243;Lafitole;477;12;489
76;Occitanie;65;3;17;244;Lagarde;524;7;531
76;Occitanie;65;2;15;245;Lagrange;227;7;234
76;Occitanie;65;3;13;248;Lahitte-Toupière;261;9;270
76;Occitanie;65;3;03;249;Lalanne;98;6;104
76;Occitanie;65;3;03;250;Lalanne-Trie;115;1;116
76;Occitanie;65;3;07;251;Laloubère;1883;57;1940
76;Occitanie;65;3;09;252;Lamarque-Pontacq;852;14;866
76;Occitanie;65;3;03;253;Lamarque-Rustaing;53;0;53
76;Occitanie;65;3;13;254;Laméac;147;4;151
76;Occitanie;65;3;14;256;Lanespède;150;2;152
76;Occitanie;65;3;09;257;Lanne;588;9;597
76;Occitanie;65;2;15;258;Lannemezan;5837;159;5996
76;Occitanie;65;3;03;259;Lansac;177;4;181
76;Occitanie;65;2;08;255;Lançon;32;0;32
76;Occitanie;65;3;03;260;Lapeyre;101;5;106
76;Occitanie;65;3;03;261;Laran;48;1;49
76;Occitanie;65;3;13;262;Larreule;410;14;424
76;Occitanie;65;3;03;263;Larroque;99;3;102
76;Occitanie;65;3;13;264;Lascazères;311;27;338
76;Occitanie;65;3;03;265;Laslades;340;10;350
76;Occitanie;65;3;03;266;Lassales;33;1;34
76;Occitanie;65;1;16;267;Lau-Balagnas;524;16;540
76;Occitanie;65;3;09;268;Layrisse;185;0;185
76;Occitanie;65;3;13;269;Lescurry;171;3;174
76;Occitanie;65;3;14;270;Lespouey;209;9;218
76;Occitanie;65;1;06;271;Lézignan;350;8;358
76;Occitanie;65;3;14;272;Lhez;77;0;77
76;Occitanie;65;3;13;273;Liac;196;1;197
76;Occitanie;65;2;14;274;Libaros;136;1;137
76;Occitanie;65;2;14;275;Lies;71;2;73
76;Occitanie;65;3;03;276;Lizos;117;1;118
76;Occitanie;65;2;15;277;Lombrès;100;3;103
76;Occitanie;65;2;14;278;Lomné;31;0;31
76;Occitanie;65;2;08;279;Lortet;213;8;221
76;Occitanie;65;1;05;280;Loubajac;403;8;411
76;Occitanie;65;3;09;281;Loucrup;228;4;232
76;Occitanie;65;2;08;282;Loudenvielle;301;5;306
76;Occitanie;65;2;08;283;Loudervielle;54;1;55
76;Occitanie;65;3;09;284;Louey;990;26;1016
76;Occitanie;65;3;03;285;Louit;196;3;199
76;Occitanie;65;1;98;286;Lourdes;13389;303;13692
76;Occitanie;65;2;15;287;Loures-Barousse;626;13;639
76;Occitanie;65;3;03;288;Lubret-Saint-Luc;55;0;55
76;Occitanie;65;3;03;289;Luby-Betmont;107;1;108
76;Occitanie;65;3;14;290;Luc;213;3;216
76;Occitanie;65;1;06;291;Lugagnan;136;3;139
76;Occitanie;65;3;09;292;Luquet;397;3;400
76;Occitanie;65;3;03;293;Lustar;118;3;121
76;Occitanie;65;2;14;294;Lutilhous;223;3;226
76;Occitanie;65;1;16;295;Luz-Saint-Sauveur;966;16;982
76;Occitanie;65;3;13;296;Madiran;418;10;428
76;Occitanie;65;3;13;297;Mansan;42;5;47
76;Occitanie;65;3;03;298;Marquerie;80;0;80
76;Occitanie;65;3;17;299;Marsac;224;4;228
76;Occitanie;65;2;14;300;Marsas;69;5;74
76;Occitanie;65;3;03;301;Marseillan;255;4;259
76;Occitanie;65;3;14;303;Mascaras;353;4;357
76;Occitanie;65;3;13;304;Maubourguet;2377;31;2408
76;Occitanie;65;2;15;305;Mauléon-Barousse;95;0;95
76;Occitanie;65;2;14;306;Mauvezin;234;4;238
76;Occitanie;65;2;15;307;Mazères-de-Neste;330;6;336
76;Occitanie;65;3;03;308;Mazerolles;106;4;110
76;Occitanie;65;2;08;309;Mazouau;16;3;19
76;Occitanie;65;2;14;310;Mérilheu;253;4;257
76;Occitanie;65;3;13;311;Mingot;99;0;99
76;Occitanie;65;3;07;313;Momères;759;19;778
76;Occitanie;65;3;13;314;Monfaucon;210;6;216
76;Occitanie;65;3;03;315;Monléon-Magnoac;439;241;680
76;Occitanie;65;3;03;316;Monlong;102;4;106
76;Occitanie;65;2;08;317;Mont;42;2;44
76;Occitanie;65;2;14;318;Montastruc;233;6;239
76;Occitanie;65;2;15;319;Montégut;135;2;137
76;Occitanie;65;2;04;320;Montgaillard;850;17;867
76;Occitanie;65;3;07;321;Montignac;138;2;140
76;Occitanie;65;2;08;322;Montoussé;250;7;257
76;Occitanie;65;2;15;323;Montsérié;80;0;80
76;Occitanie;65;3;14;324;Moulédous;211;7;218
76;Occitanie;65;3;13;325;Moumoulous;42;0;42
76;Occitanie;65;3;03;326;Mun;101;2;103
76;Occitanie;65;2;15;327;Nestier;156;2;158
76;Occitanie;65;2;04;328;Neuilh;98;4;102
76;Occitanie;65;2;15;329;Nistos;215;5;220
76;Occitanie;65;3;17;330;Nouilhan;200;4;204
76;Occitanie;65;3;07;331;Odos;3242;97;3339
76;Occitanie;65;3;03;332;Oléac-Debat;170;1;171
76;Occitanie;65;3;14;333;Oléac-Dessus;120;1;121
76;Occitanie;65;1;05;334;Omex;227;3;230
76;Occitanie;65;2;04;335;Ordizan;544;21;565
76;Occitanie;65;3;03;336;Organ;44;0;44
76;Occitanie;65;3;14;337;Orieux;115;3;118
76;Occitanie;65;2;14;338;Orignac;255;3;258
76;Occitanie;65;3;09;339;Orincles;330;7;337
76;Occitanie;65;3;02;340;Orleix;2127;33;2160
76;Occitanie;65;3;17;341;Oroix;120;2;122
76;Occitanie;65;3;03;342;Osmets;90;2;92
76;Occitanie;65;1;05;343;Ossen;233;4;237
76;Occitanie;65;3;09;344;Ossun;2368;49;2417
76;Occitanie;65;1;06;345;Ossun-ez-Angles;50;1;51
76;Occitanie;65;3;14;346;Oueilloux;179;5;184
76;Occitanie;65;2;15;347;Ourde;40;0;40
76;Occitanie;65;1;06;348;Ourdis-Cotdoussan;48;2;50
76;Occitanie;65;1;06;349;Ourdon;7;0;7
76;Occitanie;65;3;02;350;Oursbelille;1179;40;1219
76;Occitanie;65;1;06;351;Ousté;26;2;28
76;Occitanie;65;1;16;352;Ouzous;212;9;221
76;Occitanie;65;3;14;353;Ozon;279;5;284
76;Occitanie;65;2;08;354;Pailhac;69;2;71
76;Occitanie;65;1;06;355;Paréac;63;0;63
76;Occitanie;65;2;14;356;Péré;55;2;57
76;Occitanie;65;3;14;357;Peyraube;161;4;165
76;Occitanie;65;3;03;358;Peyret-Saint-André;54;2;56
76;Occitanie;65;3;03;359;Peyriguère;27;0;27
76;Occitanie;65;1;05;360;Peyrouse;276;7;283
76;Occitanie;65;3;13;361;Peyrun;84;1;85
76;Occitanie;65;1;16;362;Pierrefitte-Nestalas;1139;25;1164
76;Occitanie;65;2;15;363;Pinas;446;9;455
76;Occitanie;65;3;17;364;Pintac;22;3;25
76;Occitanie;65;1;05;366;Poueyferré;849;17;866
76;Occitanie;65;3;14;367;Poumarous;156;3;159
76;Occitanie;65;3;03;368;Pouy;46;1;47
76;Occitanie;65;3;03;369;Pouyastruc;675;22;697
76;Occitanie;65;2;04;370;Pouzac;1112;38;1150
76;Occitanie;65;1;16;371;Préchac;230;10;240
76;Occitanie;65;3;17;372;Pujo;636;13;649
76;Occitanie;65;3;03;373;Puntous;181;4;185
76;Occitanie;65;3;03;374;Puydarrieux;223;1;224
76;Occitanie;65;3;13;375;Rabastens-de-Bigorre;1453;26;1479
76;Occitanie;65;2;14;376;Recurt;204;8;212
76;Occitanie;65;2;15;377;Réjaumont;164;4;168
76;Occitanie;65;3;14;378;Ricaud;66;2;68
76;Occitanie;65;2;08;379;Ris;16;0;16
76;Occitanie;65;3;03;380;Sabalos;147;1;148
76;Occitanie;65;2;14;381;Sabarros;34;0;34
76;Occitanie;65;2;15;382;Sacoué;62;2;64
76;Occitanie;65;3;03;383;Sadournin;183;2;185
76;Occitanie;65;2;08;384;Sailhan;161;1;162
76;Occitanie;65;2;08;385;Saint-Arroman;87;5;92
76;Occitanie;65;1;06;386;Saint-Créac;97;0;97
76;Occitanie;65;3;13;387;Saint-Lanne;141;2;143
76;Occitanie;65;2;08;388;Saint-Lary-Soulan;835;25;860
76;Occitanie;65;2;15;389;Saint-Laurent-de-Neste;927;38;965
76;Occitanie;65;3;17;390;Saint-Lézer;426;14;440
76;Occitanie;65;3;07;392;Saint-Martin;452;12;464
76;Occitanie;65;1;16;393;Saint-Pastous;135;5;140
76;Occitanie;65;2;15;394;Saint-Paul;315;3;318
76;Occitanie;65;1;05;395;Saint-Pé-de-Bigorre;1162;16;1178
76;Occitanie;65;1;16;396;Saint-Savin;373;7;380
76;Occitanie;65;3;13;397;Saint-Sever-de-Rustan;173;2;175
76;Occitanie;65;2;15;391;Sainte-Marie;65;0;65
76;Occitanie;65;2;15;398;Saléchan;272;4;276
76;Occitanie;65;1;16;399;Saligos;107;3;110
76;Occitanie;65;1;16;400;Salles;233;7;240
76;Occitanie;65;3;07;401;Salles-Adour;594;7;601
76;Occitanie;65;2;15;402;Samuran;26;0;26
76;Occitanie;65;3;17;403;Sanous;98;2;100
76;Occitanie;65;3;03;404;Sariac-Magnoac;153;3;156
76;Occitanie;65;2;14;405;Sarlabous;68;4;72
76;Occitanie;65;3;17;406;Sarniguet;255;5;260
76;Occitanie;65;2;15;407;Sarp;108;2;110
76;Occitanie;65;2;08;408;Sarrancolin;563;13;576
76;Occitanie;65;3;13;409;Sarriac-Bigorre;303;5;308
76;Occitanie;65;3;07;410;Sarrouilles;529;17;546
76;Occitanie;65;1;16;411;Sassis;80;6;86
76;Occitanie;65;3;13;412;Sauveterre;169;4;173
76;Occitanie;65;1;16;413;Sazos;129;4;133
76;Occitanie;65;3;13;414;Ségalas;81;4;85
76;Occitanie;65;1;05;415;Ségus;235;1;236
76;Occitanie;65;2;15;416;Seich;89;3;92
76;Occitanie;65;3;01;417;Séméac;4926;135;5061
76;Occitanie;65;3;13;418;Sénac;296;7;303
76;Occitanie;65;2;14;419;Sentous;69;0;69
76;Occitanie;65;1;16;420;Sère-en-Lavedan;74;2;76
76;Occitanie;65;1;06;421;Sère-Lanso;52;2;54
76;Occitanie;65;3;03;423;Sère-Rustaing;127;0;127
76;Occitanie;65;3;09;422;Séron;327;3;330
76;Occitanie;65;1;16;424;Sers;114;2;116
76;Occitanie;65;3;17;425;Siarrouy;436;7;443
76;Occitanie;65;3;14;426;Sinzos;140;6;146
76;Occitanie;65;2;15;427;Siradan;284;5;289
76;Occitanie;65;1;16;428;Sireix;64;1;65
76;Occitanie;65;3;13;429;Sombrun;207;8;215
76;Occitanie;65;3;03;430;Soréac;47;1;48
76;Occitanie;65;2;15;431;Sost;92;4;96
76;Occitanie;65;3;13;432;Soublecause;187;3;190
76;Occitanie;65;3;01;433;Soues;3061;58;3119
76;Occitanie;65;1;16;435;Soulom;256;8;264
76;Occitanie;65;3;03;436;Souyeaux;306;7;313
76;Occitanie;65;2;15;437;Tajan;134;3;137
76;Occitanie;65;3;17;438;Talazac;76;1;77
76;Occitanie;65;3;17;439;Tarasteix;266;3;269
76;Occitanie;65;3;99;440;Tarbes;41518;1072;42590
76;Occitanie;65;2;15;441;Thèbe;76;3;79
76;Occitanie;65;3;03;442;Thermes-Magnoac;212;1;213
76;Occitanie;65;3;03;443;Thuy;19;0;19
76;Occitanie;65;2;15;444;Tibiran-Jaunac;312;4;316
76;Occitanie;65;2;14;445;Tilhouse;221;2;223
76;Occitanie;65;3;13;446;Tostat;535;8;543
76;Occitanie;65;3;14;447;Tournay;1209;20;1229
76;Occitanie;65;3;03;448;Tournous-Darré;87;4;91
76;Occitanie;65;2;14;449;Tournous-Devant;105;6;111
76;Occitanie;65;2;08;450;Tramezaïgues;34;1;35
76;Occitanie;65;2;04;451;Trébons;760;14;774
76;Occitanie;65;3;03;452;Trie-sur-Baïse;1043;25;1068
76;Occitanie;65;2;15;453;Troubat;74;1;75
76;Occitanie;65;3;13;454;Trouley-Labarthe;99;1;100
76;Occitanie;65;2;15;455;Tuzaguet;453;9;462
76;Occitanie;65;2;15;456;Uglas;287;11;298
76;Occitanie;65;3;13;457;Ugnouas;79;1;80
76;Occitanie;65;1;16;458;Uz;33;1;34
76;Occitanie;65;2;14;459;Uzer;105;4;109
76;Occitanie;65;3;17;460;Vic-en-Bigorre;4897;275;5172
76;Occitanie;65;3;03;461;Vidou;106;1;107
76;Occitanie;65;3;13;462;Vidouze;241;9;250
76;Occitanie;65;1;16;463;Viella;88;3;91
76;Occitanie;65;3;07;464;Vielle-Adour;509;10;519
76;Occitanie;65;2;08;465;Vielle-Aure;330;9;339
76;Occitanie;65;2;08;466;Vielle-Louron;94;0;94
76;Occitanie;65;1;16;467;Vier-Bordes;102;6;108
76;Occitanie;65;3;03;468;Vieuzos;44;1;45
76;Occitanie;65;1;16;469;Viey;32;2;34
76;Occitanie;65;1;05;470;Viger;140;3;143
76;Occitanie;65;2;08;471;Vignec;222;8;230
76;Occitanie;65;3;13;472;Villefranque;79;3;82
76;Occitanie;65;1;16;473;Villelongue;399;15;414
76;Occitanie;65;3;03;474;Villembits;115;2;117
76;Occitanie;65;3;03;475;Villemur;59;1;60
76;Occitanie;65;3;17;476;Villenave-près-Béarn;59;4;63
76;Occitanie;65;3;17;477;Villenave-près-Marsac;90;2;92
76;Occitanie;65;1;16;478;Viscos;35;2;37
76;Occitanie;65;3;09;479;Visker;340;10;350
76;Occitanie;66;1;17;001;L' Albère;80;1;81
76;Occitanie;66;1;12;002;Alénya;3601;59;3660
76;Occitanie;66;1;02;003;Amélie-les-Bains-Palalda;3460;32;3492
76;Occitanie;66;3;13;004;Les Angles;547;8;555
76;Occitanie;66;3;13;005;Angoustrine-Villeneuve-des-Escaldes;608;38;646
76;Occitanie;66;3;15;006;Ansignan;166;2;168
76;Occitanie;66;3;15;007;Arboussols;118;2;120
76;Occitanie;66;1;05;008;Argelès-sur-Mer;10383;240;10623
76;Occitanie;66;1;02;009;Arles-sur-Tech;2705;37;2742
76;Occitanie;66;3;13;010;Ayguatébia-Talau;38;0;38
76;Occitanie;66;1;12;011;Bages;4174;53;4227
76;Occitanie;66;2;14;012;Baho;3217;59;3276
76;Occitanie;66;3;02;013;Baillestavy;115;2;117
76;Occitanie;66;2;14;014;Baixas;2573;51;2624
76;Occitanie;66;1;01;015;Banyuls-dels-Aspres;1259;21;1280
76;Occitanie;66;1;05;016;Banyuls-sur-Mer;4761;77;4838
76;Occitanie;66;2;04;017;Le Barcarès;5915;40;5955
76;Occitanie;66;1;02;018;La Bastide;72;2;74
76;Occitanie;66;3;15;019;Bélesta;221;4;225
76;Occitanie;66;3;13;020;Bolquère;808;26;834
76;Occitanie;66;2;07;021;Bompas;7254;102;7356
76;Occitanie;66;3;02;022;Boule-d'Amont;55;0;55
76;Occitanie;66;3;02;023;Bouleternère;935;8;943
76;Occitanie;66;1;17;024;Le Boulou;5514;56;5570
76;Occitanie;66;3;13;025;Bourg-Madame;1224;82;1306
76;Occitanie;66;1;01;026;Brouilla;1437;15;1452
76;Occitanie;66;3;13;027;La Cabanasse;669;13;682
76;Occitanie;66;2;08;028;Cabestany;10106;215;10321
76;Occitanie;66;1;01;029;Caixas;142;1;143
76;Occitanie;66;2;14;030;Calce;210;2;212
76;Occitanie;66;1;01;032;Calmeilles;59;0;59
76;Occitanie;66;1;01;033;Camélas;464;7;471
76;Occitanie;66;3;13;034;Campôme;111;4;115
76;Occitanie;66;3;15;035;Campoussy;37;1;38
76;Occitanie;66;3;13;036;Canaveilles;26;0;26
76;Occitanie;66;2;03;037;Canet-en-Roussillon;12130;246;12376
76;Occitanie;66;2;10;038;Canohès;6097;109;6206
76;Occitanie;66;3;15;039;Caramany;150;3;153
76;Occitanie;66;3;02;040;Casefabre;40;1;41
76;Occitanie;66;2;15;041;Cases-de-Pène;926;22;948
76;Occitanie;66;2;15;042;Cassagnes;267;6;273
76;Occitanie;66;3;02;043;Casteil;136;2;138
76;Occitanie;66;1;01;044;Castelnou;315;5;320
76;Occitanie;66;3;13;045;Catllar;771;15;786
76;Occitanie;66;3;13;047;Caudiès-de-Conflent;17;2;19
76;Occitanie;66;3;15;046;Caudiès-de-Fenouillèdes;618;12;630
76;Occitanie;66;1;05;048;Cerbère;1355;17;1372
76;Occitanie;66;1;17;049;Céret;7798;228;8026
76;Occitanie;66;2;04;050;Claira;4181;53;4234
76;Occitanie;66;3;13;051;Clara-Villerach;256;6;262
76;Occitanie;66;1;17;063;Les Cluses;242;3;245
76;Occitanie;66;3;13;052;Codalet;386;12;398
76;Occitanie;66;1;05;053;Collioure;2427;29;2456
76;Occitanie;66;3;13;054;Conat;61;3;64
76;Occitanie;66;3;16;055;Corbère;733;22;755
76;Occitanie;66;3;16;056;Corbère-les-Cabanes;1070;15;1085
76;Occitanie;66;3;02;057;Corneilla-de-Conflent;490;4;494
76;Occitanie;66;1;12;059;Corneilla-del-Vercol;2293;28;2321
76;Occitanie;66;3;16;058;Corneilla-la-Rivière;1991;36;2027
76;Occitanie;66;1;02;060;Corsavy;218;19;237
76;Occitanie;66;1;02;061;Coustouges;98;0;98
76;Occitanie;66;3;13;062;Dorres;169;7;176
76;Occitanie;66;3;13;064;Égat;438;11;449
76;Occitanie;66;1;12;065;Elne;8941;108;9049
76;Occitanie;66;3;13;066;Enveitg;641;22;663
76;Occitanie;66;3;13;067;Err;673;22;695
76;Occitanie;66;3;13;068;Escaro;106;1;107
76;Occitanie;66;3;02;070;Espira-de-Conflent;168;3;171
76;Occitanie;66;2;15;069;Espira-de-l'Agly;3455;149;3604
76;Occitanie;66;2;15;071;Estagel;2016;18;2034
76;Occitanie;66;3;13;072;Estavar;472;17;489
76;Occitanie;66;3;02;073;Estoher;145;1;146
76;Occitanie;66;3;13;074;Eus;388;4;392
76;Occitanie;66;3;13;075;Eyne;130;8;138
76;Occitanie;66;3;15;076;Felluns;70;0;70
76;Occitanie;66;3;15;077;Fenouillet;89;1;90
76;Occitanie;66;3;02;078;Fillols;185;7;192
76;Occitanie;66;3;02;079;Finestret;176;7;183
76;Occitanie;66;3;13;124;Font-Romeu-Odeillo-Via;1928;216;2144
76;Occitanie;66;3;13;080;Fontpédrouse;123;2;125
76;Occitanie;66;3;13;081;Fontrabiouse;127;3;130
76;Occitanie;66;3;13;082;Formiguères;479;4;483
76;Occitanie;66;3;15;083;Fosse;40;0;40
76;Occitanie;66;1;01;084;Fourques;1280;19;1299
76;Occitanie;66;3;02;085;Fuilla;448;24;472
76;Occitanie;66;3;02;086;Glorianes;25;0;25
76;Occitanie;66;3;16;088;Ille-sur-Têt;5446;61;5507
76;Occitanie;66;3;02;089;Joch;265;8;273
76;Occitanie;66;3;13;090;Jujols;44;2;46
76;Occitanie;66;1;02;091;Lamanère;46;1;47
76;Occitanie;66;3;15;092;Lansac;89;0;89
76;Occitanie;66;1;17;093;Laroque-des-Albères;2112;41;2153
76;Occitanie;66;1;12;094;Latour-Bas-Elne;2797;41;2838
76;Occitanie;66;3;13;095;Latour-de-Carol;424;4;428
76;Occitanie;66;3;15;096;Latour-de-France;1026;14;1040
76;Occitanie;66;3;15;097;Lesquerde;133;3;136
76;Occitanie;66;3;13;098;La Llagonne;219;10;229
76;Occitanie;66;1;01;099;Llauro;317;2;319
76;Occitanie;66;3;13;100;Llo;172;3;175
76;Occitanie;66;2;01;101;Llupia;1943;41;1984
76;Occitanie;66;3;02;102;Mantet;30;1;31
76;Occitanie;66;3;02;103;Marquixanes;555;7;562
76;Occitanie;66;3;13;104;Los Masos;966;12;978
76;Occitanie;66;3;13;105;Matemale;267;5;272
76;Occitanie;66;1;17;106;Maureillas-las-Illas;2544;47;2591
76;Occitanie;66;3;15;107;Maury;785;5;790
76;Occitanie;66;3;16;108;Millas;4279;48;4327
76;Occitanie;66;3;13;109;Molitg-les-Bains;233;4;237
76;Occitanie;66;3;13;117;Mont-Louis;152;9;161
76;Occitanie;66;3;16;111;Montalba-le-Château;149;2;151
76;Occitanie;66;1;01;112;Montauriol;247;5;252
76;Occitanie;66;1;02;113;Montbolo;180;2;182
76;Occitanie;66;1;12;114;Montescot;1712;39;1751
76;Occitanie;66;1;17;115;Montesquieu-des-Albères;1224;23;1247
76;Occitanie;66;1;02;116;Montferrer;188;4;192
76;Occitanie;66;2;15;118;Montner;348;7;355
76;Occitanie;66;3;13;119;Mosset;308;7;315
76;Occitanie;66;3;13;120;Nahuja;76;3;79
76;Occitanie;66;3;16;121;Néfiach;1280;35;1315
76;Occitanie;66;3;13;122;Nohèdes;63;2;65
76;Occitanie;66;3;13;123;Nyer;148;2;150
76;Occitanie;66;3;13;125;Olette;364;5;369
76;Occitanie;66;1;01;126;Oms;333;4;337
76;Occitanie;66;2;15;127;Opoul-Périllos;1199;8;1207
76;Occitanie;66;3;13;128;Oreilla;23;0;23
76;Occitanie;66;1;12;129;Ortaffa;1481;19;1500
76;Occitanie;66;3;13;130;Osséja;1330;64;1394
76;Occitanie;66;3;13;132;Palau-de-Cerdagne;408;10;418
76;Occitanie;66;1;05;133;Palau-del-Vidre;3142;45;3187
76;Occitanie;66;1;01;134;Passa;820;9;829
76;Occitanie;66;2;99;136;Perpignan;120158;1523;121681
76;Occitanie;66;1;17;137;Le Perthus;574;3;577
76;Occitanie;66;2;14;138;Peyrestortes;1427;24;1451
76;Occitanie;66;3;15;139;Pézilla-de-Conflent;46;0;46
76;Occitanie;66;2;14;140;Pézilla-la-Rivière;3662;53;3715
76;Occitanie;66;2;04;141;Pia;9035;87;9122
76;Occitanie;66;3;13;142;Planès;53;2;55
76;Occitanie;66;3;15;143;Planèzes;99;2;101
76;Occitanie;66;2;01;144;Pollestres;4887;80;4967
76;Occitanie;66;2;01;145;Ponteilla;2738;42;2780
76;Occitanie;66;1;05;148;Port-Vendres;4129;75;4204
76;Occitanie;66;3;13;146;Porta;116;7;123
76;Occitanie;66;3;13;147;Porté-Puymorens;101;8;109
76;Occitanie;66;3;13;149;Prades;6124;341;6465
76;Occitanie;66;1;02;150;Prats-de-Mollo-la-Preste;1163;19;1182
76;Occitanie;66;3;15;151;Prats-de-Sournia;78;4;82
76;Occitanie;66;3;15;152;Prugnanes;104;0;104
76;Occitanie;66;3;02;153;Prunet-et-Belpuig;49;0;49
76;Occitanie;66;3;13;154;Puyvalador;72;1;73
76;Occitanie;66;3;02;155;Py;88;0;88
76;Occitanie;66;3;15;156;Rabouillet;103;1;104
76;Occitanie;66;3;13;157;Railleu;32;1;33
76;Occitanie;66;3;15;158;Rasiguères;152;3;155
76;Occitanie;66;3;13;159;Réal;66;0;66
76;Occitanie;66;1;02;160;Reynès;1328;20;1348
76;Occitanie;66;3;13;161;Ria-Sirach;1325;30;1355
76;Occitanie;66;3;02;162;Rigarda;641;3;644
76;Occitanie;66;2;15;164;Rivesaltes;8610;163;8773
76;Occitanie;66;3;02;165;Rodès;619;6;625
76;Occitanie;66;3;02;166;Sahorre;382;6;388
76;Occitanie;66;3;13;167;Saillagouse;1089;25;1114
76;Occitanie;66;1;05;168;Saint-André;3443;42;3485
76;Occitanie;66;3;15;169;Saint-Arnac;115;1;116
76;Occitanie;66;1;03;171;Saint-Cyprien;10511;166;10677
76;Occitanie;66;2;14;172;Saint-Estève;11658;176;11834
76;Occitanie;66;3;16;173;Saint-Féliu-d'Amont;1133;17;1150
76;Occitanie;66;2;16;174;Saint-Féliu-d'Avall;2797;38;2835
76;Occitanie;66;1;17;175;Saint-Génis-des-Fontaines;2826;26;2852
76;Occitanie;66;2;04;176;Saint-Hippolyte;3052;29;3081
76;Occitanie;66;1;01;177;Saint-Jean-Lasseille;1540;18;1558
76;Occitanie;66;1;17;178;Saint-Jean-Pla-de-Corts;2218;45;2263
76;Occitanie;66;1;02;179;Saint-Laurent-de-Cerdans;1098;10;1108
76;Occitanie;66;2;04;180;Saint-Laurent-de-la-Salanque;10246;107;10353
76;Occitanie;66;1;02;183;Saint-Marsal;71;0;71
76;Occitanie;66;3;15;184;Saint-Martin-de-Fenouillet;55;4;59
76;Occitanie;66;3;02;185;Saint-Michel-de-Llotes;348;12;360
76;Occitanie;66;2;03;186;Saint-Nazaire;2688;40;2728
76;Occitanie;66;3;15;187;Saint-Paul-de-Fenouillet;1812;13;1825
76;Occitanie;66;3;13;188;Saint-Pierre-dels-Forcats;267;9;276
76;Occitanie;66;1;01;170;Sainte-Colombe-de-la-Commanderie;153;2;155
76;Occitanie;66;3;13;181;Sainte-Léocadie;127;1;128
76;Occitanie;66;2;07;182;Sainte-Marie-la-Mer;4773;61;4834
76;Occitanie;66;2;03;189;Saleilles;5282;97;5379
76;Occitanie;66;2;15;190;Salses-le-Château;3501;13;3514
76;Occitanie;66;3;13;191;Sansa;22;0;22
76;Occitanie;66;3;13;192;Sauto;91;1;92
76;Occitanie;66;3;13;193;Serdinya;246;10;256
76;Occitanie;66;1;02;194;Serralongue;226;2;228
76;Occitanie;66;2;16;195;Le Soler;7710;112;7822
76;Occitanie;66;1;17;196;Sorède;3267;47;3314
76;Occitanie;66;3;13;197;Souanyas;37;0;37
76;Occitanie;66;3;15;198;Sournia;498;5;503
76;Occitanie;66;1;02;199;Taillet;105;1;106
76;Occitanie;66;3;15;201;Tarerach;46;1;47
76;Occitanie;66;3;13;202;Targassonne;184;5;189
76;Occitanie;66;1;02;203;Taulis;52;0;52
76;Occitanie;66;3;02;204;Taurinya;336;11;347
76;Occitanie;66;2;15;205;Tautavel;866;19;885
76;Occitanie;66;1;02;206;Le Tech;95;0;95
76;Occitanie;66;1;01;207;Terrats;640;14;654
76;Occitanie;66;1;12;208;Théza;2040;97;2137
76;Occitanie;66;3;13;209;Thuès-Entre-Valls;37;2;39
76;Occitanie;66;1;01;210;Thuir;7635;130;7765
76;Occitanie;66;1;01;211;Tordères;165;7;172
76;Occitanie;66;2;04;212;Torreilles;3812;53;3865
76;Occitanie;66;2;11;213;Toulouges;6881;119;7000
76;Occitanie;66;1;01;214;Tresserre;1066;13;1079
76;Occitanie;66;3;15;215;Trévillach;157;0;157
76;Occitanie;66;3;15;216;Trilla;74;2;76
76;Occitanie;66;1;01;217;Trouillas;2067;23;2090
76;Occitanie;66;3;13;218;Ur;363;11;374
76;Occitanie;66;3;13;219;Urbanya;55;1;56
76;Occitanie;66;3;13;220;Valcebollère;42;2;44
76;Occitanie;66;3;02;221;Valmanya;34;0;34
76;Occitanie;66;3;02;222;Vernet-les-Bains;1387;38;1425
76;Occitanie;66;3;13;223;Villefranche-de-Conflent;213;5;218
76;Occitanie;66;2;07;224;Villelongue-de-la-Salanque;3254;35;3289
76;Occitanie;66;1;17;225;Villelongue-dels-Monts;1706;67;1773
76;Occitanie;66;1;01;226;Villemolaque;1370;22;1392
76;Occitanie;66;2;12;227;Villeneuve-de-la-Raho;3926;65;3991
76;Occitanie;66;2;14;228;Villeneuve-la-Rivière;1316;24;1340
76;Occitanie;66;2;15;231;Vingrau;606;11;617
76;Occitanie;66;3;02;230;Vinça;2075;25;2100
76;Occitanie;66;3;15;232;Vira;26;0;26
76;Occitanie;66;1;17;233;Vivès;176;4;180
76;Occitanie;66;3;15;234;Le Vivier;75;0;75
44;Grand Est;67;8;09;001;Achenheim;2123;29;2152
44;Grand Est;67;4;08;002;Adamswiller;377;14;391
44;Grand Est;67;5;11;003;Albé;446;15;461
44;Grand Est;67;4;02;005;Alteckendorf;868;19;887
44;Grand Est;67;4;14;006;Altenheim;212;1;213
44;Grand Est;67;3;10;008;Altorf;1293;18;1311
44;Grand Est;67;4;08;009;Altwiller;395;13;408
44;Grand Est;67;5;12;010;Andlau;1739;78;1817
44;Grand Est;67;5;16;011;Artolsheim;996;9;1005
44;Grand Est;67;2;23;012;Aschbach;682;20;702
44;Grand Est;67;4;08;013;Asswiller;276;3;279
44;Grand Est;67;3;10;016;Avolsheim;713;14;727
44;Grand Est;67;4;08;017;Baerendorf;302;5;307
44;Grand Est;67;3;14;018;Balbronn;656;10;666
44;Grand Est;67;5;16;019;Baldenheim;1169;18;1187
44;Grand Est;67;3;11;020;Barembach;874;7;881
44;Grand Est;67;5;12;021;Barr;7238;160;7398
44;Grand Est;67;5;11;022;Bassemberg;249;6;255
44;Grand Est;67;2;05;023;Batzendorf;988;20;1008
44;Grand Est;67;2;23;025;Beinheim;1875;23;1898
44;Grand Est;67;3;11;026;Bellefosse;150;0;150
44;Grand Est;67;3;11;027;Belmont;167;0;167
44;Grand Est;67;5;04;028;Benfeld;5753;96;5849
44;Grand Est;67;4;08;029;Berg;365;4;369
44;Grand Est;67;3;10;030;Bergbieten;704;7;711
44;Grand Est;67;5;12;031;Bernardswiller;1455;44;1499
44;Grand Est;67;5;12;032;Bernardvillé;231;2;233
44;Grand Est;67;2;03;033;Bernolsheim;602;7;609
44;Grand Est;67;4;02;034;Berstett;2437;41;2478
44;Grand Est;67;2;05;035;Berstheim;437;14;451
44;Grand Est;67;2;23;339;Betschdorf;4161;46;4207
44;Grand Est;67;4;08;036;Bettwiller;308;7;315
44;Grand Est;67;2;13;037;Biblisheim;358;5;363
44;Grand Est;67;2;03;038;Bietlenheim;277;3;280
44;Grand Est;67;2;03;039;Bilwisheim;467;1;468
44;Grand Est;67;5;16;040;Bindernheim;1032;10;1042
44;Grand Est;67;8;15;043;Bischheim;17093;202;17295
44;Grand Est;67;4;08;044;Bischholtz;273;0;273
44;Grand Est;67;3;10;045;Bischoffsheim;3330;58;3388
44;Grand Est;67;2;01;046;Bischwiller;12538;125;12663
44;Grand Est;67;4;08;047;Bissert;155;3;158
44;Grand Est;67;2;13;048;Bitschhoffen;459;15;474
44;Grand Est;67;8;09;049;Blaesheim;1316;19;1335
44;Grand Est;67;3;11;050;Blancherupt;38;3;41
44;Grand Est;67;5;12;051;Blienschwiller;321;10;331
44;Grand Est;67;5;04;054;Bolsenheim;531;5;536
44;Grand Est;67;5;04;055;Boofzheim;1381;17;1398
44;Grand Est;67;5;16;056;Bootzheim;728;6;734
44;Grand Est;67;4;02;057;Bosselshausen;166;7;173
44;Grand Est;67;4;02;058;Bossendorf;399;8;407
44;Grand Est;67;3;11;059;Bourg-Bruche;468;9;477
44;Grand Est;67;5;12;060;Bourgheim;640;10;650
44;Grand Est;67;4;02;061;Bouxwiller;3963;90;4053
44;Grand Est;67;5;11;062;Breitenau;313;6;319
44;Grand Est;67;5;11;063;Breitenbach;665;16;681
44;Grand Est;67;8;09;065;Breuschwickersheim;1253;20;1273
44;Grand Est;67;3;11;066;La Broque;2663;87;2750
44;Grand Est;67;2;03;067;Brumath;9986;103;10089
44;Grand Est;67;2;23;069;Buhl;524;1;525
44;Grand Est;67;4;08;070;Burbach;274;3;277
44;Grand Est;67;4;08;071;Bust;463;11;474
44;Grand Est;67;4;02;068;Buswiller;274;2;276
44;Grand Est;67;4;08;072;Butten;669;21;690
44;Grand Est;67;3;10;052;Bœrsch;2437;66;2503
44;Grand Est;67;5;16;053;Bœsenbiesen;321;11;332
44;Grand Est;67;5;16;073;Châtenois;4188;87;4275
44;Grand Est;67;2;23;074;Cleebourg;720;7;727
44;Grand Est;67;2;23;075;Climbach;440;6;446
44;Grand Est;67;3;11;076;Colroy-la-Roche;488;9;497
44;Grand Est;67;3;14;077;Cosswiller;574;13;587
44;Grand Est;67;3;14;078;Crastatt;270;1;271
44;Grand Est;67;2;23;079;Crœttwiller;176;3;179
44;Grand Est;67;3;10;080;Dachstein;1802;21;1823
44;Grand Est;67;3;10;081;Dahlenheim;765;12;777
44;Grand Est;67;2;01;082;Dalhunden;1171;8;1179
44;Grand Est;67;2;13;083;Dambach;736;13;749
44;Grand Est;67;5;12;084;Dambach-la-Ville;2201;41;2242
44;Grand Est;67;3;10;085;Dangolsheim;723;11;734
44;Grand Est;67;5;04;086;Daubensand;401;8;409
44;Grand Est;67;2;05;087;Dauendorf;1440;15;1455
44;Grand Est;67;4;08;088;Dehlingen;360;7;367
44;Grand Est;67;4;14;089;Dettwiller;2612;26;2638
44;Grand Est;67;5;04;090;Diebolsheim;694;44;738
44;Grand Est;67;4;08;091;Diedendorf;330;12;342
44;Grand Est;67;5;11;092;Dieffenbach-au-Val;627;14;641
44;Grand Est;67;2;13;093;Dieffenbach-lès-Wœrth;350;5;355
44;Grand Est;67;5;16;094;Dieffenthal;256;2;258
44;Grand Est;67;4;08;095;Diemeringen;1600;37;1637
44;Grand Est;67;4;14;096;Dimbsthal;311;13;324
44;Grand Est;67;4;02;097;Dingsheim;1275;19;1294
44;Grand Est;67;3;11;098;Dinsheim-sur-Bruche;1476;19;1495
44;Grand Est;67;4;08;099;Domfessel;286;4;290
44;Grand Est;67;2;03;100;Donnenheim;349;1;350
44;Grand Est;67;3;10;101;Dorlisheim;2647;31;2678
44;Grand Est;67;4;02;102;Dossenheim-Kochersberg;294;5;299
44;Grand Est;67;4;08;103;Dossenheim-sur-Zinsel;1058;26;1084
44;Grand Est;67;2;23;104;Drachenbronn-Birlenbach;762;17;779
44;Grand Est;67;4;08;105;Drulingen;1460;27;1487
44;Grand Est;67;2;01;106;Drusenheim;5154;42;5196
44;Grand Est;67;4;02;107;Duntzenheim;643;5;648
44;Grand Est;67;3;10;108;Duppigheim;1597;18;1615
44;Grand Est;67;4;02;109;Durningen;651;17;668
44;Grand Est;67;2;13;110;Durrenbach;1079;18;1097
44;Grand Est;67;4;08;111;Durstel;412;11;423
44;Grand Est;67;3;10;112;Duttlenheim;2890;29;2919
44;Grand Est;67;2;23;113;Eberbach-Seltz;422;7;429
44;Grand Est;67;5;16;115;Ebersheim;2239;24;2263
44;Grand Est;67;5;16;116;Ebersmunster;521;25;546
44;Grand Est;67;4;14;117;Eckartswiller;431;12;443
44;Grand Est;67;8;06;118;Eckbolsheim;6857;61;6918
44;Grand Est;67;8;03;119;Eckwersheim;1328;18;1346
44;Grand Est;67;5;12;120;Eichhoffen;527;12;539
44;Grand Est;67;5;16;121;Elsenheim;813;10;823
44;Grand Est;67;2;13;123;Engwiller;501;1;502
44;Grand Est;67;8;09;124;Entzheim;2390;13;2403
44;Grand Est;67;5;12;125;Epfig;2267;75;2342
44;Grand Est;67;4;08;126;Erckartswiller;299;2;301
44;Grand Est;67;3;10;127;Ergersheim;1358;13;1371
44;Grand Est;67;3;10;128;Ernolsheim-Bruche;1875;18;1893
44;Grand Est;67;4;14;129;Ernolsheim-lès-Saverne;594;9;603
44;Grand Est;67;5;04;130;Erstein;10630;124;10754
44;Grand Est;67;8;07;131;Eschau;5303;51;5354
44;Grand Est;67;2;13;132;Eschbach;931;11;942
44;Grand Est;67;4;08;133;Eschbourg;484;7;491
44;Grand Est;67;4;08;134;Eschwiller;183;0;183
44;Grand Est;67;4;02;135;Ettendorf;771;5;776
44;Grand Est;67;4;08;136;Eywiller;280;5;285
44;Grand Est;67;8;09;137;Fegersheim;5737;65;5802
44;Grand Est;67;4;02;138;Fessenheim-le-Bas;561;8;569
44;Grand Est;67;3;10;139;Flexbourg;457;10;467
44;Grand Est;67;2;01;140;Forstfeld;737;4;741
44;Grand Est;67;2;13;141;Forstheim;584;5;589
44;Grand Est;67;2;01;142;Fort-Louis;296;1;297
44;Grand Est;67;5;11;143;Fouchy;656;18;674
44;Grand Est;67;3;11;144;Fouday;341;2;343
44;Grand Est;67;4;14;145;Friedolsheim;235;1;236
44;Grand Est;67;5;04;146;Friesenheim;627;4;631
44;Grand Est;67;4;08;148;Frohmuhl;181;4;185
44;Grand Est;67;2;13;147;Frœschwiller;503;4;507
44;Grand Est;67;4;14;149;Furchhausen;415;8;423
44;Grand Est;67;4;02;150;Furdenheim;1315;22;1337
44;Grand Est;67;2;03;151;Gambsheim;4883;40;4923
44;Grand Est;67;8;09;152;Geispolsheim;7540;76;7616
44;Grand Est;67;4;02;153;Geiswiller-Zœbersdorf;408;6;414
44;Grand Est;67;5;04;154;Gerstheim;3448;24;3472
44;Grand Est;67;5;12;155;Gertwiller;1250;21;1271
44;Grand Est;67;2;03;156;Geudertheim;2530;29;2559
44;Grand Est;67;4;14;161;Gottenhouse;384;11;395
44;Grand Est;67;4;14;162;Gottesheim;346;8;354
44;Grand Est;67;4;02;163;Gougenheim;548;13;561
44;Grand Est;67;5;12;164;Goxwiller;845;20;865
44;Grand Est;67;3;11;165;Grandfontaine;396;7;403
44;Grand Est;67;4;02;166;Grassendorf;250;4;254
44;Grand Est;67;3;10;167;Grendelbruch;1201;13;1214
44;Grand Est;67;3;11;168;Gresswiller;1696;18;1714
44;Grand Est;67;2;03;169;Gries;2864;42;2906
44;Grand Est;67;3;10;172;Griesheim-près-Molsheim;2188;39;2227
44;Grand Est;67;4;02;173;Griesheim-sur-Souffel;1125;18;1143
44;Grand Est;67;2;13;174;Gumbrechtshoffen;1175;7;1182
44;Grand Est;67;2;13;176;Gundershoffen;3679;56;3735
44;Grand Est;67;4;08;178;Gungwiller;279;5;284
44;Grand Est;67;2;13;177;Gunstett;655;12;667
44;Grand Est;67;4;08;159;Gœrlingen;227;6;233
44;Grand Est;67;2;13;160;Gœrsdorf;1072;25;1097
44;Grand Est;67;4;14;179;Haegen;677;9;686
44;Grand Est;67;2;05;180;Haguenau;34504;546;35050
44;Grand Est;67;4;02;181;Handschuheim;268;8;276
44;Grand Est;67;8;09;182;Hangenbieten;1554;23;1577
44;Grand Est;67;4;08;183;Harskirchen;860;20;880
44;Grand Est;67;2;23;184;Hatten;1928;30;1958
44;Grand Est;67;4;14;185;Hattmatt;691;4;695
44;Grand Est;67;2;13;186;Hegeney;424;7;431
44;Grand Est;67;5;16;187;Heidolsheim;523;8;531
44;Grand Est;67;3;11;188;Heiligenberg;676;10;686
44;Grand Est;67;5;12;189;Heiligenstein;965;20;985
44;Grand Est;67;4;14;190;Hengwiller;190;1;191
44;Grand Est;67;4;08;191;Herbitzheim;1839;47;1886
44;Grand Est;67;5;04;192;Herbsheim;925;10;935
44;Grand Est;67;2;01;194;Herrlisheim;4861;51;4912
44;Grand Est;67;5;16;195;Hessenheim;620;10;630
44;Grand Est;67;5;16;196;Hilsenheim;2633;28;2661
44;Grand Est;67;5;04;197;Hindisheim;1502;21;1523
44;Grand Est;67;4;08;198;Hinsbourg;112;3;115
44;Grand Est;67;4;08;199;Hinsingen;87;1;88
44;Grand Est;67;5;04;200;Hipsheim;1010;8;1018
44;Grand Est;67;4;08;201;Hirschland;324;7;331
44;Grand Est;67;4;02;202;Hochfelden;3987;38;4025
44;Grand Est;67;2;05;203;Hochstett;373;5;378
44;Grand Est;67;2;23;206;Hoffen;1125;18;1143
44;Grand Est;67;3;14;208;Hohengœft;536;8;544
44;Grand Est;67;4;02;209;Hohfrankenheim;265;2;267
44;Grand Est;67;5;12;210;Le Hohwald;505;13;518
44;Grand Est;67;8;09;212;Holtzheim;3656;28;3684
44;Grand Est;67;2;23;213;Hunspach;637;16;653
44;Grand Est;67;4;02;214;Hurtigheim;834;7;841
44;Grand Est;67;2;05;215;Huttendorf;505;3;508
44;Grand Est;67;5;04;216;Huttenheim;2701;35;2736
44;Grand Est;67;8;06;204;Hœnheim;11215;80;11295
44;Grand Est;67;2;03;205;Hœrdt;4370;58;4428
44;Grand Est;67;5;04;217;Ichtratzheim;327;4;331
44;Grand Est;67;8;07;218;Illkirch-Graffenstaden;26780;666;27446
44;Grand Est;67;4;02;220;Ingenheim;333;2;335
44;Grand Est;67;2;23;221;Ingolsheim;319;5;324
44;Grand Est;67;4;08;222;Ingwiller;4064;37;4101
44;Grand Est;67;5;10;223;Innenheim;1188;6;1194
44;Grand Est;67;4;02;225;Issenhausen;111;2;113
44;Grand Est;67;4;02;226;Ittenheim;2111;24;2135
44;Grand Est;67;5;12;227;Itterswiller;242;4;246
44;Grand Est;67;3;14;229;Jetterswiller;193;2;195
44;Grand Est;67;2;01;230;Kaltenhouse;2333;18;2351
44;Grand Est;67;2;01;231;Kauffenheim;215;2;217
44;Grand Est;67;2;23;232;Keffenach;193;7;200
44;Grand Est;67;5;04;233;Kertzfeld;1221;20;1241
44;Grand Est;67;4;08;234;Keskastel;1520;26;1546
44;Grand Est;67;2;23;235;Kesseldorf;404;7;411
44;Grand Est;67;4;02;236;Kienheim;553;9;562
44;Grand Est;67;2;03;237;Kilstett;2510;32;2542
44;Grand Est;67;2;13;238;Kindwiller;637;7;644
44;Grand Est;67;5;16;239;Kintzheim;1639;31;1670
44;Grand Est;67;3;10;240;Kirchheim;706;3;709
44;Grand Est;67;4;08;241;Kirrberg;157;4;161
44;Grand Est;67;4;02;242;Kirrwiller;540;5;545
44;Grand Est;67;4;14;244;Kleingœft;156;3;159
44;Grand Est;67;3;14;245;Knœrsheim;222;2;224
44;Grand Est;67;5;04;246;Kogenheim;1265;16;1281
44;Grand Est;67;8;09;247;Kolbsheim;948;19;967
44;Grand Est;67;5;12;248;Krautergersheim;1680;26;1706
44;Grand Est;67;2;03;249;Krautwiller;255;6;261
44;Grand Est;67;2;03;250;Kriegsheim;781;17;798
44;Grand Est;67;2;03;252;Kurtzenhouse;1053;12;1065
44;Grand Est;67;4;02;253;Kuttolsheim;622;11;633
44;Grand Est;67;2;13;254;Kutzenhausen;915;16;931
44;Grand Est;67;5;11;255;Lalaye;471;8;479
44;Grand Est;67;8;06;256;Lampertheim;3272;61;3333
44;Grand Est;67;2;13;257;Lampertsloch;722;14;736
44;Grand Est;67;4;14;258;Landersheim;199;3;202
44;Grand Est;67;2;13;259;Langensoultzbach;936;13;949
44;Grand Est;67;2;13;260;Laubach;320;5;325
44;Grand Est;67;2;23;261;Lauterbourg;2304;26;2330
44;Grand Est;67;2;13;263;Lembach;1540;45;1585
44;Grand Est;67;2;01;264;Leutenheim;837;12;849
44;Grand Est;67;4;08;265;Lichtenberg;557;6;563
44;Grand Est;67;5;04;266;Limersheim;654;8;662
44;Grand Est;67;8;09;267;Lingolsheim;18324;172;18496
44;Grand Est;67;8;09;268;Lipsheim;2600;30;2630
44;Grand Est;67;4;14;269;Littenheim;286;4;290
44;Grand Est;67;4;02;270;Lixhausen;380;1;381
44;Grand Est;67;2;13;271;Lobsann;640;6;646
44;Grand Est;67;4;14;272;Lochwiller;417;7;424
44;Grand Est;67;4;08;273;Lohr;498;6;504
44;Grand Est;67;4;08;274;Lorentzen;241;2;243
44;Grand Est;67;4;14;275;Lupstein;794;20;814
44;Grand Est;67;3;11;276;Lutzelhouse;1899;28;1927
44;Grand Est;67;5;16;277;Mackenheim;765;4;769
44;Grand Est;67;4;08;278;Mackwiller;575;13;588
44;Grand Est;67;4;14;279;Maennolsheim;231;2;233
44;Grand Est;67;5;11;280;Maisonsgoutte;804;18;822
44;Grand Est;67;5;16;281;Marckolsheim;4151;64;4215
44;Grand Est;67;3;10;282;Marlenheim;4250;65;4315
44;Grand Est;67;4;14;283;Marmoutier;2726;46;2772
44;Grand Est;67;5;04;285;Matzenheim;1429;107;1536
44;Grand Est;67;5;12;286;Meistratzheim;1485;17;1502
44;Grand Est;67;4;02;287;Melsheim;591;6;597
44;Grand Est;67;2;23;288;Memmelshoffen;332;5;337
44;Grand Est;67;4;08;289;Menchhoffen;613;10;623
44;Grand Est;67;2;13;290;Merkwiller-Pechelbronn;915;14;929
44;Grand Est;67;2;13;291;Mertzwiller;3355;40;3395
44;Grand Est;67;2;13;292;Mietesheim;670;12;682
44;Grand Est;67;4;02;293;Minversheim;661;11;672
44;Grand Est;67;5;12;295;Mittelbergheim;650;18;668
44;Grand Est;67;8;06;296;Mittelhausbergen;1984;23;2007
44;Grand Est;67;2;03;298;Mittelschaeffolsheim;576;8;584
44;Grand Est;67;3;10;299;Mollkirch;923;26;949
44;Grand Est;67;3;10;300;Molsheim;9312;214;9526
44;Grand Est;67;2;03;301;Mommenheim;1897;20;1917
44;Grand Est;67;4;14;302;Monswiller;2077;39;2116
44;Grand Est;67;2;13;303;Morsbronn-les-Bains;695;6;701
44;Grand Est;67;2;05;304;Morschwiller;587;12;599
44;Grand Est;67;2;23;305;Mothern;2006;22;2028
44;Grand Est;67;3;11;306;Muhlbach-sur-Bruche;641;54;695
44;Grand Est;67;4;08;307;Mulhausen;488;4;492
44;Grand Est;67;2;23;308;Munchhausen;763;9;772
44;Grand Est;67;8;06;309;Mundolsheim;4731;61;4792
44;Grand Est;67;5;16;310;Mussig;1138;33;1171
44;Grand Est;67;5;16;311;Muttersholtz;2013;38;2051
44;Grand Est;67;4;02;312;Mutzenhouse;456;8;464
44;Grand Est;67;3;11;313;Mutzig;6011;50;6061
44;Grand Est;67;3;11;314;Natzwiller;542;8;550
44;Grand Est;67;2;23;315;Neewiller-près-Lauterbourg;656;14;670
44;Grand Est;67;5;11;317;Neubois;698;14;712
44;Grand Est;67;4;02;228;Neugartheim-Ittlenheim;799;17;816
44;Grand Est;67;2;01;319;Neuhaeusel;351;4;355
44;Grand Est;67;5;11;320;Neuve-Église;629;10;639
44;Grand Est;67;3;11;321;Neuviller-la-Roche;341;8;349
44;Grand Est;67;4;08;322;Neuwiller-lès-Saverne;1113;13;1126
44;Grand Est;67;2;13;324;Niederbronn-les-Bains;4404;84;4488
44;Grand Est;67;3;11;325;Niederhaslach;1405;14;1419
44;Grand Est;67;8;06;326;Niederhausbergen;1590;12;1602
44;Grand Est;67;2;23;327;Niederlauterbach;965;21;986
44;Grand Est;67;2;13;328;Niedermodern;913;7;920
44;Grand Est;67;5;12;329;Niedernai;1270;22;1292
44;Grand Est;67;2;23;330;Niederrœdern;931;9;940
44;Grand Est;67;2;05;331;Niederschaeffolsheim;1374;12;1386
44;Grand Est;67;4;08;333;Niedersoultzbach;276;5;281
44;Grand Est;67;2;13;334;Niedersteinbach;122;1;123
44;Grand Est;67;3;10;335;Nordheim;887;15;902
44;Grand Est;67;5;04;336;Nordhouse;1734;30;1764
44;Grand Est;67;5;12;337;Nothalten;456;16;472
44;Grand Est;67;5;04;338;Obenheim;1359;22;1381
44;Grand Est;67;2;13;340;Oberbronn;1570;26;1596
44;Grand Est;67;2;13;341;Oberdorf-Spachbach;363;8;371
44;Grand Est;67;3;11;342;Oberhaslach;1780;28;1808
44;Grand Est;67;8;06;343;Oberhausbergen;5381;54;5435
44;Grand Est;67;2;23;344;Oberhoffen-lès-Wissembourg;324;5;329
44;Grand Est;67;2;01;345;Oberhoffen-sur-Moder;3486;28;3514
44;Grand Est;67;2;23;346;Oberlauterbach;540;11;551
44;Grand Est;67;4;02;347;Obermodern-Zutzendorf;1681;21;1702
44;Grand Est;67;5;12;348;Obernai;11279;459;11738
44;Grand Est;67;2;23;349;Oberrœdern;525;10;535
44;Grand Est;67;8;09;350;Oberschaeffolsheim;2301;24;2325
44;Grand Est;67;4;02;352;Obersoultzbach;433;2;435
44;Grand Est;67;2;13;353;Obersteinbach;227;2;229
44;Grand Est;67;3;10;354;Odratzheim;499;11;510
44;Grand Est;67;4;08;355;Oermingen;1250;15;1265
44;Grand Est;67;2;01;356;Offendorf;2476;20;2496
44;Grand Est;67;2;13;358;Offwiller;796;17;813
44;Grand Est;67;2;05;359;Ohlungen;1308;20;1328
44;Grand Est;67;5;16;360;Ohnenheim;1032;13;1045
44;Grand Est;67;2;03;361;Olwisheim;498;6;504
44;Grand Est;67;5;16;362;Orschwiller;603;5;608
44;Grand Est;67;8;09;363;Osthoffen;825;17;842
44;Grand Est;67;5;04;364;Osthouse;924;17;941
44;Grand Est;67;8;07;365;Ostwald;12604;120;12724
44;Grand Est;67;4;14;366;Ottersthal;713;18;731
44;Grand Est;67;4;14;367;Otterswiller;1339;33;1372
44;Grand Est;67;3;10;368;Ottrott;1546;31;1577
44;Grand Est;67;4;08;369;Ottwiller;260;5;265
44;Grand Est;67;4;08;370;Petersbach;647;12;659
44;Grand Est;67;4;08;371;La Petite-Pierre;618;4;622
44;Grand Est;67;4;08;373;Pfalzweyer;321;4;325
44;Grand Est;67;4;02;375;Pfulgriesheim;1311;17;1328
44;Grand Est;67;3;11;377;Plaine;993;11;1004
44;Grand Est;67;8;07;378;Plobsheim;4443;39;4482
44;Grand Est;67;2;13;379;Preuschdorf;891;5;896
44;Grand Est;67;4;14;380;Printzheim;202;4;206
44;Grand Est;67;4;08;381;Puberg;353;5;358
44;Grand Est;67;4;02;382;Quatzenheim;781;18;799
44;Grand Est;67;3;14;383;Rangen;198;6;204
44;Grand Est;67;3;11;384;Ranrupt;329;4;333
44;Grand Est;67;4;08;385;Ratzwiller;254;3;257
44;Grand Est;67;4;08;386;Rauwiller;209;2;211
44;Grand Est;67;5;12;387;Reichsfeld;296;9;305
44;Grand Est;67;2;13;388;Reichshoffen;5396;84;5480
44;Grand Est;67;8;06;389;Reichstett;4418;40;4458
44;Grand Est;67;4;14;391;Reinhardsmunster;448;7;455
44;Grand Est;67;4;08;392;Reipertswiller;858;6;864
44;Grand Est;67;2;23;394;Retschwiller;285;6;291
44;Grand Est;67;4;14;395;Reutenbourg;419;11;430
44;Grand Est;67;4;08;396;Rexingen;203;1;204
44;Grand Est;67;5;04;397;Rhinau;2698;30;2728
44;Grand Est;67;5;16;398;Richtolsheim;343;2;345
44;Grand Est;67;2;23;400;Riedseltz;1087;33;1120
44;Grand Est;67;4;08;401;Rimsdorf;308;9;317
44;Grand Est;67;4;02;403;Ringendorf;437;10;447
44;Grand Est;67;2;23;404;Rittershoffen;911;14;925
44;Grand Est;67;4;02;406;Rohr;311;3;314
44;Grand Est;67;2;01;407;Rohrwiller;1634;11;1645
44;Grand Est;67;3;14;408;Romanswiller;1239;17;1256
44;Grand Est;67;2;01;409;Roppenheim;1003;15;1018
44;Grand Est;67;3;10;410;Rosenwiller;686;15;701
44;Grand Est;67;3;10;411;Rosheim;5149;109;5258
44;Grand Est;67;5;04;412;Rossfeld;1002;10;1012
44;Grand Est;67;4;08;413;Rosteig;537;10;547
44;Grand Est;67;3;11;414;Rothau;1591;18;1609
44;Grand Est;67;2;13;415;Rothbach;468;6;474
44;Grand Est;67;2;23;416;Rott;472;10;482
44;Grand Est;67;2;03;417;Rottelsheim;307;10;317
44;Grand Est;67;2;01;418;Rountzenheim-Auenheim;1937;29;1966
44;Grand Est;67;3;11;420;Russ;1254;16;1270
44;Grand Est;67;2;01;405;Rœschwoog;2285;47;2332
44;Grand Est;67;3;11;421;Saales;837;12;849
44;Grand Est;67;5;16;422;Saasenheim;600;10;610
44;Grand Est;67;4;14;423;Saessolsheim;570;8;578
44;Grand Est;67;3;11;424;Saint-Blaise-la-Roche;228;0;228
44;Grand Est;67;4;14;425;Saint-Jean-Saverne;560;13;573
44;Grand Est;67;5;11;426;Saint-Martin;352;1;353
44;Grand Est;67;5;11;427;Saint-Maurice;367;15;382
44;Grand Est;67;3;10;428;Saint-Nabor;485;13;498
44;Grand Est;67;5;12;429;Saint-Pierre;648;9;657
44;Grand Est;67;5;11;430;Saint-Pierre-Bois;771;26;797
44;Grand Est;67;2;23;432;Salmbach;578;12;590
44;Grand Est;67;5;04;433;Sand;1283;10;1293
44;Grand Est;67;4;08;434;Sarre-Union;2823;44;2867
44;Grand Est;67;4;08;435;Sarrewerden;848;19;867
44;Grand Est;67;3;11;436;Saulxures;512;12;524
44;Grand Est;67;4;14;437;Saverne;11239;309;11548
44;Grand Est;67;5;04;438;Schaeffersheim;835;13;848
44;Grand Est;67;2;23;440;Schaffhouse-près-Seltz;558;12;570
44;Grand Est;67;4;02;441;Schalkendorf;330;5;335
44;Grand Est;67;3;10;442;Scharrachbergheim-Irmstett;1215;60;1275
44;Grand Est;67;2;23;443;Scheibenhard;822;19;841
44;Grand Est;67;4;02;444;Scherlenheim;126;0;126
44;Grand Est;67;5;16;445;Scherwiller;3195;53;3248
44;Grand Est;67;4;08;446;Schillersdorf;430;11;441
44;Grand Est;67;8;15;447;Schiltigheim;31894;176;32070
44;Grand Est;67;3;11;448;Schirmeck;2183;49;2232
44;Grand Est;67;2;01;449;Schirrhein;2227;18;2245
44;Grand Est;67;2;01;450;Schirrhoffen;694;17;711
44;Grand Est;67;2;23;451;Schleithal;1428;32;1460
44;Grand Est;67;4;02;452;Schnersheim;1613;31;1644
44;Grand Est;67;4;08;456;Schopperten;445;10;455
44;Grand Est;67;2;05;458;Schweighouse-sur-Moder;4939;60;4999
44;Grand Est;67;4;14;459;Schwenheim;760;17;777
44;Grand Est;67;4;02;460;Schwindratzheim;1675;20;1695
44;Grand Est;67;5;16;461;Schwobsheim;323;7;330
44;Grand Est;67;5;16;453;Schœnau;602;8;610
44;Grand Est;67;4;08;454;Schœnbourg;428;8;436
44;Grand Est;67;2;23;455;Schœnenbourg;688;11;699
44;Grand Est;67;2;23;351;Seebach;1672;39;1711
44;Grand Est;67;5;16;462;Sélestat;19252;288;19540
44;Grand Est;67;2;23;463;Seltz;3235;35;3270
44;Grand Est;67;5;04;464;Sermersheim;930;13;943
44;Grand Est;67;2;01;465;Sessenheim;2315;33;2348
44;Grand Est;67;2;23;466;Siegen;508;9;517
44;Grand Est;67;4;08;467;Siewiller;386;5;391
44;Grand Est;67;4;08;468;Siltzheim;636;16;652
44;Grand Est;67;3;11;470;Solbach;104;1;105
44;Grand Est;67;4;14;004;Sommerau;1524;28;1552
44;Grand Est;67;8;06;471;Souffelweyersheim;8001;62;8063
44;Grand Est;67;2;01;472;Soufflenheim;4889;64;4953
44;Grand Est;67;3;10;473;Soultz-les-Bains;947;18;965
44;Grand Est;67;2;23;474;Soultz-sous-Forêts;3177;35;3212
44;Grand Est;67;4;08;475;Sparsbach;240;3;243
44;Grand Est;67;2;01;476;Stattmatten;707;7;714
44;Grand Est;67;5;11;477;Steige;609;17;626
44;Grand Est;67;4;14;478;Steinbourg;1991;30;2021
44;Grand Est;67;2;23;479;Steinseltz;596;22;618
44;Grand Est;67;3;11;480;Still;1809;27;1836
44;Grand Est;67;5;12;481;Stotzheim;1064;16;1080
44;Grand Est;67;8;99;482;Strasbourg;280966;2779;283745
44;Grand Est;67;4;08;483;Struth;252;2;254
44;Grand Est;67;2;23;484;Stundwiller;491;9;500
44;Grand Est;67;4;02;485;Stutzheim-Offenheim;1455;26;1481
44;Grand Est;67;5;16;486;Sundhouse;1823;23;1846
44;Grand Est;67;2;23;487;Surbourg;1699;23;1722
44;Grand Est;67;4;08;488;Thal-Drulingen;184;4;188
44;Grand Est;67;4;14;489;Thal-Marmoutier;777;23;800
44;Grand Est;67;5;11;490;Thanvillé;594;19;613
44;Grand Est;67;4;08;491;Tieffenbach;261;0;261
44;Grand Est;67;3;14;492;Traenheim;648;15;663
44;Grand Est;67;5;11;493;Triembach-au-Val;463;11;474
44;Grand Est;67;2;23;494;Trimbach;574;11;585
44;Grand Est;67;4;02;495;Truchtersheim;4029;81;4110
44;Grand Est;67;2;05;497;Uhlwiller;688;15;703
44;Grand Est;67;2;13;498;Uhrwiller;706;5;711
44;Grand Est;67;5;11;499;Urbeis;322;14;336
44;Grand Est;67;3;11;500;Urmatt;1478;35;1513
44;Grand Est;67;5;04;501;Uttenheim;552;4;556
44;Grand Est;67;2;13;502;Uttenhoffen;204;2;206
44;Grand Est;67;4;02;503;Uttwiller;161;2;163
44;Grand Est;67;2;89;372;Val-de-Moder;5096;65;5161
44;Grand Est;67;5;12;504;Valff;1318;13;1331
44;Grand Est;67;5;16;505;La Vancelle;402;22;424
44;Grand Est;67;8;03;506;Vendenheim;5664;65;5729
44;Grand Est;67;5;11;507;Villé;1834;33;1867
44;Grand Est;67;4;08;509;Volksberg;354;8;362
44;Grand Est;67;4;08;508;Vœllerdingen;398;18;416
44;Grand Est;67;2;05;510;Wahlenheim;478;2;480
44;Grand Est;67;2;13;511;Walbourg;917;274;1191
44;Grand Est;67;3;11;513;Waldersbach;131;1;132
44;Grand Est;67;4;08;514;Waldhambach;626;10;636
44;Grand Est;67;4;14;515;Waldolwisheim;574;9;583
44;Grand Est;67;4;02;516;Waltenheim-sur-Zorn;664;7;671
44;Grand Est;67;3;10;517;Wangen;698;11;709
44;Grand Est;67;3;14;122;Wangenbourg-Engenthal;1354;17;1371
44;Grand Est;67;8;03;519;La Wantzenau;5841;107;5948
44;Grand Est;67;3;14;520;Wasselonne;5652;63;5715
44;Grand Est;67;4;08;521;Weinbourg;432;6;438
44;Grand Est;67;4;08;522;Weislingen;535;8;543
44;Grand Est;67;2;03;523;Weitbruch;2832;38;2870
44;Grand Est;67;4;08;524;Weiterswiller;521;13;534
44;Grand Est;67;3;14;525;Westhoffen;1651;26;1677
44;Grand Est;67;5;04;526;Westhouse;1515;26;1541
44;Grand Est;67;4;14;527;Westhouse-Marmoutier;306;3;309
44;Grand Est;67;4;08;528;Weyer;576;11;587
44;Grand Est;67;2;03;529;Weyersheim;3356;36;3392
44;Grand Est;67;4;02;530;Wickersheim-Wilshausen;392;6;398
44;Grand Est;67;3;11;531;Wildersbach;291;6;297
44;Grand Est;67;4;02;532;Willgottheim;1085;18;1103
44;Grand Est;67;4;02;534;Wilwisheim;725;6;731
44;Grand Est;67;4;08;535;Wimmenau;1081;21;1102
44;Grand Est;67;2;13;536;Windstein;164;1;165
44;Grand Est;67;2;13;537;Wingen;453;6;459
44;Grand Est;67;4;08;538;Wingen-sur-Moder;1626;23;1649
44;Grand Est;67;4;02;539;Wingersheim les Quatre Bans;2292;44;2336
44;Grand Est;67;2;05;540;Wintershouse;894;12;906
44;Grand Est;67;2;23;541;Wintzenbach;544;2;546
44;Grand Est;67;4;02;542;Wintzenheim-Kochersberg;425;3;428
44;Grand Est;67;3;11;543;Wisches;2105;29;2134
44;Grand Est;67;2;23;544;Wissembourg;7537;213;7750
44;Grand Est;67;5;04;545;Witternheim;507;5;512
44;Grand Est;67;2;05;546;Wittersheim;661;5;666
44;Grand Est;67;5;16;547;Wittisheim;2054;24;2078
44;Grand Est;67;4;02;548;Wiwersheim;880;13;893
44;Grand Est;67;8;06;551;Wolfisheim;4157;56;4213
44;Grand Est;67;4;08;552;Wolfskirchen;344;10;354
44;Grand Est;67;4;14;553;Wolschheim;320;5;325
44;Grand Est;67;3;10;554;Wolxheim;963;13;976
44;Grand Est;67;2;13;550;Wœrth;1745;24;1769
44;Grand Est;67;3;14;555;Zehnacker;246;3;249
44;Grand Est;67;3;14;556;Zeinheim;201;3;204
44;Grand Est;67;5;12;557;Zellwiller;794;13;807
44;Grand Est;67;2;13;558;Zinswiller;769;11;780
44;Grand Est;67;4;08;559;Zittersheim;250;2;252
44;Grand Est;68;2;06;001;Algolsheim;1141;13;1154
44;Grand Est;68;1;09;002;Altenach;393;4;397
44;Grand Est;68;1;01;004;Altkirch;5737;133;5870
44;Grand Est;68;2;15;005;Ammerschwihr;1779;47;1826
44;Grand Est;68;2;05;007;Andolsheim;2162;64;2226
44;Grand Est;68;2;06;008;Appenwihr;579;11;590
44;Grand Est;68;2;06;009;Artzenheim;846;11;857
44;Grand Est;68;1;01;010;Aspach;1128;20;1148
44;Grand Est;68;6;03;011;Aspach-le-Bas;1321;28;1349
44;Grand Est;68;6;03;012;Aspach-Michelbach;1788;42;1830
44;Grand Est;68;4;14;013;Attenschwiller;973;23;996
44;Grand Est;68;2;15;014;Aubure;360;9;369
44;Grand Est;68;4;13;015;Baldersheim;2616;47;2663
44;Grand Est;68;2;06;016;Balgau;969;18;987
44;Grand Est;68;1;09;017;Ballersdorf;824;14;838
44;Grand Est;68;1;09;018;Balschwiller;757;17;774
44;Grand Est;68;2;06;019;Baltzenheim;574;5;579
44;Grand Est;68;4;13;020;Bantzenheim;1608;34;1642
44;Grand Est;68;4;02;021;Bartenheim;3837;52;3889
44;Grand Est;68;4;13;022;Battenheim;1587;14;1601
44;Grand Est;68;2;15;023;Beblenheim;941;24;965
44;Grand Est;68;1;09;024;Bellemagny;190;4;194
44;Grand Est;68;1;01;025;Bendorf;216;3;219
44;Grand Est;68;2;15;026;Bennwihr;1335;26;1361
44;Grand Est;68;1;01;027;Berentzwiller;324;9;333
44;Grand Est;68;2;15;028;Bergheim;2121;49;2170
44;Grand Est;68;6;07;029;Bergholtz;1078;33;1111
44;Grand Est;68;6;07;030;Bergholtzzell;433;15;448
44;Grand Est;68;1;09;006;Bernwiller;1180;24;1204
44;Grand Est;68;4;17;032;Berrwiller;1192;37;1229
44;Grand Est;68;1;01;033;Bettendorf;450;8;458
44;Grand Est;68;1;01;034;Bettlach;311;16;327
44;Grand Est;68;1;01;035;Biederthal;317;13;330
44;Grand Est;68;2;06;036;Biesheim;2571;32;2603
44;Grand Est;68;6;06;037;Biltzheim;444;11;455
44;Grand Est;68;2;05;038;Bischwihr;1039;24;1063
44;Grand Est;68;1;01;039;Bisel;544;16;560
44;Grand Est;68;6;03;040;Bitschwiller-lès-Thann;1960;23;1983
44;Grand Est;68;2;06;041;Blodelsheim;1957;27;1984
44;Grand Est;68;4;14;042;Blotzheim;4526;114;4640
44;Grand Est;68;4;17;043;Bollwiller;4027;55;4082
44;Grand Est;68;2;15;044;Le Bonhomme;752;29;781
44;Grand Est;68;6;03;045;Bourbach-le-Bas;560;19;579
44;Grand Est;68;6;03;046;Bourbach-le-Haut;420;10;430
44;Grand Est;68;1;01;049;Bouxwiller;459;9;468
44;Grand Est;68;1;09;050;Bréchaumont;412;11;423
44;Grand Est;68;2;16;051;Breitenbach-Haut-Rhin;828;16;844
44;Grand Est;68;1;09;052;Bretten;181;3;184
44;Grand Est;68;4;02;054;Brinckheim;405;8;413
44;Grand Est;68;4;02;055;Bruebach;1061;24;1085
44;Grand Est;68;4;02;056;Brunstatt-Didenheim;8012;208;8220
44;Grand Est;68;1;09;057;Buethwiller;277;4;281
44;Grand Est;68;6;07;058;Buhl;3310;41;3351
44;Grand Est;68;6;09;059;Burnhaupt-le-Bas;1878;40;1918
44;Grand Est;68;6;09;060;Burnhaupt-le-Haut;1802;45;1847
44;Grand Est;68;4;14;061;Buschwiller;1040;17;1057
44;Grand Est;68;1;01;062;Carspach;2044;103;2147
44;Grand Est;68;6;03;063;Cernay;11565;224;11789
44;Grand Est;68;4;13;064;Chalampé;950;19;969
44;Grand Est;68;1;09;065;Chavannes-sur-l'Étang;693;9;702
44;Grand Est;68;2;98;066;Colmar;69105;1053;70158
44;Grand Est;68;1;01;067;Courtavon;368;2;370
44;Grand Est;68;1;09;068;Dannemarie;2255;29;2284
44;Grand Est;68;2;06;069;Dessenheim;1420;30;1450
44;Grand Est;68;1;09;071;Diefmatten;290;6;296
44;Grand Est;68;4;02;072;Dietwiller;1447;28;1475
44;Grand Est;68;6;09;073;Dolleren;475;11;486
44;Grand Est;68;1;01;074;Durlinsdorf;566;7;573
44;Grand Est;68;1;01;075;Durmenach;841;16;857
44;Grand Est;68;2;06;076;Durrenentzen;907;10;917
44;Grand Est;68;1;09;077;Eglingen;365;9;374
44;Grand Est;68;2;16;078;Eguisheim;1726;42;1768
44;Grand Est;68;1;09;079;Elbach;259;0;259
44;Grand Est;68;1;01;080;Emlingen;287;3;290
44;Grand Est;68;6;06;082;Ensisheim;7508;70;7578
44;Grand Est;68;2;16;083;Eschbach-au-Val;362;14;376
44;Grand Est;68;4;02;084;Eschentzwiller;1473;46;1519
44;Grand Est;68;1;09;085;Eteimbes;380;5;385
44;Grand Est;68;1;09;086;Falkwiller;191;9;200
44;Grand Est;68;1;01;087;Feldbach;444;13;457
44;Grand Est;68;4;17;088;Feldkirch;990;20;1010
44;Grand Est;68;6;03;089;Fellering;1606;32;1638
44;Grand Est;68;1;01;090;Ferrette;729;14;743
44;Grand Est;68;2;06;091;Fessenheim;2353;48;2401
44;Grand Est;68;1;01;092;Fislis;418;6;424
44;Grand Est;68;4;02;093;Flaxlanden;1448;47;1495
44;Grand Est;68;4;14;094;Folgensbourg;918;14;932
44;Grand Est;68;2;05;095;Fortschwihr;1157;40;1197
44;Grand Est;68;1;01;096;Franken;349;4;353
44;Grand Est;68;2;15;097;Fréland;1343;32;1375
44;Grand Est;68;1;09;098;Friesen;644;8;652
44;Grand Est;68;1;01;099;Frœningen;739;19;758
44;Grand Est;68;1;09;100;Fulleren;342;14;356
44;Grand Est;68;4;08;101;Galfingue;805;17;822
44;Grand Est;68;6;03;102;Geishouse;441;10;451
44;Grand Est;68;4;02;103;Geispitzen;449;8;457
44;Grand Est;68;2;06;104;Geiswasser;306;5;311
44;Grand Est;68;1;09;105;Gildwiller;271;12;283
44;Grand Est;68;6;03;106;Goldbach-Altenbach;286;6;292
44;Grand Est;68;1;09;107;Gommersdorf;361;8;369
44;Grand Est;68;2;16;109;Griesbach-au-Val;714;14;728
44;Grand Est;68;2;05;110;Grussenheim;830;13;843
44;Grand Est;68;6;16;111;Gueberschwihr;837;24;861
44;Grand Est;68;6;07;112;Guebwiller;11094;320;11414
44;Grand Est;68;2;15;113;Guémar;1384;28;1412
44;Grand Est;68;1;09;114;Guevenatten;140;2;142
44;Grand Est;68;6;09;115;Guewenheim;1302;25;1327
44;Grand Est;68;6;16;116;Gundolsheim;699;29;728
44;Grand Est;68;2;16;117;Gunsbach;907;15;922
44;Grand Est;68;4;13;118;Habsheim;4894;97;4991
44;Grand Est;68;1;09;119;Hagenbach;706;16;722
44;Grand Est;68;4;14;120;Hagenthal-le-Bas;1220;29;1249
44;Grand Est;68;4;14;121;Hagenthal-le-Haut;664;18;682
44;Grand Est;68;6;07;122;Hartmannswiller;638;11;649
44;Grand Est;68;6;16;123;Hattstatt;785;25;810
44;Grand Est;68;1;01;124;Hausgauen;383;9;392
44;Grand Est;68;6;09;219;Le Haut Soultzbach;914;24;938
44;Grand Est;68;1;09;125;Hecken;497;7;504
44;Grand Est;68;4;14;126;Hégenheim;3420;73;3493
44;Grand Est;68;1;01;127;Heidwiller;624;13;637
44;Grand Est;68;1;01;128;Heimersdorf;660;15;675
44;Grand Est;68;4;08;129;Heimsbrunn;1325;49;1374
44;Grand Est;68;2;06;130;Heiteren;1040;19;1059
44;Grand Est;68;1;01;131;Heiwiller;169;1;170
44;Grand Est;68;4;02;132;Helfrantzkirch;692;17;709
44;Grand Est;68;2;16;134;Herrlisheim-près-Colmar;1818;24;1842
44;Grand Est;68;4;14;135;Hésingue;2719;54;2773
44;Grand Est;68;2;06;136;Hettenschlag;331;11;342
44;Grand Est;68;1;09;137;Hindlingen;636;10;646
44;Grand Est;68;1;01;138;Hirsingue;2121;39;2160
44;Grand Est;68;1;01;139;Hirtzbach;1442;20;1462
44;Grand Est;68;2;06;140;Hirtzfelden;1261;15;1276
44;Grand Est;68;1;01;141;Hochstatt;2143;55;2198
44;Grand Est;68;2;16;142;Hohrod;365;12;377
44;Grand Est;68;4;13;144;Hombourg;1334;26;1360
44;Grand Est;68;2;05;145;Horbourg-Wihr;5967;114;6081
44;Grand Est;68;2;05;146;Houssen;2249;22;2271
44;Grand Est;68;2;15;147;Hunawihr;602;8;610
44;Grand Est;68;1;01;148;Hundsbach;346;5;351
44;Grand Est;68;4;14;149;Huningue;7238;88;7326
44;Grand Est;68;2;16;150;Husseren-les-Châteaux;514;13;527
44;Grand Est;68;6;03;151;Husseren-Wesserling;1048;12;1060
44;Grand Est;68;1;01;152;Illfurth;2474;39;2513
44;Grand Est;68;2;15;153;Illhaeusern;702;13;715
44;Grand Est;68;1;01;240;Illtal;1420;24;1444
44;Grand Est;68;4;12;154;Illzach;14691;171;14862
44;Grand Est;68;2;04;155;Ingersheim;4678;74;4752
44;Grand Est;68;6;07;156;Issenheim;3416;46;3462
44;Grand Est;68;2;05;157;Jebsheim;1403;18;1421
44;Grand Est;68;1;01;158;Jettingen;502;15;517
44;Grand Est;68;6;07;159;Jungholtz;898;22;920
44;Grand Est;68;4;02;160;Kappelen;587;15;602
44;Grand Est;68;2;15;161;Katzenthal;528;22;550
44;Grand Est;68;2;15;162;Kaysersberg Vignoble;4523;95;4618
44;Grand Est;68;4;02;163;Kembs;5257;73;5330
44;Grand Est;68;1;01;165;Kiffis;249;3;252
44;Grand Est;68;4;08;166;Kingersheim;13055;146;13201
44;Grand Est;68;6;09;167;Kirchberg;762;21;783
44;Grand Est;68;4;14;168;Knœringue;381;11;392
44;Grand Est;68;6;03;171;Kruth;941;14;955
44;Grand Est;68;2;06;172;Kunheim;1763;29;1792
44;Grand Est;68;1;01;169;Kœstlach;506;9;515
44;Grand Est;68;4;02;170;Kœtzingue;600;24;624
44;Grand Est;68;2;15;173;Labaroche;2165;77;2242
44;Grand Est;68;4;02;174;Landser;1601;24;1625
44;Grand Est;68;2;15;175;Lapoutroie;1908;40;1948
44;Grand Est;68;1;09;176;Largitzen;314;5;319
44;Grand Est;68;6;07;177;Lautenbach;1511;37;1548
44;Grand Est;68;6;07;178;Lautenbachzell;955;15;970
44;Grand Est;68;6;09;179;Lauw;915;16;931
44;Grand Est;68;6;03;180;Leimbach;888;28;916
44;Grand Est;68;1;01;181;Levoncourt;240;3;243
44;Grand Est;68;4;14;182;Leymen;1208;27;1235
44;Grand Est;68;4;14;183;Liebenswiller;194;4;198
44;Grand Est;68;1;01;184;Liebsdorf;307;10;317
44;Grand Est;68;2;15;185;Lièpvre;1724;28;1752
44;Grand Est;68;1;01;186;Ligsdorf;311;9;320
44;Grand Est;68;1;01;187;Linsdorf;321;12;333
44;Grand Est;68;6;07;188;Linthal;599;19;618
44;Grand Est;68;2;06;189;Logelheim;818;21;839
44;Grand Est;68;1;01;190;Lucelle;34;0;34
44;Grand Est;68;1;01;191;Luemschwiller;777;15;792
44;Grand Est;68;2;16;193;Luttenbach-près-Munster;742;9;751
44;Grand Est;68;1;01;194;Lutter;279;5;284
44;Grand Est;68;4;08;195;Lutterbach;6310;94;6404
44;Grand Est;68;1;09;196;Magny;308;5;313
44;Grand Est;68;4;02;197;Magstatt-le-Bas;475;9;484
44;Grand Est;68;4;02;198;Magstatt-le-Haut;283;8;291
44;Grand Est;68;6;03;199;Malmerspach;504;2;506
44;Grand Est;68;1;09;200;Manspach;560;13;573
44;Grand Est;68;6;09;201;Masevaux-Niederbruck;3797;63;3860
44;Grand Est;68;1;09;202;Mertzen;209;5;214
44;Grand Est;68;6;07;203;Merxheim;1261;25;1286
44;Grand Est;68;2;16;204;Metzeral;1060;15;1075
44;Grand Est;68;6;06;205;Meyenheim;1480;9;1489
44;Grand Est;68;4;14;207;Michelbach-le-Bas;697;8;705
44;Grand Est;68;4;14;208;Michelbach-le-Haut;597;11;608
44;Grand Est;68;2;15;209;Mittelwihr;832;16;848
44;Grand Est;68;2;16;210;Mittlach;335;1;336
44;Grand Est;68;6;03;211;Mitzach;390;8;398
44;Grand Est;68;6;03;213;Mollau;349;7;356
44;Grand Est;68;1;09;214;Montreux-Jeune;370;9;379
44;Grand Est;68;1;09;215;Montreux-Vieux;899;8;907
44;Grand Est;68;6;03;217;Moosch;1677;23;1700
44;Grand Est;68;1;09;216;Mooslargue;417;6;423
44;Grand Est;68;4;08;218;Morschwiller-le-Bas;3766;83;3849
44;Grand Est;68;1;01;221;Muespach;899;13;912
44;Grand Est;68;1;01;222;Muespach-le-Haut;1065;20;1085
44;Grand Est;68;2;16;223;Muhlbach-sur-Munster;767;14;781
44;Grand Est;68;4;99;224;Mulhouse;109443;1169;110612
44;Grand Est;68;2;06;225;Munchhouse;1519;25;1544
44;Grand Est;68;2;16;226;Munster;4606;82;4688
44;Grand Est;68;2;05;227;Muntzenheim;1257;33;1290
44;Grand Est;68;6;06;228;Munwiller;475;16;491
44;Grand Est;68;6;07;229;Murbach;159;3;162
44;Grand Est;68;1;01;212;Mœrnach;529;11;540
44;Grand Est;68;2;06;230;Nambsheim;586;7;593
44;Grand Est;68;2;06;231;Neuf-Brisach;1931;13;1944
44;Grand Est;68;4;14;232;Neuwiller;463;14;477
44;Grand Est;68;6;06;234;Niederentzen;715;10;725
44;Grand Est;68;6;06;235;Niederhergheim;1129;15;1144
44;Grand Est;68;2;16;237;Niedermorschwihr;539;14;553
44;Grand Est;68;4;13;238;Niffer;946;25;971
44;Grand Est;68;6;09;239;Oberbruck;393;14;407
44;Grand Est;68;6;06;241;Oberentzen;637;10;647
44;Grand Est;68;6;06;242;Oberhergheim;1202;12;1214
44;Grand Est;68;1;01;243;Oberlarg;138;1;139
44;Grand Est;68;2;16;244;Obermorschwihr;359;6;365
44;Grand Est;68;1;01;245;Obermorschwiller;407;15;422
44;Grand Est;68;2;06;246;Obersaasheim;1033;13;1046
44;Grand Est;68;6;03;247;Oderen;1268;15;1283
44;Grand Est;68;1;01;248;Oltingue;686;22;708
44;Grand Est;68;2;15;249;Orbey;3552;67;3619
44;Grand Est;68;6;07;250;Orschwihr;1043;18;1061
44;Grand Est;68;6;16;251;Osenbach;890;19;909
44;Grand Est;68;2;15;252;Ostheim;1612;29;1641
44;Grand Est;68;4;13;253;Ottmarsheim;1885;30;1915
44;Grand Est;68;4;13;254;Petit-Landau;828;21;849
44;Grand Est;68;6;16;255;Pfaffenheim;1457;21;1478
44;Grand Est;68;4;08;256;Pfastatt;9579;128;9707
44;Grand Est;68;1;09;257;Pfetterhouse;980;23;1003
44;Grand Est;68;2;05;143;Porte du Ried;1782;51;1833
44;Grand Est;68;4;17;258;Pulversheim;2960;76;3036
44;Grand Est;68;1;01;259;Raedersdorf;513;7;520
44;Grand Est;68;6;07;260;Raedersheim;1108;24;1132
44;Grand Est;68;6;03;261;Rammersmatt;223;6;229
44;Grand Est;68;6;03;262;Ranspach;819;16;835
44;Grand Est;68;4;14;263;Ranspach-le-Bas;646;8;654
44;Grand Est;68;4;14;264;Ranspach-le-Haut;628;11;639
44;Grand Est;68;4;02;265;Rantzwiller;795;23;818
44;Grand Est;68;6;06;266;Réguisheim;1895;28;1923
44;Grand Est;68;4;08;267;Reiningue;1981;24;2005
44;Grand Est;68;1;09;268;Retzwiller;709;8;717
44;Grand Est;68;2;15;269;Ribeauvillé;4729;164;4893
44;Grand Est;68;4;08;270;Richwiller;3689;61;3750
44;Grand Est;68;4;13;271;Riedisheim;12645;353;12998
44;Grand Est;68;1;01;273;Riespach;643;40;683
44;Grand Est;68;6;07;274;Rimbach-près-Guebwiller;187;1;188
44;Grand Est;68;6;09;275;Rimbach-près-Masevaux;464;17;481
44;Grand Est;68;6;07;276;Rimbachzell;198;2;200
44;Grand Est;68;2;15;277;Riquewihr;1077;19;1096
44;Grand Est;68;4;13;278;Rixheim;13902;212;14114
44;Grand Est;68;6;03;279;Roderen;887;26;913
44;Grand Est;68;2;15;280;Rodern;362;6;368
44;Grand Est;68;2;06;281;Roggenhouse;469;6;475
44;Grand Est;68;1;09;282;Romagny;263;4;267
44;Grand Est;68;2;15;283;Rombach-le-Franc;780;22;802
44;Grand Est;68;1;01;284;Roppentzwiller;698;10;708
44;Grand Est;68;2;15;285;Rorschwihr;372;8;380
44;Grand Est;68;4;14;286;Rosenau;2374;51;2425
44;Grand Est;68;6;16;287;Rouffach;4518;266;4784
44;Grand Est;68;1;01;288;Ruederbach;399;4;403
44;Grand Est;68;4;17;289;Ruelisheim;2297;39;2336
44;Grand Est;68;2;06;291;Rumersheim-le-Haut;1079;26;1105
44;Grand Est;68;2;06;290;Rustenhart;859;15;874
44;Grand Est;68;6;03;292;Saint-Amarin;2262;41;2303
44;Grand Est;68;1;01;081;Saint-Bernard;571;9;580
44;Grand Est;68;1;09;293;Saint-Cosme;91;1;92
44;Grand Est;68;2;15;296;Saint-Hippolyte;966;15;981
44;Grand Est;68;4;14;297;Saint-Louis;21177;280;21457
44;Grand Est;68;1;09;299;Saint-Ulrich;308;0;308
44;Grand Est;68;2;15;294;Sainte-Croix-aux-Mines;1922;28;1950
44;Grand Est;68;2;05;295;Sainte-Croix-en-Plaine;2978;65;3043
44;Grand Est;68;2;15;298;Sainte-Marie-aux-Mines;5095;125;5220
44;Grand Est;68;4;13;300;Sausheim;5501;121;5622
44;Grand Est;68;4;02;301;Schlierbach;1227;24;1251
44;Grand Est;68;6;03;302;Schweighouse-Thann;767;27;794
44;Grand Est;68;1;01;303;Schwoben;228;8;236
44;Grand Est;68;6;09;304;Sentheim;1577;30;1607
44;Grand Est;68;1;09;305;Seppois-le-Bas;1378;25;1403
44;Grand Est;68;1;09;306;Seppois-le-Haut;511;7;518
44;Grand Est;68;6;09;307;Sewen;501;7;508
44;Grand Est;68;6;09;308;Sickert;327;13;340
44;Grand Est;68;4;02;309;Sierentz;3696;73;3769
44;Grand Est;68;2;16;311;Sondernach;615;12;627
44;Grand Est;68;1;01;312;Sondersdorf;335;6;341
44;Grand Est;68;6;09;313;Soppe-le-Bas;763;12;775
44;Grand Est;68;6;07;315;Soultz-Haut-Rhin;7072;132;7204
44;Grand Est;68;2;16;316;Soultzbach-les-Bains;735;22;757
44;Grand Est;68;2;16;317;Soultzeren;1121;19;1140
44;Grand Est;68;6;16;318;Soultzmatt;2411;52;2463
44;Grand Est;68;1;01;320;Spechbach;1334;44;1378
44;Grand Est;68;4;17;321;Staffelfelden;3959;64;4023
44;Grand Est;68;6;03;322;Steinbach;1360;25;1385
44;Grand Est;68;4;02;323;Steinbrunn-le-Bas;757;23;780
44;Grand Est;68;4;02;324;Steinbrunn-le-Haut;583;16;599
44;Grand Est;68;1;01;325;Steinsoultz;769;9;778
44;Grand Est;68;1;09;326;Sternenberg;155;7;162
44;Grand Est;68;4;02;327;Stetten;351;6;357
44;Grand Est;68;6;03;328;Storckensohn;207;1;208
44;Grand Est;68;2;16;329;Stosswihr;1352;34;1386
44;Grand Est;68;1;09;330;Strueth;331;8;339
44;Grand Est;68;2;05;331;Sundhoffen;1938;57;1995
44;Grand Est;68;1;01;332;Tagolsheim;928;13;941
44;Grand Est;68;1;01;333;Tagsdorf;294;6;300
44;Grand Est;68;6;03;334;Thann;7780;141;7921
44;Grand Est;68;2;15;335;Thannenkirch;463;6;469
44;Grand Est;68;1;09;336;Traubach-le-Bas;478;6;484
44;Grand Est;68;1;09;337;Traubach-le-Haut;604;9;613
44;Grand Est;68;2;16;338;Turckheim;3776;79;3855
44;Grand Est;68;1;09;340;Ueberstrass;375;14;389
44;Grand Est;68;4;02;341;Uffheim;885;27;912
44;Grand Est;68;6;03;342;Uffholtz;1795;34;1829
44;Grand Est;68;4;17;343;Ungersheim;2341;31;2372
44;Grand Est;68;6;03;344;Urbès;435;9;444
44;Grand Est;68;2;06;345;Urschenheim;735;25;760
44;Grand Est;68;1;09;192;Valdieu-Lutran;421;4;425
44;Grand Est;68;1;01;347;Vieux-Ferrette;688;20;708
44;Grand Est;68;6;03;348;Vieux-Thann;2843;46;2889
44;Grand Est;68;4;14;349;Village-Neuf;4284;82;4366
44;Grand Est;68;2;06;351;Vogelgrun;649;13;662
44;Grand Est;68;2;06;352;Volgelsheim;2668;26;2694
44;Grand Est;68;2;16;350;Vœgtlinshoffen;489;15;504
44;Grand Est;68;4;02;353;Wahlbach;497;17;514
44;Grand Est;68;2;16;354;Walbach;904;36;940
44;Grand Est;68;1;01;355;Waldighofen;1540;27;1567
44;Grand Est;68;1;01;356;Walheim;896;20;916
44;Grand Est;68;4;02;357;Waltenheim;532;16;548
44;Grand Est;68;2;16;358;Wasserbourg;463;12;475
44;Grand Est;68;6;03;359;Wattwiller;1634;47;1681
44;Grand Est;68;2;06;360;Weckolsheim;665;4;669
44;Grand Est;68;6;09;361;Wegscheid;322;6;328
44;Grand Est;68;4;14;362;Wentzwiller;756;15;771
44;Grand Est;68;1;01;363;Werentzhouse;544;14;558
44;Grand Est;68;6;16;364;Westhalten;988;15;1003
44;Grand Est;68;2;16;365;Wettolsheim;1733;62;1795
44;Grand Est;68;2;05;366;Wickerschwihr;732;31;763
44;Grand Est;68;2;06;367;Widensolen;1177;21;1198
44;Grand Est;68;2;16;368;Wihr-au-Val;1263;41;1304
44;Grand Est;68;6;03;370;Wildenstein;180;4;184
44;Grand Est;68;1;01;371;Willer;308;9;317
44;Grand Est;68;6;03;372;Willer-sur-Thur;1825;41;1866
44;Grand Est;68;1;01;373;Winkel;304;12;316
44;Grand Est;68;2;16;374;Wintzenheim;7594;402;7996
44;Grand Est;68;4;17;375;Wittelsheim;10355;162;10517
44;Grand Est;68;4;17;376;Wittenheim;14317;113;14430
44;Grand Est;68;1;01;377;Wittersdorf;806;18;824
44;Grand Est;68;1;09;378;Wolfersdorf;372;3;375
44;Grand Est;68;2;06;379;Wolfgantzen;1048;21;1069
44;Grand Est;68;1;01;380;Wolschwiller;453;11;464
44;Grand Est;68;6;07;381;Wuenheim;799;19;818
44;Grand Est;68;4;02;382;Zaessingue;378;4;382
44;Grand Est;68;2;15;383;Zellenberg;322;5;327
44;Grand Est;68;4;02;384;Zillisheim;2572;64;2636
44;Grand Est;68;2;16;385;Zimmerbach;843;25;868
44;Grand Est;68;4;02;386;Zimmersheim;1016;42;1058
84;Auvergne-Rhône-Alpes;69;2;10;001;Affoux;369;3;372
84;Auvergne-Rhône-Alpes;69;2;11;002;Aigueperse;248;1;249
84;Auvergne-Rhône-Alpes;69;1;00;003;Albigny-sur-Saône;2880;39;2919
84;Auvergne-Rhône-Alpes;69;2;04;004;Alix;763;23;786
84;Auvergne-Rhône-Alpes;69;2;01;005;Ambérieux;578;9;587
84;Auvergne-Rhône-Alpes;69;2;11;006;Amplepuis;4976;121;5097
84;Auvergne-Rhône-Alpes;69;1;08;007;Ampuis;2713;43;2756
84;Auvergne-Rhône-Alpes;69;2;10;008;Ancy;640;15;655
84;Auvergne-Rhône-Alpes;69;2;01;009;Anse;7178;154;7332
84;Auvergne-Rhône-Alpes;69;2;02;010;L' Arbresle;6398;196;6594
84;Auvergne-Rhône-Alpes;69;2;03;012;Les Ardillats;622;15;637
84;Auvergne-Rhône-Alpes;69;2;07;013;Arnas;3778;78;3856
84;Auvergne-Rhône-Alpes;69;1;12;014;Aveize;1127;22;1149
84;Auvergne-Rhône-Alpes;69;2;11;016;Azolette;120;0;120
84;Auvergne-Rhône-Alpes;69;2;04;017;Bagnols;731;21;752
84;Auvergne-Rhône-Alpes;69;2;03;018;Beaujeu;2157;33;2190
84;Auvergne-Rhône-Alpes;69;1;89;179;Beauvallon;4013;73;4086
84;Auvergne-Rhône-Alpes;69;2;03;019;Belleville-en-Beaujolais;12971;269;13240
84;Auvergne-Rhône-Alpes;69;2;04;020;Belmont-d'Azergues;631;17;648
84;Auvergne-Rhône-Alpes;69;2;02;021;Bessenay;2293;80;2373
84;Auvergne-Rhône-Alpes;69;2;02;022;Bibost;575;14;589
84;Auvergne-Rhône-Alpes;69;2;07;023;Blacé;1631;25;1656
84;Auvergne-Rhône-Alpes;69;2;04;026;Le Breuil;530;10;540
84;Auvergne-Rhône-Alpes;69;1;05;027;Brignais;11434;176;11610
84;Auvergne-Rhône-Alpes;69;1;05;028;Brindas;6174;106;6280
84;Auvergne-Rhône-Alpes;69;1;00;029;Bron;41543;477;42020
84;Auvergne-Rhône-Alpes;69;1;02;030;Brullioles;816;15;831
84;Auvergne-Rhône-Alpes;69;1;02;031;Brussieu;1376;93;1469
84;Auvergne-Rhône-Alpes;69;2;04;032;Bully;1982;37;2019
84;Auvergne-Rhône-Alpes;69;1;00;033;Cailloux-sur-Fontaines;2722;70;2792
84;Auvergne-Rhône-Alpes;69;1;00;034;Caluire-et-Cuire;43187;629;43816
84;Auvergne-Rhône-Alpes;69;2;03;035;Cenves;391;7;398
84;Auvergne-Rhône-Alpes;69;2;03;036;Cercié;1128;22;1150
84;Auvergne-Rhône-Alpes;69;1;08;228;Chabanière;4183;93;4276
84;Auvergne-Rhône-Alpes;69;2;10;037;Chambost-Allières;839;6;845
84;Auvergne-Rhône-Alpes;69;1;02;038;Chambost-Longessaigne;938;25;963
84;Auvergne-Rhône-Alpes;69;2;04;039;Chamelet;682;10;692
84;Auvergne-Rhône-Alpes;69;1;00;040;Champagne-au-Mont-d'Or;5526;53;5579
84;Auvergne-Rhône-Alpes;69;1;12;042;La Chapelle-sur-Coise;573;15;588
84;Auvergne-Rhône-Alpes;69;1;09;270;Chaponnay;4273;65;4338
84;Auvergne-Rhône-Alpes;69;1;05;043;Chaponost;8717;171;8888
84;Auvergne-Rhône-Alpes;69;1;00;044;Charbonnières-les-Bains;5067;141;5208
84;Auvergne-Rhône-Alpes;69;2;03;045;Charentay;1240;68;1308
84;Auvergne-Rhône-Alpes;69;1;00;046;Charly;4541;138;4679
84;Auvergne-Rhône-Alpes;69;2;04;047;Charnay;1057;23;1080
84;Auvergne-Rhône-Alpes;69;2;01;049;Chasselay;2784;65;2849
84;Auvergne-Rhône-Alpes;69;1;00;271;Chassieu;10359;146;10505
84;Auvergne-Rhône-Alpes;69;2;04;050;Châtillon;2137;47;2184
84;Auvergne-Rhône-Alpes;69;1;08;051;Chaussan;1116;29;1145
84;Auvergne-Rhône-Alpes;69;2;01;052;Chazay-d'Azergues;4130;115;4245
84;Auvergne-Rhône-Alpes;69;2;03;053;Chénas;545;13;558
84;Auvergne-Rhône-Alpes;69;2;11;054;Chénelette;321;6;327
84;Auvergne-Rhône-Alpes;69;2;01;055;Les Chères;1453;26;1479
84;Auvergne-Rhône-Alpes;69;2;04;056;Chessy;2063;48;2111
84;Auvergne-Rhône-Alpes;69;2;02;057;Chevinay;557;12;569
84;Auvergne-Rhône-Alpes;69;2;03;058;Chiroubles;391;10;401
84;Auvergne-Rhône-Alpes;69;2;01;059;Civrieux-d'Azergues;1515;28;1543
84;Auvergne-Rhône-Alpes;69;2;11;060;Claveisolles;635;95;730
84;Auvergne-Rhône-Alpes;69;2;04;061;Cogny;1167;34;1201
84;Auvergne-Rhône-Alpes;69;1;12;062;Coise;769;22;791
84;Auvergne-Rhône-Alpes;69;1;00;063;Collonges-au-Mont-d'Or;4052;83;4135
84;Auvergne-Rhône-Alpes;69;1;06;299;Colombier-Saugnieu;2613;30;2643
84;Auvergne-Rhône-Alpes;69;1;09;272;Communay;4197;84;4281
84;Auvergne-Rhône-Alpes;69;1;08;064;Condrieu;3897;80;3977
84;Auvergne-Rhône-Alpes;69;1;00;273;Corbas;11050;60;11110
84;Auvergne-Rhône-Alpes;69;2;03;065;Corcelles-en-Beaujolais;942;15;957
84;Auvergne-Rhône-Alpes;69;2;11;066;Cours;4449;80;4529
84;Auvergne-Rhône-Alpes;69;2;02;067;Courzieu;1118;20;1138
84;Auvergne-Rhône-Alpes;69;1;00;068;Couzon-au-Mont-d'Or;2516;48;2564
84;Auvergne-Rhône-Alpes;69;1;00;069;Craponne;11067;186;11253
84;Auvergne-Rhône-Alpes;69;2;11;070;Cublize;1266;28;1294
84;Auvergne-Rhône-Alpes;69;1;00;071;Curis-au-Mont-d'Or;1172;31;1203
84;Auvergne-Rhône-Alpes;69;1;00;072;Dardilly;8600;556;9156
84;Auvergne-Rhône-Alpes;69;1;00;275;Décines-Charpieu;28602;128;28730
84;Auvergne-Rhône-Alpes;69;2;07;074;Denicé;1513;48;1561
84;Auvergne-Rhône-Alpes;69;2;88;135;Deux-Grosnes;1905;41;1946
84;Auvergne-Rhône-Alpes;69;2;10;075;Dième;186;2;188
84;Auvergne-Rhône-Alpes;69;2;01;076;Dommartin;2576;98;2674
84;Auvergne-Rhône-Alpes;69;2;03;077;Dracé;956;13;969
84;Auvergne-Rhône-Alpes;69;1;12;078;Duerne;829;16;845
84;Auvergne-Rhône-Alpes;69;1;08;080;Échalas;1799;15;1814
84;Auvergne-Rhône-Alpes;69;1;00;081;Écully;18517;348;18865
84;Auvergne-Rhône-Alpes;69;2;03;082;Émeringes;259;7;266
84;Auvergne-Rhône-Alpes;69;2;02;083;Éveux;1169;29;1198
84;Auvergne-Rhône-Alpes;69;1;00;276;Feyzin;9857;53;9910
84;Auvergne-Rhône-Alpes;69;2;03;084;Fleurie;1265;21;1286
84;Auvergne-Rhône-Alpes;69;1;00;085;Fleurieu-sur-Saône;1449;40;1489
84;Auvergne-Rhône-Alpes;69;2;02;086;Fleurieux-sur-l'Arbresle;2334;64;2398
84;Auvergne-Rhône-Alpes;69;1;00;087;Fontaines-Saint-Martin;3052;74;3126
84;Auvergne-Rhône-Alpes;69;1;00;088;Fontaines-sur-Saône;7069;75;7144
84;Auvergne-Rhône-Alpes;69;1;00;089;Francheville;14198;266;14464
84;Auvergne-Rhône-Alpes;69;2;04;090;Frontenas;815;24;839
84;Auvergne-Rhône-Alpes;69;1;06;277;Genas;12734;207;12941
84;Auvergne-Rhône-Alpes;69;1;00;278;Genay;5470;104;5574
84;Auvergne-Rhône-Alpes;69;1;00;091;Givors;19975;114;20089
84;Auvergne-Rhône-Alpes;69;2;07;092;Gleizé;7472;339;7811
84;Auvergne-Rhône-Alpes;69;2;10;093;Grandris;1181;20;1201
84;Auvergne-Rhône-Alpes;69;1;05;094;Grézieu-la-Varenne;5734;112;5846
84;Auvergne-Rhône-Alpes;69;1;12;095;Grézieu-le-Marché;815;17;832
84;Auvergne-Rhône-Alpes;69;1;00;096;Grigny;9662;72;9734
84;Auvergne-Rhône-Alpes;69;1;08;097;Les Haies;785;20;805
84;Auvergne-Rhône-Alpes;69;1;02;098;Les Halles;492;7;499
84;Auvergne-Rhône-Alpes;69;1;02;099;Haute-Rivoire;1444;28;1472
84;Auvergne-Rhône-Alpes;69;1;00;100;Irigny;8641;99;8740
84;Auvergne-Rhône-Alpes;69;1;00;279;Jonage;5903;75;5978
84;Auvergne-Rhône-Alpes;69;1;06;280;Jons;1487;12;1499
84;Auvergne-Rhône-Alpes;69;2;10;102;Joux;691;22;713
84;Auvergne-Rhône-Alpes;69;2;03;103;Juliénas;909;21;930
84;Auvergne-Rhône-Alpes;69;2;03;104;Jullié;435;9;444
84;Auvergne-Rhône-Alpes;69;2;07;105;Lacenas;972;34;1006
84;Auvergne-Rhône-Alpes;69;2;01;106;Lachassagne;1118;22;1140
84;Auvergne-Rhône-Alpes;69;2;10;107;Lamure-sur-Azergues;1048;66;1114
84;Auvergne-Rhône-Alpes;69;2;03;108;Lancié;1021;23;1044
84;Auvergne-Rhône-Alpes;69;2;03;109;Lantignié;880;30;910
84;Auvergne-Rhône-Alpes;69;1;12;110;Larajasse;1853;30;1883
84;Auvergne-Rhône-Alpes;69;2;04;111;Légny;667;17;684
84;Auvergne-Rhône-Alpes;69;2;01;112;Lentilly;5793;137;5930
84;Auvergne-Rhône-Alpes;69;2;04;113;Létra;922;28;950
84;Auvergne-Rhône-Alpes;69;2;07;115;Limas;4803;102;4905
84;Auvergne-Rhône-Alpes;69;1;00;116;Limonest;3664;101;3765
84;Auvergne-Rhône-Alpes;69;1;00;117;Lissieu;3122;74;3196
84;Auvergne-Rhône-Alpes;69;1;08;118;Loire-sur-Rhône;2559;31;2590
84;Auvergne-Rhône-Alpes;69;1;08;119;Longes;977;9;986
84;Auvergne-Rhône-Alpes;69;1;02;120;Longessaigne;595;16;611
84;Auvergne-Rhône-Alpes;69;2;01;121;Lozanne;2626;41;2667
84;Auvergne-Rhône-Alpes;69;2;01;122;Lucenay;1808;35;1843
84;Auvergne-Rhône-Alpes;69;1;00;381;Lyon 1er Arrondissement;29352;790;30142
84;Auvergne-Rhône-Alpes;69;1;00;382;Lyon 2e Arrondissement;30520;378;30898
84;Auvergne-Rhône-Alpes;69;1;00;383;Lyon 3e Arrondissement;101744;1008;102752
84;Auvergne-Rhône-Alpes;69;1;00;384;Lyon 4e Arrondissement;35949;420;36369
84;Auvergne-Rhône-Alpes;69;1;00;385;Lyon 5e Arrondissement;49409;1064;50473
84;Auvergne-Rhône-Alpes;69;1;00;386;Lyon 6e Arrondissement;51777;791;52568
84;Auvergne-Rhône-Alpes;69;1;00;387;Lyon 7e Arrondissement;81566;539;82105
84;Auvergne-Rhône-Alpes;69;1;00;388;Lyon 8e Arrondissement;85088;1022;86110
84;Auvergne-Rhône-Alpes;69;1;00;389;Lyon 9e Arrondissement;50687;575;51262
84;Auvergne-Rhône-Alpes;69;2;03;124;Marchampt;462;9;471
84;Auvergne-Rhône-Alpes;69;2;01;125;Marcilly-d'Azergues;875;14;889
84;Auvergne-Rhône-Alpes;69;2;01;126;Marcy;726;27;753
84;Auvergne-Rhône-Alpes;69;1;00;127;Marcy-l'Étoile;3657;57;3714
84;Auvergne-Rhône-Alpes;69;1;09;281;Marennes;1688;20;1708
84;Auvergne-Rhône-Alpes;69;2;11;130;Meaux-la-Montagne;237;3;240
84;Auvergne-Rhône-Alpes;69;1;05;131;Messimy;3381;84;3465
84;Auvergne-Rhône-Alpes;69;1;12;132;Meys;850;15;865
84;Auvergne-Rhône-Alpes;69;1;00;282;Meyzieu;33477;248;33725
84;Auvergne-Rhône-Alpes;69;1;09;133;Millery;4331;83;4414
84;Auvergne-Rhône-Alpes;69;1;00;283;Mions;13542;119;13661
84;Auvergne-Rhône-Alpes;69;2;04;134;Moiré;210;9;219
84;Auvergne-Rhône-Alpes;69;1;09;136;Montagny;2959;41;3000
84;Auvergne-Rhône-Alpes;69;1;00;284;Montanay;3142;113;3255
84;Auvergne-Rhône-Alpes;69;2;07;137;Montmelas-Saint-Sorlin;502;7;509
84;Auvergne-Rhône-Alpes;69;1;02;138;Montromant;456;9;465
84;Auvergne-Rhône-Alpes;69;1;02;139;Montrottier;1385;78;1463
84;Auvergne-Rhône-Alpes;69;2;01;140;Morancé;1970;45;2015
84;Auvergne-Rhône-Alpes;69;1;08;141;Mornant;5938;202;6140
84;Auvergne-Rhône-Alpes;69;1;00;142;La Mulatière;6334;89;6423
84;Auvergne-Rhône-Alpes;69;1;00;143;Neuville-sur-Saône;7514;95;7609
84;Auvergne-Rhône-Alpes;69;2;03;145;Odenas;927;25;952
84;Auvergne-Rhône-Alpes;69;1;09;148;Orliénas;2444;65;2509
84;Auvergne-Rhône-Alpes;69;1;00;149;Oullins;26273;292;26565
84;Auvergne-Rhône-Alpes;69;2;07;151;Le Perréon;1587;39;1626
84;Auvergne-Rhône-Alpes;69;1;00;152;Pierre-Bénite;10390;63;10453
84;Auvergne-Rhône-Alpes;69;1;00;153;Poleymieux-au-Mont-d'Or;1332;44;1376
84;Auvergne-Rhône-Alpes;69;1;12;154;Pollionnay;2637;49;2686
84;Auvergne-Rhône-Alpes;69;1;12;155;Pomeys;1145;31;1176
84;Auvergne-Rhône-Alpes;69;2;01;156;Pommiers;2637;78;2715
84;Auvergne-Rhône-Alpes;69;2;04;159;Porte des Pierres Dorées;3753;92;3845
84;Auvergne-Rhône-Alpes;69;2;11;160;Poule-les-Écharmeaux;1102;25;1127
84;Auvergne-Rhône-Alpes;69;2;11;161;Propières;468;30;498
84;Auvergne-Rhône-Alpes;69;1;06;285;Pusignan;4114;37;4151
84;Auvergne-Rhône-Alpes;69;2;03;162;Quincié-en-Beaujolais;1325;34;1359
84;Auvergne-Rhône-Alpes;69;1;00;163;Quincieux;3467;51;3518
84;Auvergne-Rhône-Alpes;69;2;11;164;Ranchal;319;10;329
84;Auvergne-Rhône-Alpes;69;2;03;165;Régnié-Durette;1119;25;1144
84;Auvergne-Rhône-Alpes;69;1;00;286;Rillieux-la-Pape;30012;354;30366
84;Auvergne-Rhône-Alpes;69;1;08;166;Riverie;322;2;324
84;Auvergne-Rhône-Alpes;69;2;07;167;Rivolet;579;11;590
84;Auvergne-Rhône-Alpes;69;1;00;168;Rochetaillée-sur-Saône;1528;23;1551
84;Auvergne-Rhône-Alpes;69;2;11;169;Ronno;636;23;659
84;Auvergne-Rhône-Alpes;69;1;12;170;Rontalon;1162;18;1180
84;Auvergne-Rhône-Alpes;69;2;02;171;Sain-Bel;2316;24;2340
84;Auvergne-Rhône-Alpes;69;1;12;180;Saint-André-la-Côte;284;9;293
84;Auvergne-Rhône-Alpes;69;2;10;181;Saint-Appolinaire;213;1;214
84;Auvergne-Rhône-Alpes;69;1;06;287;Saint-Bonnet-de-Mure;6800;79;6879
84;Auvergne-Rhône-Alpes;69;2;11;182;Saint-Bonnet-des-Bruyères;356;2;358
84;Auvergne-Rhône-Alpes;69;2;11;183;Saint-Bonnet-le-Troncy;313;3;316
84;Auvergne-Rhône-Alpes;69;2;11;186;Saint-Clément-de-Vers;226;2;228
84;Auvergne-Rhône-Alpes;69;1;02;187;Saint-Clément-les-Places;640;21;661
84;Auvergne-Rhône-Alpes;69;2;10;188;Saint-Clément-sur-Valsonne;909;9;918
84;Auvergne-Rhône-Alpes;69;1;00;191;Saint-Cyr-au-Mont-d'Or;5576;136;5712
84;Auvergne-Rhône-Alpes;69;2;07;192;Saint-Cyr-le-Chatoux;145;7;152
84;Auvergne-Rhône-Alpes;69;1;08;193;Saint-Cyr-sur-le-Rhône;1306;33;1339
84;Auvergne-Rhône-Alpes;69;1;00;194;Saint-Didier-au-Mont-d'Or;6785;154;6939
84;Auvergne-Rhône-Alpes;69;2;03;196;Saint-Didier-sur-Beaujeu;616;10;626
84;Auvergne-Rhône-Alpes;69;2;07;197;Saint-Étienne-des-Oullières;2207;39;2246
84;Auvergne-Rhône-Alpes;69;2;03;198;Saint-Étienne-la-Varenne;741;7;748
84;Auvergne-Rhône-Alpes;69;1;00;199;Saint-Fons;18802;57;18859
84;Auvergne-Rhône-Alpes;69;2;10;200;Saint-Forgeux;1486;33;1519
84;Auvergne-Rhône-Alpes;69;1;02;203;Saint-Genis-l'Argentière;1041;17;1058
84;Auvergne-Rhône-Alpes;69;1;00;204;Saint-Genis-Laval;21217;478;21695
84;Auvergne-Rhône-Alpes;69;1;00;205;Saint-Genis-les-Ollières;4984;88;5072
84;Auvergne-Rhône-Alpes;69;2;07;206;Saint-Georges-de-Reneins;4378;90;4468
84;Auvergne-Rhône-Alpes;69;1;00;207;Saint-Germain-au-Mont-d'Or;3085;48;3133
84;Auvergne-Rhône-Alpes;69;2;04;208;Saint-Germain-Nuelles;2265;61;2326
84;Auvergne-Rhône-Alpes;69;2;11;209;Saint-Igny-de-Vers;582;16;598
84;Auvergne-Rhône-Alpes;69;2;04;212;Saint-Jean-des-Vignes;432;10;442
84;Auvergne-Rhône-Alpes;69;2;11;214;Saint-Jean-la-Bussière;1214;28;1242
84;Auvergne-Rhône-Alpes;69;2;07;215;Saint-Julien;854;19;873
84;Auvergne-Rhône-Alpes;69;2;02;216;Saint-Julien-sur-Bibost;562;12;574
84;Auvergne-Rhône-Alpes;69;2;10;217;Saint-Just-d'Avray;747;28;775
84;Auvergne-Rhône-Alpes;69;2;03;218;Saint-Lager;1040;17;1057
84;Auvergne-Rhône-Alpes;69;1;08;219;Saint-Laurent-d'Agny;2139;57;2196
84;Auvergne-Rhône-Alpes;69;1;02;220;Saint-Laurent-de-Chamousset;1827;113;1940
84;Auvergne-Rhône-Alpes;69;1;06;288;Saint-Laurent-de-Mure;5377;65;5442
84;Auvergne-Rhône-Alpes;69;2;10;225;Saint-Marcel-l'Éclairé;524;14;538
84;Auvergne-Rhône-Alpes;69;1;12;227;Saint-Martin-en-Haut;3865;189;4054
84;Auvergne-Rhône-Alpes;69;2;11;229;Saint-Nizier-d'Azergues;790;14;804
84;Auvergne-Rhône-Alpes;69;1;06;289;Saint-Pierre-de-Chandieu;4520;58;4578
84;Auvergne-Rhône-Alpes;69;2;02;231;Saint-Pierre-la-Palud;2635;42;2677
84;Auvergne-Rhône-Alpes;69;1;00;290;Saint-Priest;46207;290;46497
84;Auvergne-Rhône-Alpes;69;1;00;233;Saint-Romain-au-Mont-d'Or;1211;59;1270
84;Auvergne-Rhône-Alpes;69;2;10;234;Saint-Romain-de-Popey;1560;71;1631
84;Auvergne-Rhône-Alpes;69;1;08;235;Saint-Romain-en-Gal;1889;112;2001
84;Auvergne-Rhône-Alpes;69;1;08;236;Saint-Romain-en-Gier;579;5;584
84;Auvergne-Rhône-Alpes;69;1;09;291;Saint-Symphorien-d'Ozon;5735;56;5791
84;Auvergne-Rhône-Alpes;69;1;12;238;Saint-Symphorien-sur-Coise;3682;94;3776
84;Auvergne-Rhône-Alpes;69;2;04;239;Saint-Vérand;1192;23;1215
84;Auvergne-Rhône-Alpes;69;2;11;240;Saint-Vincent-de-Reins;630;6;636
84;Auvergne-Rhône-Alpes;69;1;12;184;Sainte-Catherine;980;20;1000
84;Auvergne-Rhône-Alpes;69;1;08;189;Sainte-Colombe;1909;29;1938
84;Auvergne-Rhône-Alpes;69;1;12;190;Sainte-Consorce;1939;91;2030
84;Auvergne-Rhône-Alpes;69;1;02;201;Sainte-Foy-l'Argentière;1281;25;1306
84;Auvergne-Rhône-Alpes;69;1;00;202;Sainte-Foy-lès-Lyon;22012;371;22383
84;Auvergne-Rhône-Alpes;69;2;04;230;Sainte-Paule;324;7;331
84;Auvergne-Rhône-Alpes;69;2;07;172;Salles-Arbuissonnas-en-Beaujolais;791;28;819
84;Auvergne-Rhône-Alpes;69;2;10;173;Sarcey;1002;25;1027
84;Auvergne-Rhône-Alpes;69;1;00;292;Sathonay-Camp;5934;59;5993
84;Auvergne-Rhône-Alpes;69;1;00;293;Sathonay-Village;2360;48;2408
84;Auvergne-Rhône-Alpes;69;2;10;174;Les Sauvages;612;13;625
84;Auvergne-Rhône-Alpes;69;2;02;175;Savigny;2009;57;2066
84;Auvergne-Rhône-Alpes;69;1;09;294;Sérézin-du-Rhône;2664;36;2700
84;Auvergne-Rhône-Alpes;69;1;09;295;Simandres;1812;9;1821
84;Auvergne-Rhône-Alpes;69;1;00;296;Solaize;2922;32;2954
84;Auvergne-Rhône-Alpes;69;1;08;176;Soucieu-en-Jarrest;4515;83;4598
84;Auvergne-Rhône-Alpes;69;2;02;177;Sourcieux-les-Mines;2029;45;2074
84;Auvergne-Rhône-Alpes;69;1;02;178;Souzy;813;20;833
84;Auvergne-Rhône-Alpes;69;1;09;241;Taluyers;2539;62;2601
84;Auvergne-Rhône-Alpes;69;2;03;242;Taponas;976;16;992
84;Auvergne-Rhône-Alpes;69;2;10;243;Tarare;10582;281;10863
84;Auvergne-Rhône-Alpes;69;1;00;244;Tassin-la-Demi-Lune;22297;394;22691
84;Auvergne-Rhône-Alpes;69;2;04;245;Ternand;684;26;710
84;Auvergne-Rhône-Alpes;69;1;09;297;Ternay;5514;61;5575
84;Auvergne-Rhône-Alpes;69;2;04;246;Theizé;1247;38;1285
84;Auvergne-Rhône-Alpes;69;2;11;248;Thizy-les-Bourgs;6031;127;6158
84;Auvergne-Rhône-Alpes;69;1;12;249;Thurins;3050;62;3112
84;Auvergne-Rhône-Alpes;69;1;00;250;La Tour-de-Salvagny;4050;96;4146
84;Auvergne-Rhône-Alpes;69;1;06;298;Toussieu;3080;26;3106
84;Auvergne-Rhône-Alpes;69;1;08;252;Trèves;737;9;746
84;Auvergne-Rhône-Alpes;69;1;08;253;Tupin-et-Semons;617;10;627
84;Auvergne-Rhône-Alpes;69;2;04;024;Val d'Oingt;4037;112;4149
84;Auvergne-Rhône-Alpes;69;2;10;254;Valsonne;952;12;964
84;Auvergne-Rhône-Alpes;69;1;12;255;Vaugneray;5734;108;5842
84;Auvergne-Rhône-Alpes;69;1;00;256;Vaulx-en-Velin;49658;270;49928
84;Auvergne-Rhône-Alpes;69;2;07;257;Vaux-en-Beaujolais;1087;19;1106
84;Auvergne-Rhône-Alpes;69;2;03;258;Vauxrenard;321;7;328
84;Auvergne-Rhône-Alpes;69;1;00;259;Vénissieux;65894;308;66202
84;Auvergne-Rhône-Alpes;69;1;00;260;Vernaison;4998;54;5052
84;Auvergne-Rhône-Alpes;69;2;03;261;Vernay;101;1;102
84;Auvergne-Rhône-Alpes;69;2;04;265;Ville-sur-Jarnioux;806;33;839
84;Auvergne-Rhône-Alpes;69;1;02;263;Villechenève;883;20;903
84;Auvergne-Rhône-Alpes;69;2;13;264;Villefranche-sur-Saône;36857;446;37303
84;Auvergne-Rhône-Alpes;69;1;00;266;Villeurbanne;147712;1042;148754
84;Auvergne-Rhône-Alpes;69;2;03;267;Villié-Morgon;2111;120;2231
84;Auvergne-Rhône-Alpes;69;2;10;157;Vindry-sur-Turdine;5133;93;5226
84;Auvergne-Rhône-Alpes;69;1;05;268;Vourles;3411;90;3501
84;Auvergne-Rhône-Alpes;69;1;12;269;Yzeron;1022;24;1046
27;Bourgogne-Franche-Comté;70;1;13;001;Abelcourt;354;5;359
27;Bourgogne-Franche-Comté;70;2;05;002;Aboncourt-Gesincourt;214;7;221
27;Bourgogne-Franche-Comté;70;2;01;003;Achey;70;0;70
27;Bourgogne-Franche-Comté;70;1;06;004;Adelans-et-le-Val-de-Bithaine;301;7;308
27;Bourgogne-Franche-Comté;70;1;17;005;Aillevans;148;1;149
27;Bourgogne-Franche-Comté;70;1;13;006;Aillevillers-et-Lyaumont;1551;110;1661
27;Bourgogne-Franche-Comté;70;1;08;007;Ailloncourt;302;5;307
27;Bourgogne-Franche-Comté;70;1;13;008;Ainvelle;148;2;150
27;Bourgogne-Franche-Comté;70;2;05;009;Aisey-et-Richecourt;107;0;107
27;Bourgogne-Franche-Comté;70;1;05;010;Alaincourt;112;2;114
27;Bourgogne-Franche-Comté;70;1;10;011;Amage;338;4;342
27;Bourgogne-Franche-Comté;70;2;11;012;Amance;652;15;667
27;Bourgogne-Franche-Comté;70;1;05;013;Ambiévillers;73;0;73
27;Bourgogne-Franche-Comté;70;1;07;014;Amblans-et-Velotte;396;5;401
27;Bourgogne-Franche-Comté;70;2;11;015;Amoncourt;286;7;293
27;Bourgogne-Franche-Comté;70;1;10;016;Amont-et-Effreney;164;3;167
27;Bourgogne-Franche-Comté;70;1;11;017;Anchenoncourt-et-Chazel;241;2;243
27;Bourgogne-Franche-Comté;70;2;02;018;Ancier;502;5;507
27;Bourgogne-Franche-Comté;70;2;15;019;Andelarre;134;4;138
27;Bourgogne-Franche-Comté;70;2;15;020;Andelarrot;237;2;239
27;Bourgogne-Franche-Comté;70;1;07;021;Andornay;203;5;208
27;Bourgogne-Franche-Comté;70;2;02;022;Angirey;140;3;143
27;Bourgogne-Franche-Comté;70;1;11;023;Anjeux;144;4;148
27;Bourgogne-Franche-Comté;70;2;02;024;Apremont;460;14;474
27;Bourgogne-Franche-Comté;70;2;05;025;Arbecey;259;6;265
27;Bourgogne-Franche-Comté;70;2;02;026;Arc-lès-Gray;2540;27;2567
27;Bourgogne-Franche-Comté;70;2;01;027;Argillières;75;1;76
27;Bourgogne-Franche-Comté;70;2;14;028;Aroz;148;3;151
27;Bourgogne-Franche-Comté;70;1;07;029;Arpenans;245;2;247
27;Bourgogne-Franche-Comté;70;2;09;030;Arsans;48;2;50
27;Bourgogne-Franche-Comté;70;1;17;031;Athesans-Étroitefontaine;654;13;667
27;Bourgogne-Franche-Comté;70;2;01;032;Attricourt;44;0;44
27;Bourgogne-Franche-Comté;70;2;05;035;Augicourt;177;4;181
27;Bourgogne-Franche-Comté;70;2;12;036;Aulx-lès-Cromary;167;2;169
27;Bourgogne-Franche-Comté;70;2;01;037;Autet;262;26;288
27;Bourgogne-Franche-Comté;70;2;12;038;Authoison;320;11;331
27;Bourgogne-Franche-Comté;70;2;09;039;Autoreille;337;4;341
27;Bourgogne-Franche-Comté;70;1;17;042;Autrey-le-Vay;92;1;93
27;Bourgogne-Franche-Comté;70;2;17;040;Autrey-lès-Cerre;234;1;235
27;Bourgogne-Franche-Comté;70;2;01;041;Autrey-lès-Gray;374;9;383
27;Bourgogne-Franche-Comté;70;2;01;043;Auvet-et-la-Chapelotte;238;8;246
27;Bourgogne-Franche-Comté;70;2;11;044;Auxon;419;19;438
27;Bourgogne-Franche-Comté;70;2;09;045;Avrigney-Virey;420;7;427
27;Bourgogne-Franche-Comté;70;1;07;046;Les Aynans;351;7;358
27;Bourgogne-Franche-Comté;70;2;14;047;Baignes;104;1;105
27;Bourgogne-Franche-Comté;70;2;09;048;Bard-lès-Pesmes;145;1;146
27;Bourgogne-Franche-Comté;70;2;05;049;Barges;94;2;96
27;Bourgogne-Franche-Comté;70;2;12;050;La Barre;101;0;101
27;Bourgogne-Franche-Comté;70;1;05;051;La Basse-Vaivre;37;0;37
27;Bourgogne-Franche-Comté;70;1;11;052;Bassigney;127;3;130
27;Bourgogne-Franche-Comté;70;2;14;053;Les Bâties;79;1;80
27;Bourgogne-Franche-Comté;70;2;02;054;Battrans;237;3;240
27;Bourgogne-Franche-Comté;70;1;08;055;Baudoncourt;533;10;543
27;Bourgogne-Franche-Comté;70;2;11;056;Baulay;297;6;303
27;Bourgogne-Franche-Comté;70;2;09;057;Bay;142;1;143
27;Bourgogne-Franche-Comté;70;2;14;058;Beaujeu-Saint-Vallier-Pierrejux-et-Quitteur;934;15;949
27;Bourgogne-Franche-Comté;70;2;12;059;Beaumotte-Aubertans;458;9;467
27;Bourgogne-Franche-Comté;70;2;09;060;Beaumotte-lès-Pin;307;4;311
27;Bourgogne-Franche-Comté;70;1;10;061;Belfahy;81;3;84
27;Bourgogne-Franche-Comté;70;1;10;062;Belmont;137;5;142
27;Bourgogne-Franche-Comté;70;1;10;063;Belonchamp;204;4;208
27;Bourgogne-Franche-Comté;70;1;04;064;Belverne;145;3;148
27;Bourgogne-Franche-Comté;70;2;12;065;Besnans;79;1;80
27;Bourgogne-Franche-Comté;70;2;05;066;Betaucourt;170;1;171
27;Bourgogne-Franche-Comté;70;1;06;067;Betoncourt-lès-Brotte;122;0;122
27;Bourgogne-Franche-Comté;70;1;11;069;Betoncourt-Saint-Pancras;50;2;52
27;Bourgogne-Franche-Comté;70;2;05;070;Betoncourt-sur-Mance;29;2;31
27;Bourgogne-Franche-Comté;70;1;10;071;Beulotte-Saint-Laurent;58;0;58
27;Bourgogne-Franche-Comté;70;1;17;072;Beveuge;83;2;85
27;Bourgogne-Franche-Comté;70;2;05;074;Blondefontaine;269;3;272
27;Bourgogne-Franche-Comté;70;2;09;075;Bonboillon;199;2;201
27;Bourgogne-Franche-Comté;70;2;09;076;Bonnevent-Velloreille;378;8;386
27;Bourgogne-Franche-Comté;70;2;17;077;Borey;230;4;234
27;Bourgogne-Franche-Comté;70;2;05;078;Bougey;93;2;95
27;Bourgogne-Franche-Comté;70;2;11;079;Bougnon;545;11;556
27;Bourgogne-Franche-Comté;70;2;01;080;Bouhans-et-Feurg;239;7;246
27;Bourgogne-Franche-Comté;70;1;06;081;Bouhans-lès-Lure;323;6;329
27;Bourgogne-Franche-Comté;70;2;12;082;Bouhans-lès-Montbozon;142;3;145
27;Bourgogne-Franche-Comté;70;1;11;083;Bouligney;410;10;420
27;Bourgogne-Franche-Comté;70;2;12;084;Boulot;690;6;696
27;Bourgogne-Franche-Comté;70;2;12;085;Boult;623;12;635
27;Bourgogne-Franche-Comté;70;2;05;086;Bourbévelle;78;1;79
27;Bourgogne-Franche-Comté;70;2;11;087;Bourguignon-lès-Conflans;141;3;144
27;Bourgogne-Franche-Comté;70;2;14;088;Bourguignon-lès-la-Charité;116;2;118
27;Bourgogne-Franche-Comté;70;2;05;089;Bourguignon-lès-Morey;47;3;50
27;Bourgogne-Franche-Comté;70;2;14;090;Boursières;57;1;58
27;Bourgogne-Franche-Comté;70;2;05;091;Bousseraucourt;49;1;50
27;Bourgogne-Franche-Comté;70;2;09;092;Bresilley;188;3;191
27;Bourgogne-Franche-Comté;70;1;08;093;Breuches;688;11;699
27;Bourgogne-Franche-Comté;70;1;10;094;Breuchotte;300;6;306
27;Bourgogne-Franche-Comté;70;2;11;095;Breurey-lès-Faverney;635;10;645
27;Bourgogne-Franche-Comté;70;1;03;096;Brevilliers;634;17;651
27;Bourgogne-Franche-Comté;70;1;13;097;Briaucourt;239;10;249
27;Bourgogne-Franche-Comté;70;1;08;098;Brotte-lès-Luxeuil;208;2;210
27;Bourgogne-Franche-Comté;70;2;01;099;Brotte-lès-Ray;75;1;76
27;Bourgogne-Franche-Comté;70;2;09;101;Broye-Aubigney-Montseugny;486;6;492
27;Bourgogne-Franche-Comté;70;2;01;100;Broye-les-Loups-et-Verfontaine;127;0;127
27;Bourgogne-Franche-Comté;70;2;09;102;Brussey;276;10;286
27;Bourgogne-Franche-Comté;70;1;10;103;La Bruyère;218;3;221
27;Bourgogne-Franche-Comté;70;2;09;104;Bucey-lès-Gy;592;14;606
27;Bourgogne-Franche-Comté;70;2;14;105;Bucey-lès-Traves;123;1;124
27;Bourgogne-Franche-Comté;70;2;11;106;Buffignécourt;116;4;120
27;Bourgogne-Franche-Comté;70;2;12;107;Bussières;425;4;429
27;Bourgogne-Franche-Comté;70;2;12;109;Buthiers;308;2;310
27;Bourgogne-Franche-Comté;70;2;17;111;Calmoutier;266;4;270
27;Bourgogne-Franche-Comté;70;2;05;112;Cemboing;180;5;185
27;Bourgogne-Franche-Comté;70;2;12;113;Cenans;125;3;128
27;Bourgogne-Franche-Comté;70;2;05;114;Cendrecourt;207;2;209
27;Bourgogne-Franche-Comté;70;2;17;115;Cerre-lès-Noroy;233;6;239
27;Bourgogne-Franche-Comté;70;1;03;116;Chagey;634;12;646
27;Bourgogne-Franche-Comté;70;1;03;117;Châlonvillars;1248;34;1282
27;Bourgogne-Franche-Comté;70;2;12;118;Chambornay-lès-Bellevaux;185;3;188
27;Bourgogne-Franche-Comté;70;2;09;119;Chambornay-lès-Pin;361;12;373
27;Bourgogne-Franche-Comté;70;1;03;120;Champagney;3788;76;3864
27;Bourgogne-Franche-Comté;70;1;04;121;Champey;875;16;891
27;Bourgogne-Franche-Comté;70;2;01;122;Champlitte;1639;34;1673
27;Bourgogne-Franche-Comté;70;2;02;124;Champtonnay;101;1;102
27;Bourgogne-Franche-Comté;70;2;02;125;Champvans;180;2;182
27;Bourgogne-Franche-Comté;70;2;09;126;Chancey;200;6;206
27;Bourgogne-Franche-Comté;70;2;14;127;Chantes;119;9;128
27;Bourgogne-Franche-Comté;70;1;08;128;La Chapelle-lès-Luxeuil;382;9;391
27;Bourgogne-Franche-Comté;70;2;14;129;La Chapelle-Saint-Quillain;154;3;157
27;Bourgogne-Franche-Comté;70;2;09;130;Charcenne;336;9;345
27;Bourgogne-Franche-Comté;70;2;01;132;Chargey-lès-Gray;694;68;762
27;Bourgogne-Franche-Comté;70;2;05;133;Chargey-lès-Port;237;7;244
27;Bourgogne-Franche-Comté;70;2;15;134;Chariez;207;2;209
27;Bourgogne-Franche-Comté;70;2;05;135;Charmes-Saint-Valbert;38;1;39
27;Bourgogne-Franche-Comté;70;2;15;136;Charmoille;484;11;495
27;Bourgogne-Franche-Comté;70;2;12;137;Chassey-lès-Montbozon;217;9;226
27;Bourgogne-Franche-Comté;70;2;14;138;Chassey-lès-Scey;131;3;134
27;Bourgogne-Franche-Comté;70;1;06;140;Châteney;64;1;65
27;Bourgogne-Franche-Comté;70;1;06;141;Châtenois;118;2;120
27;Bourgogne-Franche-Comté;70;2;09;142;Chaumercenne;187;3;190
27;Bourgogne-Franche-Comté;70;2;05;143;Chauvirey-le-Châtel;123;4;127
27;Bourgogne-Franche-Comté;70;2;05;144;Chauvirey-le-Vieil;34;1;35
27;Bourgogne-Franche-Comté;70;2;12;145;Chaux-la-Lotière;454;10;464
27;Bourgogne-Franche-Comté;70;2;11;146;Chaux-lès-Port;159;4;163
27;Bourgogne-Franche-Comté;70;1;04;147;Chavanne;239;2;241
27;Bourgogne-Franche-Comté;70;2;14;148;Chemilly;88;1;89
27;Bourgogne-Franche-Comté;70;1;04;149;Chenebier;695;17;712
27;Bourgogne-Franche-Comté;70;2;09;150;Chenevrey-et-Morogne;308;2;310
27;Bourgogne-Franche-Comté;70;2;09;151;Chevigney;36;0;36
27;Bourgogne-Franche-Comté;70;2;09;152;Choye;453;37;490
27;Bourgogne-Franche-Comté;70;2;05;153;Cintrey;94;1;95
27;Bourgogne-Franche-Comté;70;2;12;154;Cirey;368;6;374
27;Bourgogne-Franche-Comté;70;1;08;155;Citers;778;14;792
27;Bourgogne-Franche-Comté;70;2;09;156;Citey;103;1;104
27;Bourgogne-Franche-Comté;70;1;03;157;Clairegoutte;379;4;383
27;Bourgogne-Franche-Comté;70;2;14;158;Clans;106;2;108
27;Bourgogne-Franche-Comté;70;2;12;159;Cognières;92;0;92
27;Bourgogne-Franche-Comté;70;1;04;160;Coisevaux;327;20;347
27;Bourgogne-Franche-Comté;70;2;17;162;Colombe-lès-Vesoul;460;14;474
27;Bourgogne-Franche-Comté;70;2;16;163;Colombier;452;5;457
27;Bourgogne-Franche-Comté;70;2;17;164;Colombotte;85;1;86
27;Bourgogne-Franche-Comté;70;2;05;165;Combeaufontaine;542;46;588
27;Bourgogne-Franche-Comté;70;2;16;166;Comberjon;161;6;167
27;Bourgogne-Franche-Comté;70;2;11;167;Conflandey;360;13;373
27;Bourgogne-Franche-Comté;70;1;13;168;Conflans-sur-Lanterne;623;18;641
27;Bourgogne-Franche-Comté;70;2;05;169;Confracourt;216;5;221
27;Bourgogne-Franche-Comté;70;2;11;170;Contréglise;118;2;120
27;Bourgogne-Franche-Comté;70;1;13;171;Corbenay;1282;30;1312
27;Bourgogne-Franche-Comté;70;1;10;172;La Corbière;106;1;107
27;Bourgogne-Franche-Comté;70;2;12;174;Cordonnet;142;2;144
27;Bourgogne-Franche-Comté;70;2;05;175;Cornot;139;4;143
27;Bourgogne-Franche-Comté;70;1;10;176;Corravillers;190;3;193
27;Bourgogne-Franche-Comté;70;2;05;177;Corre;596;18;614
27;Bourgogne-Franche-Comté;70;1;07;178;La Côte;519;12;531
27;Bourgogne-Franche-Comté;70;2;16;179;Coulevon;173;3;176
27;Bourgogne-Franche-Comté;70;1;17;180;Courchaton;449;10;459
27;Bourgogne-Franche-Comté;70;2;09;181;Courcuire;128;2;130
27;Bourgogne-Franche-Comté;70;1;04;182;Courmont;136;0;136
27;Bourgogne-Franche-Comté;70;2;01;183;Courtesoult-et-Gatey;61;0;61
27;Bourgogne-Franche-Comté;70;1;04;184;Couthenans;730;21;751
27;Bourgogne-Franche-Comté;70;2;02;185;Cresancey;181;9;190
27;Bourgogne-Franche-Comté;70;1;06;186;La Creuse;74;1;75
27;Bourgogne-Franche-Comté;70;1;17;187;Crevans-et-la-Chapelle-lès-Granges;264;3;267
27;Bourgogne-Franche-Comté;70;1;06;188;Creveney;57;1;58
27;Bourgogne-Franche-Comté;70;2;12;189;Cromary;245;4;249
27;Bourgogne-Franche-Comté;70;2;11;190;Cubry-lès-Faverney;178;3;181
27;Bourgogne-Franche-Comté;70;2;09;192;Cugney;205;2;207
27;Bourgogne-Franche-Comté;70;2;09;193;Cult;233;5;238
27;Bourgogne-Franche-Comté;70;1;11;194;Cuve;141;9;150
27;Bourgogne-Franche-Comté;70;1;06;195;Dambenoît-lès-Colombe;277;4;281
27;Bourgogne-Franche-Comté;70;1;11;196;Dampierre-lès-Conflans;260;9;269
27;Bourgogne-Franche-Comté;70;2;12;197;Dampierre-sur-Linotte;802;16;818
27;Bourgogne-Franche-Comté;70;2;01;198;Dampierre-sur-Salon;1263;26;1289
27;Bourgogne-Franche-Comté;70;2;17;199;Dampvalley-lès-Colombe;113;0;113
27;Bourgogne-Franche-Comté;70;1;11;200;Dampvalley-Saint-Pancras;32;1;33
27;Bourgogne-Franche-Comté;70;2;01;201;Delain;219;1;220
27;Bourgogne-Franche-Comté;70;1;05;202;Demangevelle;278;7;285
27;Bourgogne-Franche-Comté;70;2;17;203;La Demie;142;3;145
27;Bourgogne-Franche-Comté;70;2;01;204;Denèvre;165;4;169
27;Bourgogne-Franche-Comté;70;1;03;205;Échavanne;205;2;207
27;Bourgogne-Franche-Comté;70;1;03;206;Échenans-sous-Mont-Vaudois;522;7;529
27;Bourgogne-Franche-Comté;70;2;15;207;Échenoz-la-Méline;3231;75;3306
27;Bourgogne-Franche-Comté;70;2;12;208;Échenoz-le-Sec;298;5;303
27;Bourgogne-Franche-Comté;70;1;10;210;Écromagny;158;5;163
27;Bourgogne-Franche-Comté;70;2;01;211;Écuelle;70;2;72
27;Bourgogne-Franche-Comté;70;1;13;213;Éhuns;234;4;238
27;Bourgogne-Franche-Comté;70;2;11;214;Équevilley;123;6;129
27;Bourgogne-Franche-Comté;70;1;03;215;Errevet;248;11;259
27;Bourgogne-Franche-Comté;70;1;08;216;Esboz-Brest;428;23;451
27;Bourgogne-Franche-Comté;70;1;10;217;Esmoulières;97;1;98
27;Bourgogne-Franche-Comté;70;2;02;218;Esmoulins;136;1;137
27;Bourgogne-Franche-Comté;70;1;17;219;Esprels;733;16;749
27;Bourgogne-Franche-Comté;70;2;02;220;Essertenne-et-Cecey;411;6;417
27;Bourgogne-Franche-Comté;70;1;04;221;Étobon;288;5;293
27;Bourgogne-Franche-Comté;70;2;14;222;Étrelles-et-la-Montbleuse;77;1;78
27;Bourgogne-Franche-Comté;70;2;09;224;Étuz;666;14;680
27;Bourgogne-Franche-Comté;70;2;01;225;Fahy-lès-Autrey;112;6;118
27;Bourgogne-Franche-Comté;70;1;17;226;Fallon;313;4;317
27;Bourgogne-Franche-Comté;70;1;10;227;Faucogney-et-la-Mer;530;15;545
27;Bourgogne-Franche-Comté;70;2;11;228;Faverney;961;14;975
27;Bourgogne-Franche-Comté;70;1;07;229;Faymont;262;7;269
27;Bourgogne-Franche-Comté;70;2;01;230;Fédry;97;4;101
27;Bourgogne-Franche-Comté;70;2;01;231;Ferrières-lès-Ray;33;2;35
27;Bourgogne-Franche-Comté;70;2;14;232;Ferrières-lès-Scey;124;5;129
27;Bourgogne-Franche-Comté;70;1;10;233;Les Fessey;136;2;138
27;Bourgogne-Franche-Comté;70;2;12;234;Filain;235;5;240
27;Bourgogne-Franche-Comté;70;2;11;235;Flagy;156;2;158
27;Bourgogne-Franche-Comté;70;2;11;236;Fleurey-lès-Faverney;466;9;475
27;Bourgogne-Franche-Comté;70;2;01;237;Fleurey-lès-Lavoncourt;99;0;99
27;Bourgogne-Franche-Comté;70;1;13;238;Fleurey-lès-Saint-Loup;134;4;138
27;Bourgogne-Franche-Comté;70;2;12;239;Fondremand;198;6;204
27;Bourgogne-Franche-Comté;70;1;13;240;Fontaine-lès-Luxeuil;1351;29;1380
27;Bourgogne-Franche-Comté;70;1;11;242;Fontenois-la-Ville;135;0;135
27;Bourgogne-Franche-Comté;70;2;12;243;Fontenois-lès-Montbozon;328;10;338
27;Bourgogne-Franche-Comté;70;2;05;244;Fouchécourt;110;0;110
27;Bourgogne-Franche-Comté;70;1;88;245;Fougerolles-Saint-Valbert;3803;128;3931
27;Bourgogne-Franche-Comté;70;2;01;247;Fouvent-Saint-Andoche;214;3;217
27;Bourgogne-Franche-Comté;70;1;03;248;Frahier-et-Chatebier;1378;25;1403
27;Bourgogne-Franche-Comté;70;2;01;252;Framont;176;3;179
27;Bourgogne-Franche-Comté;70;1;13;249;Francalmont;120;3;123
27;Bourgogne-Franche-Comté;70;1;06;250;Franchevelle;428;7;435
27;Bourgogne-Franche-Comté;70;2;01;251;Francourt;101;4;105
27;Bourgogne-Franche-Comté;70;2;14;253;Frasne-le-Château;292;28;320
27;Bourgogne-Franche-Comté;70;1;03;254;Frédéric-Fontaine;258;8;266
27;Bourgogne-Franche-Comté;70;2;14;255;Fresne-Saint-Mamès;505;4;509
27;Bourgogne-Franche-Comté;70;1;10;256;Fresse;721;13;734
27;Bourgogne-Franche-Comté;70;2;14;257;Fretigney-et-Velloreille;735;7;742
27;Bourgogne-Franche-Comté;70;1;08;258;Froideconche;1980;47;2027
27;Bourgogne-Franche-Comté;70;1;06;259;Froideterre;371;12;383
27;Bourgogne-Franche-Comté;70;1;07;260;Frotey-lès-Lure;691;21;712
27;Bourgogne-Franche-Comté;70;2;16;261;Frotey-lès-Vesoul;1411;34;1445
27;Bourgogne-Franche-Comté;70;1;07;262;Genevreuille;165;4;169
27;Bourgogne-Franche-Comté;70;1;06;263;Genevrey;243;2;245
27;Bourgogne-Franche-Comté;70;1;17;264;Georfans;59;0;59
27;Bourgogne-Franche-Comté;70;2;02;265;Germigney;161;5;166
27;Bourgogne-Franche-Comté;70;2;05;267;Gevigney-et-Mercey;482;7;489
27;Bourgogne-Franche-Comté;70;2;09;268;Gézier-et-Fontenelay;211;3;214
27;Bourgogne-Franche-Comté;70;1;11;269;Girefontaine;37;0;37
27;Bourgogne-Franche-Comté;70;1;17;271;Gouhenans;388;10;398
27;Bourgogne-Franche-Comté;70;2;05;272;Gourgeon;208;13;221
27;Bourgogne-Franche-Comté;70;1;17;273;Grammont;66;1;67
27;Bourgogne-Franche-Comté;70;2;09;443;La Grande-Résie;86;1;87
27;Bourgogne-Franche-Comté;70;2;01;274;Grandecourt;48;0;48
27;Bourgogne-Franche-Comté;70;2;14;275;Grandvelle-et-le-Perrenot;371;5;376
27;Bourgogne-Franche-Comté;70;1;17;276;Granges-la-Ville;185;8;193
27;Bourgogne-Franche-Comté;70;1;17;277;Granges-le-Bourg;387;10;397
27;Bourgogne-Franche-Comté;70;2;11;278;Grattery;213;4;217
27;Bourgogne-Franche-Comté;70;2;02;279;Gray;5512;404;5916
27;Bourgogne-Franche-Comté;70;2;02;280;Gray-la-Ville;955;37;992
27;Bourgogne-Franche-Comté;70;2;09;282;Gy;1049;21;1070
27;Bourgogne-Franche-Comté;70;1;10;283;Haut-du-Them-Château-Lambert;434;9;443
27;Bourgogne-Franche-Comté;70;1;13;284;Hautevelle;267;9;276
27;Bourgogne-Franche-Comté;70;1;97;285;Héricourt;10601;280;10881
27;Bourgogne-Franche-Comté;70;2;09;286;Hugier;128;3;131
27;Bourgogne-Franche-Comté;70;1;05;287;Hurecourt;40;2;42
27;Bourgogne-Franche-Comté;70;2;12;288;Hyet;124;0;124
27;Bourgogne-Franche-Comté;70;2;02;289;Igny;200;2;202
27;Bourgogne-Franche-Comté;70;1;11;290;Jasney;233;10;243
27;Bourgogne-Franche-Comté;70;2;05;291;Jonvelle;126;2;128
27;Bourgogne-Franche-Comté;70;2;05;292;Jussey;1613;43;1656
27;Bourgogne-Franche-Comté;70;2;05;293;Lambrey;83;2;85
27;Bourgogne-Franche-Comté;70;1;10;294;Lantenot;353;5;358
27;Bourgogne-Franche-Comté;70;1;10;295;La Lanterne-et-les-Armonts;215;5;220
27;Bourgogne-Franche-Comté;70;2;12;296;Larians-et-Munans;260;2;262
27;Bourgogne-Franche-Comté;70;2;01;297;Larret;60;3;63
27;Bourgogne-Franche-Comté;70;2;05;298;Lavigney;121;0;121
27;Bourgogne-Franche-Comté;70;2;01;299;Lavoncourt;309;4;313
27;Bourgogne-Franche-Comté;70;2;14;301;Lieffrans;62;0;62
27;Bourgogne-Franche-Comté;70;2;09;302;Lieucourt;77;1;78
27;Bourgogne-Franche-Comté;70;2;17;303;Liévans;148;2;150
27;Bourgogne-Franche-Comté;70;1;06;304;Linexert;128;1;129
27;Bourgogne-Franche-Comté;70;1;07;306;Lomont;443;4;447
27;Bourgogne-Franche-Comté;70;1;17;307;Longevelle;125;7;132
27;Bourgogne-Franche-Comté;70;1;10;308;La Longine;226;7;233
27;Bourgogne-Franche-Comté;70;2;12;309;Loulans-Verchamp;453;15;468
27;Bourgogne-Franche-Comté;70;1;98;310;Lure;8207;202;8409
27;Bourgogne-Franche-Comté;70;1;08;311;Luxeuil-les-Bains;6722;286;7008
27;Bourgogne-Franche-Comté;70;1;03;312;Luze;707;22;729
27;Bourgogne-Franche-Comté;70;1;07;313;Lyoffans;375;5;380
27;Bourgogne-Franche-Comté;70;2;01;305;Lœuilley;104;2;106
27;Bourgogne-Franche-Comté;70;1;10;314;Magnivray;168;8;176
27;Bourgogne-Franche-Comté;70;1;13;315;Magnoncourt;418;13;431
27;Bourgogne-Franche-Comté;70;2;12;316;Le Magnoray;89;4;93
27;Bourgogne-Franche-Comté;70;1;17;317;Les Magny;139;4;143
27;Bourgogne-Franche-Comté;70;1;07;318;Magny-Danigon;439;15;454
27;Bourgogne-Franche-Comté;70;1;07;319;Magny-Jobert;110;1;111
27;Bourgogne-Franche-Comté;70;2;05;320;Magny-lès-Jussey;103;0;103
27;Bourgogne-Franche-Comté;70;1;07;321;Magny-Vernois;1376;31;1407
27;Bourgogne-Franche-Comté;70;1;13;322;Mailleroncourt-Charette;279;6;285
27;Bourgogne-Franche-Comté;70;1;11;323;Mailleroncourt-Saint-Pancras;192;1;193
27;Bourgogne-Franche-Comté;70;2;14;324;Mailley-et-Chazelot;649;14;663
27;Bourgogne-Franche-Comté;70;2;12;325;Maizières;363;29;392
27;Bourgogne-Franche-Comté;70;2;12;326;La Malachère;307;4;311
27;Bourgogne-Franche-Comté;70;2;09;327;Malans;134;4;138
27;Bourgogne-Franche-Comté;70;1;06;328;Malbouhans;335;4;339
27;Bourgogne-Franche-Comté;70;2;05;329;Malvillers;63;4;67
27;Bourgogne-Franche-Comté;70;1;03;330;Mandrevillars;242;7;249
27;Bourgogne-Franche-Comté;70;2;02;331;Mantoche;448;20;468
27;Bourgogne-Franche-Comté;70;1;17;332;Marast;55;1;56
27;Bourgogne-Franche-Comté;70;2;09;334;Marnay;1481;22;1503
27;Bourgogne-Franche-Comté;70;2;12;335;Maussans;67;1;68
27;Bourgogne-Franche-Comté;70;1;17;336;Mélecey;144;3;147
27;Bourgogne-Franche-Comté;70;2;05;337;Melin;58;2;60
27;Bourgogne-Franche-Comté;70;1;11;338;Melincourt;237;3;240
27;Bourgogne-Franche-Comté;70;1;10;339;Mélisey;1681;36;1717
27;Bourgogne-Franche-Comté;70;2;01;340;Membrey;217;31;248
27;Bourgogne-Franche-Comté;70;2;11;341;Menoux;301;5;306
27;Bourgogne-Franche-Comté;70;2;14;342;Mercey-sur-Saône;133;2;135
27;Bourgogne-Franche-Comté;70;2;11;343;Mersuay;289;5;294
27;Bourgogne-Franche-Comté;70;1;13;344;Meurcourt;330;10;340
27;Bourgogne-Franche-Comté;70;1;17;347;Mignavillers;339;5;344
27;Bourgogne-Franche-Comté;70;1;07;348;Moffans-et-Vacheresse;625;12;637
27;Bourgogne-Franche-Comté;70;1;17;349;Moimay;236;3;239
27;Bourgogne-Franche-Comté;70;2;05;350;Molay;67;0;67
27;Bourgogne-Franche-Comté;70;1;07;351;Mollans;234;3;237
27;Bourgogne-Franche-Comté;70;2;15;367;Mont-le-Vernois;171;3;174
27;Bourgogne-Franche-Comté;70;2;01;369;Mont-Saint-Léger;51;0;51
27;Bourgogne-Franche-Comté;70;1;10;352;La Montagne;37;0;37
27;Bourgogne-Franche-Comté;70;2;09;353;Montagney;514;8;522
27;Bourgogne-Franche-Comté;70;2;12;355;Montarlot-lès-Rioz;285;7;292
27;Bourgogne-Franche-Comté;70;2;09;356;Montboillon;270;6;276
27;Bourgogne-Franche-Comté;70;2;12;357;Montbozon;562;94;656
27;Bourgogne-Franche-Comté;70;2;16;358;Montcey;276;4;280
27;Bourgogne-Franche-Comté;70;2;05;359;Montcourt;55;0;55
27;Bourgogne-Franche-Comté;70;1;05;360;Montdoré;73;1;74
27;Bourgogne-Franche-Comté;70;1;10;361;Montessaux;162;6;168
27;Bourgogne-Franche-Comté;70;2;05;362;Montigny-lès-Cherlieu;157;6;163
27;Bourgogne-Franche-Comté;70;2;15;363;Montigny-lès-Vesoul;660;19;679
27;Bourgogne-Franche-Comté;70;2;17;364;Montjustin-et-Velotte;121;4;125
27;Bourgogne-Franche-Comté;70;2;01;368;Montot;132;3;135
27;Bourgogne-Franche-Comté;70;2;01;371;Montureux-et-Prantigny;208;1;209
27;Bourgogne-Franche-Comté;70;2;11;372;Montureux-lès-Baulay;156;4;160
27;Bourgogne-Franche-Comté;70;2;09;374;Motey-Besuche;103;2;105
27;Bourgogne-Franche-Comté;70;2;02;376;Nantilly;481;10;491
27;Bourgogne-Franche-Comté;70;2;16;378;Navenne;1660;57;1717
27;Bourgogne-Franche-Comté;70;2;13;380;Neurey-en-Vaux;176;6;182
27;Bourgogne-Franche-Comté;70;2;17;381;Neurey-lès-la-Demie;328;11;339
27;Bourgogne-Franche-Comté;70;2;12;383;Neuvelle-lès-Cromary;403;5;408
27;Bourgogne-Franche-Comté;70;2;14;384;Neuvelle-lès-la-Charité;225;5;230
27;Bourgogne-Franche-Comté;70;1;06;385;La Neuvelle-lès-Lure;333;9;342
27;Bourgogne-Franche-Comté;70;2;05;386;La Neuvelle-lès-Scey;187;7;194
27;Bourgogne-Franche-Comté;70;2;14;387;Noidans-le-Ferroux;687;10;697
27;Bourgogne-Franche-Comté;70;2;15;388;Noidans-lès-Vesoul;1992;68;2060
27;Bourgogne-Franche-Comté;70;2;02;389;Noiron;57;1;58
27;Bourgogne-Franche-Comté;70;2;17;390;Noroy-le-Bourg;497;11;508
27;Bourgogne-Franche-Comté;70;2;05;392;Oigney;41;2;43
27;Bourgogne-Franche-Comté;70;2;14;393;Oiselay-et-Grachaux;422;6;428
27;Bourgogne-Franche-Comté;70;2;02;394;Onay;60;4;64
27;Bourgogne-Franche-Comté;70;1;17;395;Oppenans;53;1;54
27;Bourgogne-Franche-Comté;70;1;17;396;Oricourt;38;1;39
27;Bourgogne-Franche-Comté;70;2;12;397;Ormenans;77;0;77
27;Bourgogne-Franche-Comté;70;1;08;398;Ormoiche;65;4;69
27;Bourgogne-Franche-Comté;70;2;05;399;Ormoy;215;7;222
27;Bourgogne-Franche-Comté;70;2;05;400;Ouge;102;3;105
27;Bourgogne-Franche-Comté;70;2;14;401;Ovanches;133;1;134
27;Bourgogne-Franche-Comté;70;2;01;402;Oyrières;381;11;392
27;Bourgogne-Franche-Comté;70;1;07;403;Palante;239;4;243
27;Bourgogne-Franche-Comté;70;1;05;404;Passavant-la-Rochère;603;19;622
27;Bourgogne-Franche-Comté;70;2;12;405;Pennesières;193;4;197
27;Bourgogne-Franche-Comté;70;2;01;406;Percey-le-Grand;83;1;84
27;Bourgogne-Franche-Comté;70;2;12;407;Perrouse;267;6;273
27;Bourgogne-Franche-Comté;70;2;09;408;Pesmes;1084;29;1113
27;Bourgogne-Franche-Comté;70;2;01;409;Pierrecourt;113;2;115
27;Bourgogne-Franche-Comté;70;2;09;410;Pin;700;4;704
27;Bourgogne-Franche-Comté;70;1;11;411;La Pisseure;37;0;37
27;Bourgogne-Franche-Comté;70;1;11;412;Plainemont;68;0;68
27;Bourgogne-Franche-Comté;70;1;03;413;Plancher-Bas;1965;36;2001
27;Bourgogne-Franche-Comté;70;1;03;414;Plancher-les-Mines;975;15;990
27;Bourgogne-Franche-Comté;70;2;11;415;Polaincourt-et-Clairefontaine;734;9;743
27;Bourgogne-Franche-Comté;70;1;07;416;Pomoy;210;7;217
27;Bourgogne-Franche-Comté;70;1;05;419;Pont-du-Bois;108;5;113
27;Bourgogne-Franche-Comté;70;1;17;420;Pont-sur-l'Ognon;67;0;67
27;Bourgogne-Franche-Comté;70;2;14;417;Pontcey;324;9;333
27;Bourgogne-Franche-Comté;70;2;11;421;Port-sur-Saône;2971;57;3028
27;Bourgogne-Franche-Comté;70;2;01;422;Poyans;146;1;147
27;Bourgogne-Franche-Comté;70;2;05;423;Preigney;108;1;109
27;Bourgogne-Franche-Comté;70;1;10;425;La Proiselière-et-Langle;146;6;152
27;Bourgogne-Franche-Comté;70;2;11;426;Provenchère;260;7;267
27;Bourgogne-Franche-Comté;70;2;05;427;Purgerot;342;9;351
27;Bourgogne-Franche-Comté;70;2;15;428;Pusey;1474;50;1524
27;Bourgogne-Franche-Comté;70;2;15;429;Pusy-et-Épenoux;552;12;564
27;Bourgogne-Franche-Comté;70;2;05;430;La Quarte;66;1;67
27;Bourgogne-Franche-Comté;70;2;12;431;Quenoche;249;3;252
27;Bourgogne-Franche-Comté;70;1;06;432;Quers;345;7;352
27;Bourgogne-Franche-Comté;70;2;16;433;Quincey;1399;39;1438
27;Bourgogne-Franche-Comté;70;1;10;435;Raddon-et-Chapendu;861;23;884
27;Bourgogne-Franche-Comté;70;2;05;436;Raincourt;121;0;121
27;Bourgogne-Franche-Comté;70;2;05;437;Ranzevelle;17;0;17
27;Bourgogne-Franche-Comté;70;2;01;438;Ray-sur-Saône;210;3;213
27;Bourgogne-Franche-Comté;70;2;14;439;Raze;352;7;359
27;Bourgogne-Franche-Comté;70;2;01;440;Recologne;32;2;34
27;Bourgogne-Franche-Comté;70;2;12;441;Recologne-lès-Rioz;249;3;252
27;Bourgogne-Franche-Comté;70;2;01;442;Renaucourt;105;4;109
27;Bourgogne-Franche-Comté;70;2;09;444;La Résie-Saint-Martin;158;2;160
27;Bourgogne-Franche-Comté;70;1;10;445;Rignovelle;112;0;112
27;Bourgogne-Franche-Comté;70;2;01;446;Rigny;595;10;605
27;Bourgogne-Franche-Comté;70;2;12;447;Rioz;2270;90;2360
27;Bourgogne-Franche-Comté;70;2;01;448;Roche-et-Raucourt;160;2;162
27;Bourgogne-Franche-Comté;70;2;05;373;La Roche-Morey;281;4;285
27;Bourgogne-Franche-Comté;70;2;12;449;Roche-sur-Linotte-et-Sorans-les-Cordiers;66;0;66
27;Bourgogne-Franche-Comté;70;2;05;450;La Rochelle;39;0;39
27;Bourgogne-Franche-Comté;70;2;14;418;La Romaine;511;4;515
27;Bourgogne-Franche-Comté;70;1;06;451;Ronchamp;2757;31;2788
27;Bourgogne-Franche-Comté;70;2;14;452;Rosey;268;3;271
27;Bourgogne-Franche-Comté;70;1;10;453;La Rosière;80;3;83
27;Bourgogne-Franche-Comté;70;2;05;454;Rosières-sur-Mance;49;2;51
27;Bourgogne-Franche-Comté;70;1;07;455;Roye;1553;29;1582
27;Bourgogne-Franche-Comté;70;2;12;456;Ruhans;155;5;160
27;Bourgogne-Franche-Comté;70;2;14;457;Rupt-sur-Saône;111;5;116
27;Bourgogne-Franche-Comté;70;1;10;459;Saint-Barthélemy;1115;29;1144
27;Bourgogne-Franche-Comté;70;1;10;460;Saint-Bresson;439;10;449
27;Bourgogne-Franche-Comté;70;2;02;461;Saint-Broing;115;3;118
27;Bourgogne-Franche-Comté;70;1;17;462;Saint-Ferjeux;78;2;80
27;Bourgogne-Franche-Comté;70;2;14;463;Saint-Gand;137;1;138
27;Bourgogne-Franche-Comté;70;1;06;464;Saint-Germain;1344;25;1369
27;Bourgogne-Franche-Comté;70;2;02;466;Saint-Loup-Nantouard;122;3;125
27;Bourgogne-Franche-Comté;70;1;13;467;Saint-Loup-sur-Semouse;3221;80;3301
27;Bourgogne-Franche-Comté;70;2;05;468;Saint-Marcel;93;1;94
27;Bourgogne-Franche-Comté;70;2;11;472;Saint-Rémy-en-Comté;571;5;576
27;Bourgogne-Franche-Comté;70;1;08;473;Saint-Sauveur;1920;43;1963
27;Bourgogne-Franche-Comté;70;1;17;474;Saint-Sulpice;131;2;133
27;Bourgogne-Franche-Comté;70;1;10;469;Sainte-Marie-en-Chanois;216;5;221
27;Bourgogne-Franche-Comté;70;1;13;470;Sainte-Marie-en-Chaux;161;3;164
27;Bourgogne-Franche-Comté;70;2;14;471;Sainte-Reine;31;1;32
27;Bourgogne-Franche-Comté;70;2;11;476;Saponcourt;64;1;65
27;Bourgogne-Franche-Comté;70;1;04;477;Saulnot;752;13;765
27;Bourgogne-Franche-Comté;70;1;06;478;Saulx;898;16;914
27;Bourgogne-Franche-Comté;70;2;02;479;Sauvigney-lès-Gray;102;4;106
27;Bourgogne-Franche-Comté;70;2;09;480;Sauvigney-lès-Pesmes;139;7;146
27;Bourgogne-Franche-Comté;70;2;01;481;Savoyeux;210;4;214
27;Bourgogne-Franche-Comté;70;2;14;482;Scey-sur-Saône-et-Saint-Albin;1545;26;1571
27;Bourgogne-Franche-Comté;70;2;11;483;Scye;135;4;139
27;Bourgogne-Franche-Comté;70;1;17;484;Secenans;178;3;181
27;Bourgogne-Franche-Comté;70;1;05;485;Selles;204;7;211
27;Bourgogne-Franche-Comté;70;2;05;486;Semmadon;116;3;119
27;Bourgogne-Franche-Comté;70;1;17;487;Senargent-Mignafans;295;3;298
27;Bourgogne-Franche-Comté;70;2;11;488;Senoncourt;196;1;197
27;Bourgogne-Franche-Comté;70;1;10;489;Servance-Miellin;816;32;848
27;Bourgogne-Franche-Comté;70;1;06;490;Servigney;122;0;122
27;Bourgogne-Franche-Comté;70;2;14;491;Seveux-Motey;488;6;494
27;Bourgogne-Franche-Comté;70;2;14;492;Soing-Cubry-Charentenay;570;10;580
27;Bourgogne-Franche-Comté;70;2;12;493;Sorans-lès-Breurey;441;7;448
27;Bourgogne-Franche-Comté;70;2;09;494;Sornay;337;6;343
27;Bourgogne-Franche-Comté;70;2;05;496;Tartécourt;27;1;28
27;Bourgogne-Franche-Comté;70;1;10;498;Ternuay-Melay-et-Saint-Hilaire;487;14;501
27;Bourgogne-Franche-Comté;70;2;01;499;Theuley;104;2;106
27;Bourgogne-Franche-Comté;70;2;12;500;Thieffrans;173;11;184
27;Bourgogne-Franche-Comté;70;2;12;501;Thiénans;93;3;96
27;Bourgogne-Franche-Comté;70;2;01;502;Tincey-et-Pontrebeau;86;1;87
27;Bourgogne-Franche-Comté;70;2;12;503;Traitiéfontaine;162;2;164
27;Bourgogne-Franche-Comté;70;2;14;504;Traves;362;13;375
27;Bourgogne-Franche-Comté;70;2;02;505;Le Tremblois;176;9;185
27;Bourgogne-Franche-Comté;70;1;04;506;Trémoins;386;13;399
27;Bourgogne-Franche-Comté;70;2;12;507;Trésilley;221;7;228
27;Bourgogne-Franche-Comté;70;2;09;509;Tromarey;101;1;102
27;Bourgogne-Franche-Comté;70;2;09;510;Vadans;134;3;137
27;Bourgogne-Franche-Comté;70;2;01;511;Vaite;218;4;222
27;Bourgogne-Franche-Comté;70;1;13;512;La Vaivre;216;5;221
27;Bourgogne-Franche-Comté;70;2;15;513;Vaivre-et-Montoille;2417;60;2477
27;Bourgogne-Franche-Comté;70;1;07;515;Le Val-de-Gouhenans;66;1;67
27;Bourgogne-Franche-Comté;70;2;11;518;Le Val-Saint-Éloi;100;2;102
27;Bourgogne-Franche-Comté;70;2;09;514;Valay;693;11;704
27;Bourgogne-Franche-Comté;70;2;17;516;Vallerois-le-Bois;256;4;260
27;Bourgogne-Franche-Comté;70;2;17;517;Vallerois-Lorioz;370;18;388
27;Bourgogne-Franche-Comté;70;2;12;519;Vandelans;111;0;111
27;Bourgogne-Franche-Comté;70;2;01;520;Vanne;103;3;106
27;Bourgogne-Franche-Comté;70;2;09;521;Vantoux-et-Longevelle;181;4;185
27;Bourgogne-Franche-Comté;70;2;16;522;Varogne;146;4;150
27;Bourgogne-Franche-Comté;70;2;01;523;Vars;203;3;206
27;Bourgogne-Franche-Comté;70;2;11;524;Vauchoux;111;3;114
27;Bourgogne-Franche-Comté;70;2;01;525;Vauconcourt-Nervezain;215;3;218
27;Bourgogne-Franche-Comté;70;1;05;526;Vauvillers;660;15;675
27;Bourgogne-Franche-Comté;70;2;14;527;Vaux-le-Moncelot;70;0;70
27;Bourgogne-Franche-Comté;70;2;02;528;Velesmes-Échevanne;485;10;495
27;Bourgogne-Franche-Comté;70;2;02;529;Velet;393;15;408
27;Bourgogne-Franche-Comté;70;2;14;536;Velle-le-Châtel;132;2;134
27;Bourgogne-Franche-Comté;70;1;17;530;Vellechevreux-et-Courbenans;128;0;128
27;Bourgogne-Franche-Comté;70;2;09;531;Velleclaire;109;2;111
27;Bourgogne-Franche-Comté;70;2;12;532;Vellefaux;499;7;506
27;Bourgogne-Franche-Comté;70;2;09;533;Vellefrey-et-Vellefrange;121;0;121
27;Bourgogne-Franche-Comté;70;2;16;534;Vellefrie;127;1;128
27;Bourgogne-Franche-Comté;70;2;14;535;Velleguindry-et-Levrecey;156;1;157
27;Bourgogne-Franche-Comté;70;1;06;537;Velleminfroy;298;6;304
27;Bourgogne-Franche-Comté;70;2;14;538;Vellemoz;82;0;82
27;Bourgogne-Franche-Comté;70;2;14;539;Vellexon-Queutrey-et-Vaudey;453;13;466
27;Bourgogne-Franche-Comté;70;2;09;540;Velloreille-lès-Choye;78;4;82
27;Bourgogne-Franche-Comté;70;1;13;541;Velorcey;209;4;213
27;Bourgogne-Franche-Comté;70;2;09;542;Venère;218;5;223
27;Bourgogne-Franche-Comté;70;2;11;545;Venisey;136;3;139
27;Bourgogne-Franche-Comté;70;2;01;546;Vereux;227;23;250
27;Bourgogne-Franche-Comté;70;1;17;544;La Vergenne;118;2;120
27;Bourgogne-Franche-Comté;70;1;04;547;Verlans;174;3;177
27;Bourgogne-Franche-Comté;70;2;05;548;Vernois-sur-Mance;146;1;147
27;Bourgogne-Franche-Comté;70;2;14;549;La Vernotte;76;1;77
27;Bourgogne-Franche-Comté;70;2;99;550;Vesoul;14916;812;15728
27;Bourgogne-Franche-Comté;70;1;17;552;Villafans;211;4;215
27;Bourgogne-Franche-Comté;70;1;17;553;Villargent;120;2;122
27;Bourgogne-Franche-Comté;70;2;05;554;Villars-le-Pautel;193;2;195
27;Bourgogne-Franche-Comté;70;1;13;555;La Villedieu-en-Fontenette;176;2;178
27;Bourgogne-Franche-Comté;70;2;09;557;Villefrancon;140;2;142
27;Bourgogne-Franche-Comté;70;2;16;558;La Villeneuve-Bellenoye-et-la-Maize;139;2;141
27;Bourgogne-Franche-Comté;70;2;16;559;Villeparois;206;5;211
27;Bourgogne-Franche-Comté;70;2;12;560;Villers-Bouton;162;2;164
27;Bourgogne-Franche-Comté;70;2;09;366;Villers-Chemin-et-Mont-lès-Étrelles;123;0;123
27;Bourgogne-Franche-Comté;70;1;17;562;Villers-la-Ville;146;3;149
27;Bourgogne-Franche-Comté;70;2;17;563;Villers-le-Sec;531;13;544
27;Bourgogne-Franche-Comté;70;1;13;564;Villers-lès-Luxeuil;303;11;314
27;Bourgogne-Franche-Comté;70;2;12;565;Villers-Pater;51;2;53
27;Bourgogne-Franche-Comté;70;2;11;566;Villers-sur-Port;208;5;213
27;Bourgogne-Franche-Comté;70;1;04;567;Villers-sur-Saulnot;133;0;133
27;Bourgogne-Franche-Comté;70;2;01;568;Villers-Vaudey;58;4;62
27;Bourgogne-Franche-Comté;70;1;17;561;Villersexel;1441;106;1547
27;Bourgogne-Franche-Comté;70;2;16;569;Vilory;65;1;66
27;Bourgogne-Franche-Comté;70;1;13;571;Visoncourt;40;2;42
27;Bourgogne-Franche-Comté;70;2;05;572;Vitrey-sur-Mance;277;7;284
27;Bourgogne-Franche-Comté;70;1;10;573;La Voivre;146;3;149
27;Bourgogne-Franche-Comté;70;2;01;574;Volon;60;0;60
27;Bourgogne-Franche-Comté;70;2;12;575;Voray-sur-l'Ognon;827;16;843
27;Bourgogne-Franche-Comté;70;2;05;576;Vougécourt;149;1;150
27;Bourgogne-Franche-Comté;70;1;07;577;Vouhenans;371;9;380
27;Bourgogne-Franche-Comté;70;2;09;578;Vregille;174;2;176
27;Bourgogne-Franche-Comté;70;2;14;580;Vy-le-Ferroux;156;5;161
27;Bourgogne-Franche-Comté;70;2;12;583;Vy-lès-Filain;126;1;127
27;Bourgogne-Franche-Comté;70;1;07;581;Vy-lès-Lure;676;18;694
27;Bourgogne-Franche-Comté;70;2;14;582;Vy-lès-Rupt;90;0;90
27;Bourgogne-Franche-Comté;70;1;04;579;Vyans-le-Val;453;17;470
27;Bourgogne-Franche-Comté;71;4;14;001;L' Abergement-de-Cuisery;797;15;812
27;Bourgogne-Franche-Comté;71;4;24;002;L' Abergement-Sainte-Colombe;1224;20;1244
27;Bourgogne-Franche-Comté;71;2;16;003;Allerey-sur-Saône;802;6;808
27;Bourgogne-Franche-Comté;71;2;24;004;Allériot;1145;25;1170
27;Bourgogne-Franche-Comté;71;2;04;005;Aluze;251;10;261
27;Bourgogne-Franche-Comté;71;3;10;006;Amanzé;176;8;184
27;Bourgogne-Franche-Comté;71;5;11;007;Ameugny;172;4;176
27;Bourgogne-Franche-Comté;71;3;10;008;Anglure-sous-Dun;156;7;163
27;Bourgogne-Franche-Comté;71;1;01;009;Anost;730;14;744
27;Bourgogne-Franche-Comté;71;1;02;010;Antully;854;10;864
27;Bourgogne-Franche-Comté;71;3;25;011;Anzy-le-Duc;472;87;559
27;Bourgogne-Franche-Comté;71;3;25;012;Artaix;327;14;341
27;Bourgogne-Franche-Comté;71;4;26;013;Authumes;252;5;257
27;Bourgogne-Franche-Comté;71;1;96;014;Autun;13290;1091;14381
27;Bourgogne-Franche-Comté;71;1;02;015;Auxy;934;29;963
27;Bourgogne-Franche-Comté;71;5;19;016;Azé;1046;27;1073
27;Bourgogne-Franche-Comté;71;3;09;017;Ballore;92;4;96
27;Bourgogne-Franche-Comté;71;4;14;018;Bantanges;549;10;559
27;Bourgogne-Franche-Comté;71;2;17;019;Barizey;144;7;151
27;Bourgogne-Franche-Comté;71;1;01;020;Barnay;100;2;102
27;Bourgogne-Franche-Comté;71;3;09;021;Baron;292;22;314
27;Bourgogne-Franche-Comté;71;3;10;022;Baudemont;640;9;649
27;Bourgogne-Franche-Comté;71;4;24;023;Baudrières;947;25;972
27;Bourgogne-Franche-Comté;71;3;25;024;Baugy;503;17;520
27;Bourgogne-Franche-Comté;71;3;09;025;Beaubery;367;8;375
27;Bourgogne-Franche-Comté;71;2;29;026;Beaumont-sur-Grosne;347;8;355
27;Bourgogne-Franche-Comté;71;4;26;027;Beaurepaire-en-Bresse;696;5;701
27;Bourgogne-Franche-Comté;71;4;26;028;Beauvernois;115;3;118
27;Bourgogne-Franche-Comté;71;4;26;029;Bellevesvre;282;4;286
27;Bourgogne-Franche-Comté;71;5;11;030;Bergesserin;205;4;209
27;Bourgogne-Franche-Comté;71;5;19;032;Berzé-la-Ville;676;15;691
27;Bourgogne-Franche-Comté;71;5;11;031;Berzé-le-Châtel;59;2;61
27;Bourgogne-Franche-Comté;71;2;16;033;Bey;845;15;860
27;Bourgogne-Franche-Comté;71;2;17;034;Bissey-sous-Cruchaud;341;7;348
27;Bourgogne-Franche-Comté;71;5;19;035;Bissy-la-Mâconnaise;205;3;208
27;Bourgogne-Franche-Comté;71;2;11;036;Bissy-sous-Uxelles;68;2;70
27;Bourgogne-Franche-Comté;71;2;17;037;Bissy-sur-Fley;89;6;95
27;Bourgogne-Franche-Comté;71;1;03;038;Les Bizots;465;12;477
27;Bourgogne-Franche-Comté;71;5;11;039;Blanot;177;1;178
27;Bourgogne-Franche-Comté;71;1;03;040;Blanzy;6146;140;6286
27;Bourgogne-Franche-Comté;71;3;10;041;Bois-Sainte-Marie;197;2;199
27;Bourgogne-Franche-Comté;71;5;11;042;Bonnay;325;7;332
27;Bourgogne-Franche-Comté;71;2;16;043;Les Bordes;85;3;88
27;Bourgogne-Franche-Comté;71;4;26;044;Bosjean;308;6;314
27;Bourgogne-Franche-Comté;71;4;26;045;Bouhans;175;6;181
27;Bourgogne-Franche-Comté;71;1;02;046;La Boulaye;100;1;101
27;Bourgogne-Franche-Comté;71;3;15;047;Bourbon-Lancy;4927;73;5000
27;Bourgogne-Franche-Comté;71;3;25;048;Bourg-le-Comte;181;2;183
27;Bourgogne-Franche-Comté;71;5;08;050;Bourgvilain;331;7;338
27;Bourgogne-Franche-Comté;71;2;04;051;Bouzeron;137;8;145
27;Bourgogne-Franche-Comté;71;2;29;052;Boyer;719;11;730
27;Bourgogne-Franche-Comté;71;2;16;054;Bragny-sur-Saône;652;13;665
27;Bourgogne-Franche-Comté;71;4;20;056;Branges;2357;34;2391
27;Bourgogne-Franche-Comté;71;5;11;057;Bray;122;1;123
27;Bourgogne-Franche-Comté;71;2;29;058;Bresse-sur-Grosne;186;11;197
27;Bourgogne-Franche-Comté;71;1;13;059;Le Breuil;3573;69;3642
27;Bourgogne-Franche-Comté;71;3;10;060;Briant;224;2;226
27;Bourgogne-Franche-Comté;71;4;14;061;Brienne;468;11;479
27;Bourgogne-Franche-Comté;71;1;02;062;Brion;299;8;307
27;Bourgogne-Franche-Comté;71;1;02;063;Broye;762;14;776
27;Bourgogne-Franche-Comté;71;4;20;064;Bruailles;990;14;1004
27;Bourgogne-Franche-Comté;71;5;11;065;Buffières;275;8;283
27;Bourgogne-Franche-Comté;71;5;19;066;Burgy;124;0;124
27;Bourgogne-Franche-Comté;71;2;11;067;Burnand;129;7;136
27;Bourgogne-Franche-Comté;71;5;11;068;Burzy;60;2;62
27;Bourgogne-Franche-Comté;71;5;19;069;Bussières;567;26;593
27;Bourgogne-Franche-Comté;71;2;17;070;Buxy;2136;85;2221
27;Bourgogne-Franche-Comté;71;1;01;509;La Celle-en-Morvan;481;6;487
27;Bourgogne-Franche-Comté;71;3;25;071;Céron;260;9;269
27;Bourgogne-Franche-Comté;71;2;17;072;Cersot;139;2;141
27;Bourgogne-Franche-Comté;71;2;04;073;Chagny;5543;73;5616
27;Bourgogne-Franche-Comté;71;5;08;074;Chaintré;584;16;600
27;Bourgogne-Franche-Comté;71;3;15;075;Chalmoux;636;11;647
27;Bourgogne-Franche-Comté;71;2;97;076;Chalon-sur-Saône;45096;1507;46603
27;Bourgogne-Franche-Comté;71;3;25;077;Chambilly;511;4;515
27;Bourgogne-Franche-Comté;71;2;04;078;Chamilly;158;3;161
27;Bourgogne-Franche-Comté;71;4;14;079;Champagnat;450;13;463
27;Bourgogne-Franche-Comté;71;2;29;080;Champagny-sous-Uxelles;97;0;97
27;Bourgogne-Franche-Comté;71;2;05;081;Champforgeuil;2534;54;2588
27;Bourgogne-Franche-Comté;71;3;09;082;Champlecy;223;3;226
27;Bourgogne-Franche-Comté;71;5;08;084;Chânes;538;11;549
27;Bourgogne-Franche-Comté;71;2;04;085;Change;219;11;230
27;Bourgogne-Franche-Comté;71;3;09;086;Changy;467;9;476
27;Bourgogne-Franche-Comté;71;2;11;087;Chapaize;157;1;158
27;Bourgogne-Franche-Comté;71;3;18;088;La Chapelle-au-Mans;227;10;237
27;Bourgogne-Franche-Comté;71;2;29;089;La Chapelle-de-Bragny;248;2;250
27;Bourgogne-Franche-Comté;71;5;08;090;La Chapelle-de-Guinchay;4121;52;4173
27;Bourgogne-Franche-Comté;71;5;08;091;La Chapelle-du-Mont-de-France;187;2;189
27;Bourgogne-Franche-Comté;71;4;20;092;La Chapelle-Naude;531;11;542
27;Bourgogne-Franche-Comté;71;4;26;093;La Chapelle-Saint-Sauveur;681;22;703
27;Bourgogne-Franche-Comté;71;5;29;094;La Chapelle-sous-Brancion;133;2;135
27;Bourgogne-Franche-Comté;71;3;10;095;La Chapelle-sous-Dun;448;9;457
27;Bourgogne-Franche-Comté;71;1;02;096;La Chapelle-sous-Uchon;188;2;190
27;Bourgogne-Franche-Comté;71;4;14;097;La Chapelle-Thècle;466;13;479
27;Bourgogne-Franche-Comté;71;1;02;098;Charbonnat;248;5;253
27;Bourgogne-Franche-Comté;71;5;19;099;Charbonnières;328;14;342
27;Bourgogne-Franche-Comté;71;5;29;100;Chardonnay;197;0;197
27;Bourgogne-Franche-Comté;71;4;26;101;Charette-Varennes;456;8;464
27;Bourgogne-Franche-Comté;71;2;27;102;La Charmée;695;24;719
27;Bourgogne-Franche-Comté;71;1;02;103;Charmoy;257;6;263
27;Bourgogne-Franche-Comté;71;2;16;104;Charnay-lès-Chalon;187;6;193
27;Bourgogne-Franche-Comté;71;5;21;105;Charnay-lès-Mâcon;7376;287;7663
27;Bourgogne-Franche-Comté;71;3;09;106;Charolles;2785;435;3220
27;Bourgogne-Franche-Comté;71;2;04;107;Charrecey;321;10;331
27;Bourgogne-Franche-Comté;71;5;08;108;Chasselas;170;5;175
27;Bourgogne-Franche-Comté;71;2;04;109;Chassey-le-Camp;344;2;346
27;Bourgogne-Franche-Comté;71;3;10;110;Chassigny-sous-Dun;572;11;583
27;Bourgogne-Franche-Comté;71;3;18;111;Chassy;313;11;324
27;Bourgogne-Franche-Comté;71;5;11;112;Château;219;10;229
27;Bourgogne-Franche-Comté;71;3;10;113;Châteauneuf;109;0;109
27;Bourgogne-Franche-Comté;71;2;17;115;Châtel-Moron;102;1;103
27;Bourgogne-Franche-Comté;71;3;10;116;Châtenay;165;2;167
27;Bourgogne-Franche-Comté;71;2;24;117;Châtenoy-en-Bresse;1109;31;1140
27;Bourgogne-Franche-Comté;71;2;07;118;Châtenoy-le-Royal;6177;139;6316
27;Bourgogne-Franche-Comté;71;2;04;119;Chaudenay;1112;24;1136
27;Bourgogne-Franche-Comté;71;3;10;120;Chauffailles;3708;69;3777
27;Bourgogne-Franche-Comté;71;4;26;121;La Chaux;302;9;311
27;Bourgogne-Franche-Comté;71;2;04;122;Cheilly-lès-Maranges;550;14;564
27;Bourgogne-Franche-Comté;71;3;25;123;Chenay-le-Châtel;382;4;386
27;Bourgogne-Franche-Comté;71;2;17;124;Chenôves;208;7;215
27;Bourgogne-Franche-Comté;71;5;11;125;Chérizet;20;0;20
27;Bourgogne-Franche-Comté;71;5;19;126;Chevagny-les-Chevrières;592;23;615
27;Bourgogne-Franche-Comté;71;5;11;127;Chevagny-sur-Guye;74;1;75
27;Bourgogne-Franche-Comté;71;5;11;128;Chiddes;93;5;98
27;Bourgogne-Franche-Comté;71;1;01;129;Chissey-en-Morvan;275;7;282
27;Bourgogne-Franche-Comté;71;5;11;130;Chissey-lès-Mâcon;237;6;243
27;Bourgogne-Franche-Comté;71;2;16;131;Ciel;769;12;781
27;Bourgogne-Franche-Comté;71;1;28;132;Ciry-le-Noble;2275;32;2307
27;Bourgogne-Franche-Comté;71;3;10;133;La Clayette;1656;72;1728
27;Bourgogne-Franche-Comté;71;5;19;135;Clessé;869;20;889
27;Bourgogne-Franche-Comté;71;3;18;136;Clessy;251;7;258
27;Bourgogne-Franche-Comté;71;5;11;137;Cluny;4830;268;5098
27;Bourgogne-Franche-Comté;71;2;16;578;Clux-Villeneuve;324;11;335
27;Bourgogne-Franche-Comté;71;2;03;139;Collonge-en-Charollais;141;1;142
27;Bourgogne-Franche-Comté;71;1;01;140;Collonge-la-Madeleine;47;0;47
27;Bourgogne-Franche-Comté;71;3;09;141;Colombier-en-Brionnais;308;5;313
27;Bourgogne-Franche-Comté;71;1;02;142;La Comelle;225;5;230
27;Bourgogne-Franche-Comté;71;4;14;143;Condal;441;8;449
27;Bourgogne-Franche-Comté;71;1;01;144;Cordesse;190;5;195
27;Bourgogne-Franche-Comté;71;2;11;145;Cormatin;557;9;566
27;Bourgogne-Franche-Comté;71;5;11;146;Cortambert;232;7;239
27;Bourgogne-Franche-Comté;71;5;11;147;Cortevaix;252;6;258
27;Bourgogne-Franche-Comté;71;3;10;148;Coublanc;834;15;849
27;Bourgogne-Franche-Comté;71;1;04;149;Couches;1351;30;1381
27;Bourgogne-Franche-Comté;71;5;08;150;Crêches-sur-Saône;2986;77;3063
27;Bourgogne-Franche-Comté;71;1;01;151;Créot;81;3;84
27;Bourgogne-Franche-Comté;71;3;18;152;Cressy-sur-Somme;186;9;195
27;Bourgogne-Franche-Comté;71;1;98;153;Le Creusot;21630;305;21935
27;Bourgogne-Franche-Comté;71;2;05;154;Crissey;2480;63;2543
27;Bourgogne-Franche-Comté;71;3;15;155;Cronat;535;15;550
27;Bourgogne-Franche-Comté;71;5;19;156;Cruzille;263;65;328
27;Bourgogne-Franche-Comté;71;4;14;157;Cuiseaux;1829;29;1858
27;Bourgogne-Franche-Comté;71;4;14;158;Cuisery;1538;25;1563
27;Bourgogne-Franche-Comté;71;2;17;159;Culles-les-Roches;197;8;205
27;Bourgogne-Franche-Comté;71;3;10;160;Curbigny;319;13;332
27;Bourgogne-Franche-Comté;71;3;18;161;Curdin;316;6;322
27;Bourgogne-Franche-Comté;71;1;01;162;Curgy;1145;44;1189
27;Bourgogne-Franche-Comté;71;5;11;163;Curtil-sous-Buffières;90;1;91
27;Bourgogne-Franche-Comté;71;2;11;164;Curtil-sous-Burnand;133;3;136
27;Bourgogne-Franche-Comté;71;1;01;165;Cussy-en-Morvan;388;9;397
27;Bourgogne-Franche-Comté;71;3;18;166;Cuzy;119;2;121
27;Bourgogne-Franche-Comté;71;2;16;167;Damerey;558;19;577
27;Bourgogne-Franche-Comté;71;4;26;168;Dampierre-en-Bresse;171;1;172
27;Bourgogne-Franche-Comté;71;5;08;169;Davayé;694;108;802
27;Bourgogne-Franche-Comté;71;2;16;170;Demigny;1794;40;1834
27;Bourgogne-Franche-Comté;71;2;04;171;Dennevy;306;9;315
27;Bourgogne-Franche-Comté;71;1;02;172;Dettey;80;1;81
27;Bourgogne-Franche-Comté;71;4;26;173;Devrouze;311;4;315
27;Bourgogne-Franche-Comté;71;2;04;174;Dezize-lès-Maranges;174;4;178
27;Bourgogne-Franche-Comté;71;4;26;175;Diconne;343;3;346
27;Bourgogne-Franche-Comté;71;3;15;176;Digoin;7817;243;8060
27;Bourgogne-Franche-Comté;71;4;14;177;Dommartin-lès-Cuiseaux;794;12;806
27;Bourgogne-Franche-Comté;71;5;08;178;Dompierre-les-Ormes;907;32;939
27;Bourgogne-Franche-Comté;71;3;18;179;Dompierre-sous-Sanvignes;79;1;80
27;Bourgogne-Franche-Comté;71;5;11;181;Donzy-le-Pertuis;167;4;171
27;Bourgogne-Franche-Comté;71;2;17;182;Dracy-le-Fort;1333;53;1386
27;Bourgogne-Franche-Comté;71;1;04;183;Dracy-lès-Couches;153;4;157
27;Bourgogne-Franche-Comté;71;1;01;184;Dracy-Saint-Loup;570;22;592
27;Bourgogne-Franche-Comté;71;3;09;185;Dyo;340;14;354
27;Bourgogne-Franche-Comté;71;2;16;186;Écuelles;273;5;278
27;Bourgogne-Franche-Comté;71;1;03;187;Écuisses;1583;33;1616
27;Bourgogne-Franche-Comté;71;1;01;188;Épertully;61;1;62
27;Bourgogne-Franche-Comté;71;2;27;189;Épervans;1613;51;1664
27;Bourgogne-Franche-Comté;71;1;01;190;Épinac;2217;25;2242
27;Bourgogne-Franche-Comté;71;1;04;191;Essertenne;475;9;484
27;Bourgogne-Franche-Comté;71;1;02;192;Étang-sur-Arroux;1858;151;2009
27;Bourgogne-Franche-Comté;71;2;29;193;Étrigny;474;12;486
27;Bourgogne-Franche-Comté;71;2;05;194;Farges-lès-Chalon;779;14;793
27;Bourgogne-Franche-Comté;71;5;29;195;Farges-lès-Mâcon;219;6;225
27;Bourgogne-Franche-Comté;71;4;20;196;Le Fay;639;8;647
27;Bourgogne-Franche-Comté;71;4;14;198;Flacey-en-Bresse;400;7;407
27;Bourgogne-Franche-Comté;71;5;11;199;Flagy;169;8;177
27;Bourgogne-Franche-Comté;71;5;19;591;Fleurville;519;8;527
27;Bourgogne-Franche-Comté;71;3;10;200;Fleury-la-Montagne;691;17;708
27;Bourgogne-Franche-Comté;71;2;17;201;Fley;211;8;219
27;Bourgogne-Franche-Comté;71;2;04;202;Fontaines;1948;363;2311
27;Bourgogne-Franche-Comté;71;3;09;203;Fontenay;45;1;46
27;Bourgogne-Franche-Comté;71;2;05;204;Fragnes-La Loyère;1496;41;1537
27;Bourgogne-Franche-Comté;71;4;26;205;Frangy-en-Bresse;621;10;631
27;Bourgogne-Franche-Comté;71;4;14;206;La Frette;241;4;245
27;Bourgogne-Franche-Comté;71;4;26;207;Fretterans;287;11;298
27;Bourgogne-Franche-Comté;71;4;26;208;Frontenard;223;3;226
27;Bourgogne-Franche-Comté;71;4;14;209;Frontenaud;729;13;742
27;Bourgogne-Franche-Comté;71;5;08;210;Fuissé;381;19;400
27;Bourgogne-Franche-Comté;71;1;28;212;Génelard;1372;32;1404
27;Bourgogne-Franche-Comté;71;4;14;213;La Genête;572;13;585
27;Bourgogne-Franche-Comté;71;2;03;214;Genouilly;427;13;440
27;Bourgogne-Franche-Comté;71;2;16;215;Gergy;2545;70;2615
27;Bourgogne-Franche-Comté;71;2;17;216;Germagny;202;7;209
27;Bourgogne-Franche-Comté;71;5;08;217;Germolles-sur-Grosne;127;5;132
27;Bourgogne-Franche-Comté;71;3;10;218;Gibles;590;21;611
27;Bourgogne-Franche-Comté;71;2;29;219;Gigny-sur-Saône;528;14;542
27;Bourgogne-Franche-Comté;71;3;15;220;Gilly-sur-Loire;487;3;490
27;Bourgogne-Franche-Comté;71;2;17;221;Givry;3705;155;3860
27;Bourgogne-Franche-Comté;71;1;03;222;Gourdon;904;26;930
27;Bourgogne-Franche-Comté;71;1;02;223;La Grande-Verrière;563;9;572
27;Bourgogne-Franche-Comté;71;3;09;224;Grandvaux;76;8;84
27;Bourgogne-Franche-Comté;71;2;17;225;Granges;528;13;541
27;Bourgogne-Franche-Comté;71;5;29;226;Grevilly;34;0;34
27;Bourgogne-Franche-Comté;71;3;18;227;Grury;535;9;544
27;Bourgogne-Franche-Comté;71;2;24;228;Guerfand;206;0;206
27;Bourgogne-Franche-Comté;71;3;15;229;Les Guerreaux;236;1;237
27;Bourgogne-Franche-Comté;71;3;18;230;Gueugnon;6992;204;7196
27;Bourgogne-Franche-Comté;71;5;11;231;La Guiche;623;12;635
27;Bourgogne-Franche-Comté;71;3;25;232;Hautefond;206;14;220
27;Bourgogne-Franche-Comté;71;3;25;233;L' Hôpital-le-Mercier;303;7;310
27;Bourgogne-Franche-Comté;71;4;14;234;Huilly-sur-Seille;334;6;340
27;Bourgogne-Franche-Comté;71;5;19;235;Hurigny;1983;107;2090
27;Bourgogne-Franche-Comté;71;5;19;236;Igé;871;21;892
27;Bourgogne-Franche-Comté;71;1;01;237;Igornay;539;10;549
27;Bourgogne-Franche-Comté;71;3;10;238;Iguerande;996;19;1015
27;Bourgogne-Franche-Comté;71;3;18;239;Issy-l'Évêque;706;10;716
27;Bourgogne-Franche-Comté;71;5;11;240;Jalogny;359;13;372
27;Bourgogne-Franche-Comté;71;2;17;241;Jambles;490;18;508
27;Bourgogne-Franche-Comté;71;5;03;242;Joncy;530;8;538
27;Bourgogne-Franche-Comté;71;4;14;243;Joudes;379;4;383
27;Bourgogne-Franche-Comté;71;4;14;244;Jouvençon;429;2;431
27;Bourgogne-Franche-Comté;71;2;29;245;Jugy;322;6;328
27;Bourgogne-Franche-Comté;71;4;20;246;Juif;259;4;263
27;Bourgogne-Franche-Comté;71;2;17;247;Jully-lès-Buxy;366;10;376
27;Bourgogne-Franche-Comté;71;5;29;248;Lacrost;729;16;745
27;Bourgogne-Franche-Comté;71;2;29;249;Laives;1020;37;1057
27;Bourgogne-Franche-Comté;71;5;19;250;Laizé;1087;50;1137
27;Bourgogne-Franche-Comté;71;1;02;251;Laizy;579;17;596
27;Bourgogne-Franche-Comté;71;2;29;252;Lalheue;395;15;410
27;Bourgogne-Franche-Comté;71;2;24;253;Lans;924;24;948
27;Bourgogne-Franche-Comté;71;4;26;254;Lays-sur-le-Doubs;143;0;143
27;Bourgogne-Franche-Comté;71;3;15;255;Lesme;187;2;189
27;Bourgogne-Franche-Comté;71;4;24;256;Lessard-en-Bresse;542;13;555
27;Bourgogne-Franche-Comté;71;2;16;257;Lessard-le-National;644;26;670
27;Bourgogne-Franche-Comté;71;5;08;258;Leynes;517;15;532
27;Bourgogne-Franche-Comté;71;3;10;259;Ligny-en-Brionnais;340;7;347
27;Bourgogne-Franche-Comté;71;4;14;261;Loisy;651;15;666
27;Bourgogne-Franche-Comté;71;2;16;262;Longepierre;168;4;172
27;Bourgogne-Franche-Comté;71;4;20;263;Louhans;6365;204;6569
27;Bourgogne-Franche-Comté;71;5;11;264;Lournand;331;9;340
27;Bourgogne-Franche-Comté;71;1;01;266;Lucenay-l'Évêque;319;3;322
27;Bourgogne-Franche-Comté;71;5;19;267;Lugny;875;85;960
27;Bourgogne-Franche-Comté;71;3;09;268;Lugny-lès-Charolles;350;10;360
27;Bourgogne-Franche-Comté;71;2;27;269;Lux;2011;33;2044
27;Bourgogne-Franche-Comté;71;5;99;270;Mâcon;33638;779;34417
27;Bourgogne-Franche-Comté;71;3;10;271;Mailly;155;10;165
27;Bourgogne-Franche-Comté;71;2;11;272;Malay;206;9;215
27;Bourgogne-Franche-Comté;71;3;15;273;Maltat;283;6;289
27;Bourgogne-Franche-Comté;71;2;29;274;Mancey;387;10;397
27;Bourgogne-Franche-Comté;71;3;25;275;Marcigny;1780;33;1813
27;Bourgogne-Franche-Comté;71;3;09;276;Marcilly-la-Gueurce;120;6;126
27;Bourgogne-Franche-Comté;71;2;17;277;Marcilly-lès-Buxy;691;19;710
27;Bourgogne-Franche-Comté;71;1;03;278;Marigny;154;5;159
27;Bourgogne-Franche-Comté;71;3;18;280;Marly-sous-Issy;88;2;90
27;Bourgogne-Franche-Comté;71;3;18;281;Marly-sur-Arroux;323;14;337
27;Bourgogne-Franche-Comté;71;1;02;282;Marmagne;1242;33;1275
27;Bourgogne-Franche-Comté;71;2;27;283;Marnay;558;5;563
27;Bourgogne-Franche-Comté;71;5;29;284;Martailly-lès-Brancion;142;7;149
27;Bourgogne-Franche-Comté;71;3;09;285;Martigny-le-Comte;417;7;424
27;Bourgogne-Franche-Comté;71;1;03;286;Mary;245;3;248
27;Bourgogne-Franche-Comté;71;5;11;287;Massilly;356;7;363
27;Bourgogne-Franche-Comté;71;5;08;289;Matour;1119;21;1140
27;Bourgogne-Franche-Comté;71;5;11;290;Mazille;384;68;452
27;Bourgogne-Franche-Comté;71;3;25;291;Melay;994;13;1007
27;Bourgogne-Franche-Comté;71;2;17;292;Mellecey;1299;45;1344
27;Bourgogne-Franche-Comté;71;4;14;293;Ménetreuil;410;8;418
27;Bourgogne-Franche-Comté;71;2;17;294;Mercurey;1193;169;1362
27;Bourgogne-Franche-Comté;71;4;26;295;Mervans;1494;24;1518
27;Bourgogne-Franche-Comté;71;2;17;296;Messey-sur-Grosne;753;19;772
27;Bourgogne-Franche-Comté;71;1;02;297;Mesvres;760;27;787
27;Bourgogne-Franche-Comté;71;5;19;299;Milly-Lamartine;330;8;338
27;Bourgogne-Franche-Comté;71;4;14;300;Le Miroir;609;8;617
27;Bourgogne-Franche-Comté;71;3;15;301;Mont;186;2;188
27;Bourgogne-Franche-Comté;71;2;16;315;Mont-lès-Seurre;180;2;182
27;Bourgogne-Franche-Comté;71;1;03;320;Mont-Saint-Vincent;327;3;330
27;Bourgogne-Franche-Comté;71;2;17;302;Montagny-lès-Buxy;218;9;227
27;Bourgogne-Franche-Comté;71;4;20;303;Montagny-près-Louhans;454;6;460
27;Bourgogne-Franche-Comté;71;5;19;305;Montbellet;800;18;818
27;Bourgogne-Franche-Comté;71;1;23;306;Montceau-les-Mines;18398;391;18789
27;Bourgogne-Franche-Comté;71;3;25;307;Montceaux-l'Étoile;290;7;297
27;Bourgogne-Franche-Comté;71;2;29;308;Montceaux-Ragny;31;0;31
27;Bourgogne-Franche-Comté;71;1;12;309;Montcenis;2095;64;2159
27;Bourgogne-Franche-Comté;71;1;03;310;Montchanin;5030;88;5118
27;Bourgogne-Franche-Comté;71;4;20;311;Montcony;266;4;270
27;Bourgogne-Franche-Comté;71;2;24;312;Montcoy;251;1;252
27;Bourgogne-Franche-Comté;71;1;01;313;Monthelon;384;15;399
27;Bourgogne-Franche-Comté;71;4;26;314;Montjay;202;0;202
27;Bourgogne-Franche-Comté;71;5;08;316;Montmelard;356;6;362
27;Bourgogne-Franche-Comté;71;3;18;317;Montmort;177;3;180
27;Bourgogne-Franche-Comté;71;4;14;318;Montpont-en-Bresse;1099;14;1113
27;Bourgogne-Franche-Comté;71;4;20;319;Montret;801;19;820
27;Bourgogne-Franche-Comté;71;1;04;321;Morey;199;4;203
27;Bourgogne-Franche-Comté;71;1;01;322;Morlet;62;1;63
27;Bourgogne-Franche-Comté;71;3;09;323;Mornay;132;0;132
27;Bourgogne-Franche-Comté;71;2;17;324;Moroges;569;17;586
27;Bourgogne-Franche-Comté;71;3;15;325;La Motte-Saint-Jean;1217;31;1248
27;Bourgogne-Franche-Comté;71;4;26;326;Mouthier-en-Bresse;426;7;433
27;Bourgogne-Franche-Comté;71;3;10;327;Mussy-sous-Dun;349;8;357
27;Bourgogne-Franche-Comté;71;2;29;328;Nanton;634;12;646
27;Bourgogne-Franche-Comté;71;2;16;329;Navilly;423;9;432
27;Bourgogne-Franche-Comté;71;5;08;134;Navour-sur-Grosne;653;21;674
27;Bourgogne-Franche-Comté;71;3;18;330;Neuvy-Grandchamp;762;25;787
27;Bourgogne-Franche-Comté;71;3;25;331;Nochize;115;1;116
27;Bourgogne-Franche-Comté;71;4;14;332;Ormes;477;5;482
27;Bourgogne-Franche-Comté;71;2;24;333;Oslon;1230;41;1271
27;Bourgogne-Franche-Comté;71;3;09;334;Oudry;387;9;396
27;Bourgogne-Franche-Comté;71;3;09;335;Ouroux-sous-le-Bois-Sainte-Marie;67;0;67
27;Bourgogne-Franche-Comté;71;4;24;336;Ouroux-sur-Saône;3072;79;3151
27;Bourgogne-Franche-Comté;71;3;10;337;Oyé;302;8;310
27;Bourgogne-Franche-Comté;71;5;29;338;Ozenay;219;2;221
27;Bourgogne-Franche-Comté;71;3;09;339;Ozolles;418;9;427
27;Bourgogne-Franche-Comté;71;3;09;340;Palinges;1513;32;1545
27;Bourgogne-Franche-Comté;71;2;16;341;Palleau;246;2;248
27;Bourgogne-Franche-Comté;71;3;25;342;Paray-le-Monial;9189;450;9639
27;Bourgogne-Franche-Comté;71;2;04;343;Paris-l'Hôpital;306;4;310
27;Bourgogne-Franche-Comté;71;5;11;344;Passy;64;2;66
27;Bourgogne-Franche-Comté;71;5;19;345;Péronne;652;11;663
27;Bourgogne-Franche-Comté;71;1;28;346;Perrecy-les-Forges;1627;30;1657
27;Bourgogne-Franche-Comté;71;1;04;347;Perreuil;549;15;564
27;Bourgogne-Franche-Comté;71;3;15;348;Perrigny-sur-Loire;135;3;138
27;Bourgogne-Franche-Comté;71;1;01;349;La Petite-Verrière;52;1;53
27;Bourgogne-Franche-Comté;71;4;26;351;Pierre-de-Bresse;1946;31;1977
27;Bourgogne-Franche-Comté;71;5;08;350;Pierreclos;904;22;926
27;Bourgogne-Franche-Comté;71;4;26;352;Le Planois;93;3;96
27;Bourgogne-Franche-Comté;71;5;29;353;Plottes;534;6;540
27;Bourgogne-Franche-Comté;71;3;25;354;Poisson;567;21;588
27;Bourgogne-Franche-Comté;71;2;16;355;Pontoux;275;7;282
27;Bourgogne-Franche-Comté;71;1;09;356;Pouilloux;992;18;1010
27;Bourgogne-Franche-Comté;71;4;26;357;Pourlans;210;2;212
27;Bourgogne-Franche-Comté;71;5;11;358;Pressy-sous-Dondin;99;3;102
27;Bourgogne-Franche-Comté;71;5;29;359;Préty;544;17;561
27;Bourgogne-Franche-Comté;71;5;19;360;Prissé;1994;49;2043
27;Bourgogne-Franche-Comté;71;3;09;361;Prizy;64;5;69
27;Bourgogne-Franche-Comté;71;5;08;362;Pruzilly;337;5;342
27;Bourgogne-Franche-Comté;71;2;03;363;Le Puley;97;2;99
27;Bourgogne-Franche-Comté;71;4;26;364;La Racineuse;174;1;175
27;Bourgogne-Franche-Comté;71;4;14;365;Rancy;561;8;569
27;Bourgogne-Franche-Comté;71;4;14;366;Ratenelle;389;6;395
27;Bourgogne-Franche-Comté;71;4;20;367;Ratte;361;10;371
27;Bourgogne-Franche-Comté;71;1;01;368;Reclesne;320;17;337
27;Bourgogne-Franche-Comté;71;2;04;369;Remigny;433;8;441
27;Bourgogne-Franche-Comté;71;3;18;370;Rigny-sur-Arroux;642;11;653
27;Bourgogne-Franche-Comté;71;5;19;371;La Roche-Vineuse;1557;41;1598
27;Bourgogne-Franche-Comté;71;5;08;372;Romanèche-Thorins;2006;33;2039
27;Bourgogne-Franche-Comté;71;4;14;373;Romenay;1674;20;1694
27;Bourgogne-Franche-Comté;71;2;17;374;Rosey;166;2;168
27;Bourgogne-Franche-Comté;71;3;09;279;Le Rousset-Marizy;653;20;673
27;Bourgogne-Franche-Comté;71;1;01;376;Roussillon-en-Morvan;270;8;278
27;Bourgogne-Franche-Comté;71;5;29;377;Royer;131;2;133
27;Bourgogne-Franche-Comté;71;2;04;378;Rully;1554;35;1589
27;Bourgogne-Franche-Comté;71;4;20;379;Sagy;1235;18;1253
27;Bourgogne-Franche-Comté;71;4;26;380;Saillenard;785;16;801
27;Bourgogne-Franche-Comté;71;5;11;381;Sailly;85;0;85
27;Bourgogne-Franche-Comté;71;3;15;382;Saint-Agnan;705;15;720
27;Bourgogne-Franche-Comté;71;5;19;383;Saint-Albain;513;5;518
27;Bourgogne-Franche-Comté;71;2;29;384;Saint-Ambreuil;506;8;514
27;Bourgogne-Franche-Comté;71;5;08;385;Saint-Amour-Bellevue;558;21;579
27;Bourgogne-Franche-Comté;71;4;20;386;Saint-André-en-Bresse;98;0;98
27;Bourgogne-Franche-Comté;71;5;11;387;Saint-André-le-Désert;251;5;256
27;Bourgogne-Franche-Comté;71;3;09;388;Saint-Aubin-en-Charollais;472;20;492
27;Bourgogne-Franche-Comté;71;3;15;389;Saint-Aubin-sur-Loire;292;5;297
27;Bourgogne-Franche-Comté;71;1;23;390;Saint-Berain-sous-Sanvignes;1093;22;1115
27;Bourgogne-Franche-Comté;71;2;04;391;Saint-Bérain-sur-Dheune;553;9;562
27;Bourgogne-Franche-Comté;71;2;17;392;Saint-Boil;491;10;501
27;Bourgogne-Franche-Comté;71;3;10;393;Saint-Bonnet-de-Cray;485;12;497
27;Bourgogne-Franche-Comté;71;3;09;394;Saint-Bonnet-de-Joux;758;20;778
27;Bourgogne-Franche-Comté;71;3;09;395;Saint-Bonnet-de-Vieille-Vigne;200;2;202
27;Bourgogne-Franche-Comté;71;4;26;396;Saint-Bonnet-en-Bresse;483;4;487
27;Bourgogne-Franche-Comté;71;4;24;398;Saint-Christophe-en-Bresse;1087;31;1118
27;Bourgogne-Franche-Comté;71;3;10;399;Saint-Christophe-en-Brionnais;527;16;543
27;Bourgogne-Franche-Comté;71;5;11;400;Saint-Clément-sur-Guye;131;3;134
27;Bourgogne-Franche-Comté;71;2;29;402;Saint-Cyr;729;20;749
27;Bourgogne-Franche-Comté;71;2;17;403;Saint-Denis-de-Vaux;263;10;273
27;Bourgogne-Franche-Comté;71;2;17;404;Saint-Désert;881;28;909
27;Bourgogne-Franche-Comté;71;2;16;405;Saint-Didier-en-Bresse;188;0;188
27;Bourgogne-Franche-Comté;71;3;10;406;Saint-Didier-en-Brionnais;134;10;144
27;Bourgogne-Franche-Comté;71;1;02;407;Saint-Didier-sur-Arroux;232;4;236
27;Bourgogne-Franche-Comté;71;3;10;408;Saint-Edmond;404;9;413
27;Bourgogne-Franche-Comté;71;1;02;409;Saint-Émiland;343;10;353
27;Bourgogne-Franche-Comté;71;4;20;410;Saint-Étienne-en-Bresse;799;14;813
27;Bourgogne-Franche-Comté;71;1;02;411;Saint-Eugène;151;8;159
27;Bourgogne-Franche-Comté;71;1;03;412;Saint-Eusèbe;1191;24;1215
27;Bourgogne-Franche-Comté;71;1;13;413;Saint-Firmin;889;19;908
27;Bourgogne-Franche-Comté;71;1;01;414;Saint-Forgeot;468;18;486
27;Bourgogne-Franche-Comté;71;5;19;416;Saint-Gengoux-de-Scissé;608;3;611
27;Bourgogne-Franche-Comté;71;2;11;417;Saint-Gengoux-le-National;1046;8;1054
27;Bourgogne-Franche-Comté;71;4;26;419;Saint-Germain-du-Bois;1899;40;1939
27;Bourgogne-Franche-Comté;71;4;24;420;Saint-Germain-du-Plain;2290;49;2339
27;Bourgogne-Franche-Comté;71;3;09;421;Saint-Germain-en-Brionnais;190;7;197
27;Bourgogne-Franche-Comté;71;2;17;422;Saint-Germain-lès-Buxy;268;9;277
27;Bourgogne-Franche-Comté;71;2;16;423;Saint-Gervais-en-Vallière;438;10;448
27;Bourgogne-Franche-Comté;71;1;01;424;Saint-Gervais-sur-Couches;202;1;203
27;Bourgogne-Franche-Comté;71;2;04;425;Saint-Gilles;270;10;280
27;Bourgogne-Franche-Comté;71;5;11;427;Saint-Huruge;53;1;54
27;Bourgogne-Franche-Comté;71;3;10;428;Saint-Igny-de-Roche;766;15;781
27;Bourgogne-Franche-Comté;71;1;04;431;Saint-Jean-de-Trézy;368;13;381
27;Bourgogne-Franche-Comté;71;2;17;430;Saint-Jean-de-Vaux;407;13;420
27;Bourgogne-Franche-Comté;71;3;09;433;Saint-Julien-de-Civry;487;14;501
27;Bourgogne-Franche-Comté;71;3;10;434;Saint-Julien-de-Jonzy;345;7;352
27;Bourgogne-Franche-Comté;71;1;03;435;Saint-Julien-sur-Dheune;239;2;241
27;Bourgogne-Franche-Comté;71;1;03;436;Saint-Laurent-d'Andenay;1019;15;1034
27;Bourgogne-Franche-Comté;71;3;10;437;Saint-Laurent-en-Brionnais;326;11;337
27;Bourgogne-Franche-Comté;71;1;01;438;Saint-Léger-du-Bois;537;10;547
27;Bourgogne-Franche-Comté;71;3;25;439;Saint-Léger-lès-Paray;730;20;750
27;Bourgogne-Franche-Comté;71;1;02;440;Saint-Léger-sous-Beuvray;380;10;390
27;Bourgogne-Franche-Comté;71;5;08;441;Saint-Léger-sous-la-Bussière;271;4;275
27;Bourgogne-Franche-Comté;71;2;04;442;Saint-Léger-sur-Dheune;1567;20;1587
27;Bourgogne-Franche-Comté;71;2;27;444;Saint-Loup-de-Varennes;1161;28;1189
27;Bourgogne-Franche-Comté;71;2;16;443;Saint-Loup-Géanges;1631;45;1676
27;Bourgogne-Franche-Comté;71;2;27;445;Saint-Marcel;6049;173;6222
27;Bourgogne-Franche-Comté;71;5;11;446;Saint-Marcelin-de-Cray;186;6;192
27;Bourgogne-Franche-Comté;71;2;17;447;Saint-Mard-de-Vaux;275;13;288
27;Bourgogne-Franche-Comté;71;5;19;448;Saint-Martin-Belle-Roche;1392;26;1418
27;Bourgogne-Franche-Comté;71;2;17;449;Saint-Martin-d'Auxy;111;6;117
27;Bourgogne-Franche-Comté;71;1;02;450;Saint-Martin-de-Commune;106;6;112
27;Bourgogne-Franche-Comté;71;3;10;451;Saint-Martin-de-Lixy;92;0;92
27;Bourgogne-Franche-Comté;71;5;11;452;Saint-Martin-de-Salencey;99;1;100
27;Bourgogne-Franche-Comté;71;3;25;453;Saint-Martin-du-Lac;242;11;253
27;Bourgogne-Franche-Comté;71;4;20;454;Saint-Martin-du-Mont;202;4;206
27;Bourgogne-Franche-Comté;71;2;17;455;Saint-Martin-du-Tartre;159;4;163
27;Bourgogne-Franche-Comté;71;2;24;456;Saint-Martin-en-Bresse;1921;77;1998
27;Bourgogne-Franche-Comté;71;2;16;457;Saint-Martin-en-Gâtinois;123;1;124
27;Bourgogne-Franche-Comté;71;5;03;458;Saint-Martin-la-Patrouille;62;0;62
27;Bourgogne-Franche-Comté;71;2;17;459;Saint-Martin-sous-Montaigu;353;17;370
27;Bourgogne-Franche-Comté;71;5;19;460;Saint-Maurice-de-Satonnay;486;23;509
27;Bourgogne-Franche-Comté;71;2;17;461;Saint-Maurice-des-Champs;62;1;63
27;Bourgogne-Franche-Comté;71;2;16;462;Saint-Maurice-en-Rivière;554;11;565
27;Bourgogne-Franche-Comté;71;3;10;463;Saint-Maurice-lès-Châteauneuf;569;12;581
27;Bourgogne-Franche-Comté;71;1;04;464;Saint-Maurice-lès-Couches;191;8;199
27;Bourgogne-Franche-Comté;71;1;03;465;Saint-Micaud;273;10;283
27;Bourgogne-Franche-Comté;71;1;02;466;Saint-Nizier-sur-Arroux;125;4;129
27;Bourgogne-Franche-Comté;71;1;13;468;Saint-Pierre-de-Varennes;849;16;865
27;Bourgogne-Franche-Comté;71;5;08;469;Saint-Pierre-le-Vieux;355;10;365
27;Bourgogne-Franche-Comté;71;5;08;470;Saint-Point;328;14;342
27;Bourgogne-Franche-Comté;71;2;17;471;Saint-Privé;82;1;83
27;Bourgogne-Franche-Comté;71;1;02;472;Saint-Prix;217;10;227
27;Bourgogne-Franche-Comté;71;3;10;473;Saint-Racho;171;1;172
27;Bourgogne-Franche-Comté;71;2;27;475;Saint-Rémy;6639;157;6796
27;Bourgogne-Franche-Comté;71;1;09;477;Saint-Romain-sous-Gourdon;479;9;488
27;Bourgogne-Franche-Comté;71;3;18;478;Saint-Romain-sous-Versigny;85;2;87
27;Bourgogne-Franche-Comté;71;1;13;479;Saint-Sernin-du-Bois;1812;37;1849
27;Bourgogne-Franche-Comté;71;2;04;480;Saint-Sernin-du-Plain;581;13;594
27;Bourgogne-Franche-Comté;71;5;08;481;Saint-Symphorien-d'Ancelles;1187;17;1204
27;Bourgogne-Franche-Comté;71;1;02;482;Saint-Symphorien-de-Marmagne;846;11;857
27;Bourgogne-Franche-Comté;71;3;10;483;Saint-Symphorien-des-Bois;438;12;450
27;Bourgogne-Franche-Comté;71;4;20;484;Saint-Usuge;1345;19;1364
27;Bourgogne-Franche-Comté;71;2;17;485;Saint-Vallerin;263;13;276
27;Bourgogne-Franche-Comté;71;1;28;486;Saint-Vallier;8654;177;8831
27;Bourgogne-Franche-Comté;71;5;08;487;Saint-Vérand;165;2;167
27;Bourgogne-Franche-Comté;71;3;09;490;Saint-Vincent-Bragny;997;17;1014
27;Bourgogne-Franche-Comté;71;5;11;488;Saint-Vincent-des-Prés;109;3;112
27;Bourgogne-Franche-Comté;71;4;20;489;Saint-Vincent-en-Bresse;573;9;582
27;Bourgogne-Franche-Comté;71;3;25;491;Saint-Yan;1169;24;1193
27;Bourgogne-Franche-Comté;71;5;11;492;Saint-Ythaire;125;3;128
27;Bourgogne-Franche-Comté;71;5;11;397;Sainte-Cécile;288;8;296
27;Bourgogne-Franche-Comté;71;4;14;401;Sainte-Croix;635;14;649
27;Bourgogne-Franche-Comté;71;3;10;415;Sainte-Foy;139;2;141
27;Bourgogne-Franche-Comté;71;2;17;426;Sainte-Hélène;523;10;533
27;Bourgogne-Franche-Comté;71;3;18;474;Sainte-Radegonde;154;2;156
27;Bourgogne-Franche-Comté;71;1;01;493;Saisy;334;12;346
27;Bourgogne-Franche-Comté;71;5;19;494;La Salle;545;11;556
27;Bourgogne-Franche-Comté;71;5;11;495;Salornay-sur-Guye;864;12;876
27;Bourgogne-Franche-Comté;71;2;04;496;Sampigny-lès-Maranges;143;10;153
27;Bourgogne-Franche-Comté;71;5;21;497;Sancé;2033;50;2083
27;Bourgogne-Franche-Comté;71;2;17;498;Santilly;133;6;139
27;Bourgogne-Franche-Comté;71;1;28;499;Sanvignes-les-Mines;4317;85;4402
27;Bourgogne-Franche-Comté;71;3;10;500;Sarry;104;3;107
27;Bourgogne-Franche-Comté;71;2;17;501;Sassangy;147;3;150
27;Bourgogne-Franche-Comté;71;2;16;502;Sassenay;1587;44;1631
27;Bourgogne-Franche-Comté;71;2;17;503;Saules;128;3;131
27;Bourgogne-Franche-Comté;71;2;16;504;Saunières;81;2;83
27;Bourgogne-Franche-Comté;71;2;17;505;Savianges;74;0;74
27;Bourgogne-Franche-Comté;71;4;26;506;Savigny-en-Revermont;1156;17;1173
27;Bourgogne-Franche-Comté;71;2;11;507;Savigny-sur-Grosne;170;1;171
27;Bourgogne-Franche-Comté;71;4;14;508;Savigny-sur-Seille;423;9;432
27;Bourgogne-Franche-Comté;71;3;10;510;Semur-en-Brionnais;623;19;642
27;Bourgogne-Franche-Comté;71;2;29;512;Sennecey-le-Grand;3149;51;3200
27;Bourgogne-Franche-Comté;71;5;19;513;Senozan;1125;16;1141
27;Bourgogne-Franche-Comté;71;4;26;514;Sens-sur-Seille;411;5;416
27;Bourgogne-Franche-Comté;71;2;17;515;Sercy;97;7;104
27;Bourgogne-Franche-Comté;71;4;26;516;Serley;608;7;615
27;Bourgogne-Franche-Comté;71;2;16;517;Sermesse;237;3;240
27;Bourgogne-Franche-Comté;71;5;08;518;Serrières;275;9;284
27;Bourgogne-Franche-Comté;71;4;26;519;Serrigny-en-Bresse;200;4;204
27;Bourgogne-Franche-Comté;71;2;27;520;Sevrey;1226;25;1251
27;Bourgogne-Franche-Comté;71;5;11;521;Sigy-le-Châtel;103;2;105
27;Bourgogne-Franche-Comté;71;4;14;522;Simandre;1728;21;1749
27;Bourgogne-Franche-Comté;71;4;20;523;Simard;1208;12;1220
27;Bourgogne-Franche-Comté;71;5;11;524;Sivignon;166;6;172
27;Bourgogne-Franche-Comté;71;5;19;525;Sologny;591;11;602
27;Bourgogne-Franche-Comté;71;5;08;526;Solutré-Pouilly;358;7;365
27;Bourgogne-Franche-Comté;71;1;01;527;Sommant;211;4;215
27;Bourgogne-Franche-Comté;71;4;20;528;Sornay;2030;44;2074
27;Bourgogne-Franche-Comté;71;3;09;529;Suin;266;7;273
27;Bourgogne-Franche-Comté;71;1;01;530;Sully;496;18;514
27;Bourgogne-Franche-Comté;71;1;02;531;La Tagnière;230;1;231
27;Bourgogne-Franche-Comté;71;5;11;532;Taizé;178;3;181
27;Bourgogne-Franche-Comté;71;3;10;533;Tancon;542;17;559
27;Bourgogne-Franche-Comté;71;4;26;534;Le Tartre;114;1;115
27;Bourgogne-Franche-Comté;71;1;01;535;Tavernay;495;11;506
27;Bourgogne-Franche-Comté;71;1;02;537;Thil-sur-Arroux;133;0;133
27;Bourgogne-Franche-Comté;71;4;26;538;Thurey;456;5;461
27;Bourgogne-Franche-Comté;71;1;01;539;Tintry;78;2;80
27;Bourgogne-Franche-Comté;71;1;12;540;Torcy;2960;40;3000
27;Bourgogne-Franche-Comté;71;4;26;541;Torpes;372;4;376
27;Bourgogne-Franche-Comté;71;3;18;542;Toulon-sur-Arroux;1585;39;1624
27;Bourgogne-Franche-Comté;71;5;29;543;Tournus;5545;340;5885
27;Bourgogne-Franche-Comté;71;2;16;544;Toutenant;190;5;195
27;Bourgogne-Franche-Comté;71;5;08;545;Tramayes;1056;20;1076
27;Bourgogne-Franche-Comté;71;5;08;546;Trambly;399;10;409
27;Bourgogne-Franche-Comté;71;5;08;547;Trivy;274;5;279
27;Bourgogne-Franche-Comté;71;4;24;548;Tronchy;257;1;258
27;Bourgogne-Franche-Comté;71;5;29;549;La Truchère;226;2;228
27;Bourgogne-Franche-Comté;71;5;29;550;Uchizy;843;14;857
27;Bourgogne-Franche-Comté;71;1;02;551;Uchon;98;5;103
27;Bourgogne-Franche-Comté;71;3;18;552;Uxeau;519;15;534
27;Bourgogne-Franche-Comté;71;3;10;553;Vareilles;268;5;273
27;Bourgogne-Franche-Comté;71;3;10;554;Varenne-l'Arconce;117;3;120
27;Bourgogne-Franche-Comté;71;3;15;557;Varenne-Saint-Germain;713;18;731
27;Bourgogne-Franche-Comté;71;2;27;555;Varennes-le-Grand;2298;48;2346
27;Bourgogne-Franche-Comté;71;5;22;556;Varennes-lès-Mâcon;548;8;556
27;Bourgogne-Franche-Comté;71;4;14;558;Varennes-Saint-Sauveur;1133;26;1159
27;Bourgogne-Franche-Comté;71;3;10;559;Varennes-sous-Dun;573;15;588
27;Bourgogne-Franche-Comté;71;3;10;561;Vauban;223;9;232
27;Bourgogne-Franche-Comté;71;3;09;562;Vaudebarrier;221;33;254
27;Bourgogne-Franche-Comté;71;2;11;563;Vaux-en-Pré;79;1;80
27;Bourgogne-Franche-Comté;71;3;09;564;Vendenesse-lès-Charolles;743;20;763
27;Bourgogne-Franche-Comté;71;3;18;565;Vendenesse-sur-Arroux;582;15;597
27;Bourgogne-Franche-Comté;71;2;16;566;Verdun-sur-le-Doubs;1083;8;1091
27;Bourgogne-Franche-Comté;71;5;08;567;Vergisson;255;7;262
27;Bourgogne-Franche-Comté;71;4;20;568;Vérissey;55;0;55
27;Bourgogne-Franche-Comté;71;2;16;570;Verjux;528;12;540
27;Bourgogne-Franche-Comté;71;5;08;571;Verosvres;448;59;507
27;Bourgogne-Franche-Comté;71;2;29;572;Vers;231;6;237
27;Bourgogne-Franche-Comté;71;3;25;573;Versaugues;193;14;207
27;Bourgogne-Franche-Comté;71;5;19;574;Verzé;787;26;813
27;Bourgogne-Franche-Comté;71;5;29;576;Le Villars;285;4;289
27;Bourgogne-Franche-Comté;71;2;24;577;Villegaudin;212;4;216
27;Bourgogne-Franche-Comté;71;2;17;579;Villeneuve-en-Montagne;163;0;163
27;Bourgogne-Franche-Comté;71;4;20;580;Vincelles;424;10;434
27;Bourgogne-Franche-Comté;71;3;25;581;Vindecy;254;5;259
27;Bourgogne-Franche-Comté;71;5;11;582;La Vineuse sur Fregande;655;18;673
27;Bourgogne-Franche-Comté;71;5;08;583;Vinzelles;702;21;723
27;Bourgogne-Franche-Comté;71;5;19;584;Viré;1181;27;1208
27;Bourgogne-Franche-Comté;71;2;05;585;Virey-le-Grand;1342;73;1415
27;Bourgogne-Franche-Comté;71;3;09;586;Viry;255;4;259
27;Bourgogne-Franche-Comté;71;3;25;588;Vitry-en-Charollais;1098;24;1122
27;Bourgogne-Franche-Comté;71;3;15;589;Vitry-sur-Loire;432;7;439
27;Bourgogne-Franche-Comté;71;3;25;590;Volesvres;607;24;631
52;Pays de la Loire;72;3;11;001;Aigné;1659;36;1695
52;Pays de la Loire;72;2;09;002;Aillières-Beauvoir;217;6;223
52;Pays de la Loire;72;3;16;003;Allonnes;11098;108;11206
52;Pays de la Loire;72;1;07;004;Amné;566;3;569
52;Pays de la Loire;72;2;20;005;Ancinnes;949;21;970
52;Pays de la Loire;72;2;19;007;Ardenay-sur-Mérize;486;5;491
52;Pays de la Loire;72;3;15;008;Arnage;5311;121;5432
52;Pays de la Loire;72;1;06;009;Arthezé;392;9;401
52;Pays de la Loire;72;2;09;006;Arçonnay;1844;229;2073
52;Pays de la Loire;72;1;17;010;Asnières-sur-Vègre;406;11;417
52;Pays de la Loire;72;2;20;011;Assé-le-Boisne;913;17;930
52;Pays de la Loire;72;2;20;012;Assé-le-Riboul;518;10;528
52;Pays de la Loire;72;1;08;013;Aubigné-Racan;2120;28;2148
52;Pays de la Loire;72;2;09;015;Les Aulneaux;117;0;117
52;Pays de la Loire;72;1;17;016;Auvers-le-Hamon;1473;36;1509
52;Pays de la Loire;72;1;07;017;Auvers-sous-Montfaucon;244;3;247
52;Pays de la Loire;72;2;09;018;Avesnes-en-Saosnois;89;1;90
52;Pays de la Loire;72;1;07;019;Avessé;375;11;386
52;Pays de la Loire;72;2;05;020;Avezé;726;19;745
52;Pays de la Loire;72;1;17;021;Avoise;612;7;619
52;Pays de la Loire;72;1;17;022;Le Bailleul;1234;17;1251
52;Pays de la Loire;72;3;01;023;Ballon-Saint Mars;2230;32;2262
52;Pays de la Loire;72;3;01;024;La Bazoge;3641;59;3700
52;Pays de la Loire;72;1;06;025;Bazouges Cré sur Loir;2048;57;2105
52;Pays de la Loire;72;2;01;026;Beaufay;1491;15;1506
52;Pays de la Loire;72;1;03;028;Beaumont-Pied-de-Bœuf;488;13;501
52;Pays de la Loire;72;1;03;027;Beaumont-sur-Dême;331;8;339
52;Pays de la Loire;72;2;20;029;Beaumont-sur-Sarthe;1960;26;1986
52;Pays de la Loire;72;2;05;031;Beillé;528;3;531
52;Pays de la Loire;72;2;18;032;Berfay;328;12;340
52;Pays de la Loire;72;2;07;219;Bernay-Neuvy-en-Champagne;862;58;920
52;Pays de la Loire;72;2;20;034;Bérus;447;12;459
52;Pays de la Loire;72;2;18;035;Bessé-sur-Braye;2212;36;2248
52;Pays de la Loire;72;2;20;036;Béthon;327;4;331
52;Pays de la Loire;72;2;09;037;Blèves;105;1;106
52;Pays de la Loire;72;2;05;038;Boëssé-le-Sec;632;13;645
52;Pays de la Loire;72;2;01;039;Bonnétable;3856;59;3915
52;Pays de la Loire;72;2;05;040;La Bosse;137;0;137
52;Pays de la Loire;72;2;05;041;Bouër;333;2;335
52;Pays de la Loire;72;2;18;042;Bouloire;2082;36;2118
52;Pays de la Loire;72;2;20;043;Bourg-le-Roi;320;8;328
52;Pays de la Loire;72;1;06;044;Bousse;443;5;448
52;Pays de la Loire;72;1;07;045;Brains-sur-Gée;820;13;833
52;Pays de la Loire;72;2;19;046;Le Breil-sur-Mérize;1542;27;1569
52;Pays de la Loire;72;3;02;047;Brette-les-Pins;2153;115;2268
52;Pays de la Loire;72;2;01;048;Briosne-lès-Sables;542;4;546
52;Pays de la Loire;72;1;08;049;La Bruère-sur-Loir;244;2;246
52;Pays de la Loire;72;1;07;050;Brûlon;1580;31;1611
52;Pays de la Loire;72;1;08;051;Cérans-Foulletourte;3375;35;3410
52;Pays de la Loire;72;1;03;052;Chahaignes;693;13;706
52;Pays de la Loire;72;3;02;053;Challes;1221;14;1235
52;Pays de la Loire;72;3;02;054;Champagné;3876;71;3947
52;Pays de la Loire;72;2;09;056;Champfleur;1358;24;1382
52;Pays de la Loire;72;2;18;057;Champrond;70;3;73
52;Pays de la Loire;72;3;02;058;Changé;6519;194;6713
52;Pays de la Loire;72;1;07;059;Chantenay-Villedieu;865;18;883
52;Pays de la Loire;72;1;08;060;La Chapelle-aux-Choux;266;3;269
52;Pays de la Loire;72;1;06;061;La Chapelle-d'Aligné;1694;25;1719
52;Pays de la Loire;72;2;05;062;La Chapelle-du-Bois;868;25;893
52;Pays de la Loire;72;2;18;064;La Chapelle-Huon;547;15;562
52;Pays de la Loire;72;3;11;065;La Chapelle-Saint-Aubin;2360;67;2427
52;Pays de la Loire;72;2;07;066;La Chapelle-Saint-Fray;441;7;448
52;Pays de la Loire;72;2;05;067;La Chapelle-Saint-Rémy;976;15;991
52;Pays de la Loire;72;1;03;068;La Chartre-sur-le-Loir;1425;17;1442
52;Pays de la Loire;72;1;07;070;Chassillé;240;6;246
52;Pays de la Loire;72;1;08;072;Château-l'Hermitage;254;2;256
52;Pays de la Loire;72;3;16;073;Chaufour-Notre-Dame;1067;22;1089
52;Pays de la Loire;72;1;07;074;Chemiré-en-Charnie;209;6;215
52;Pays de la Loire;72;1;21;075;Chemiré-le-Gaudin;979;26;1005
52;Pays de la Loire;72;2;09;076;Chenay;231;2;233
52;Pays de la Loire;72;1;08;077;Chenu;429;6;435
52;Pays de la Loire;72;2;20;078;Chérancé;360;3;363
52;Pays de la Loire;72;2;20;079;Chérisay;309;3;312
52;Pays de la Loire;72;2;05;080;Cherré-Au;2698;79;2777
52;Pays de la Loire;72;1;07;083;Chevillé;411;5;416
52;Pays de la Loire;72;1;06;084;Clermont-Créans;1264;35;1299
52;Pays de la Loire;72;2;18;085;Cogners;188;2;190
52;Pays de la Loire;72;2;09;086;Commerveil;137;2;139
52;Pays de la Loire;72;2;18;087;Conflans-sur-Anille;512;15;527
52;Pays de la Loire;72;2;09;088;Congé-sur-Orne;343;4;347
52;Pays de la Loire;72;2;07;089;Conlie;1899;34;1933
52;Pays de la Loire;72;2;19;090;Connerré;2902;58;2960
52;Pays de la Loire;72;2;09;091;Contilly;139;2;141
52;Pays de la Loire;72;2;05;093;Cormes;907;14;921
52;Pays de la Loire;72;2;18;094;Coudrecieux;616;9;625
52;Pays de la Loire;72;3;13;095;Coulaines;7423;125;7548
52;Pays de la Loire;72;1;07;096;Coulans-sur-Gée;1650;81;1731
52;Pays de la Loire;72;1;08;098;Coulongé;519;6;525
52;Pays de la Loire;72;3;01;099;Courcebœufs;638;7;645
52;Pays de la Loire;72;1;06;100;Courcelles-la-Forêt;410;5;415
52;Pays de la Loire;72;2;01;101;Courcemont;679;15;694
52;Pays de la Loire;72;2;01;102;Courcival;96;1;97
52;Pays de la Loire;72;1;03;103;Courdemanche;609;9;618
52;Pays de la Loire;72;2;09;104;Courgains;579;14;593
52;Pays de la Loire;72;2;18;105;Courgenard;495;5;500
52;Pays de la Loire;72;1;17;106;Courtillers;922;27;949
52;Pays de la Loire;72;1;07;107;Crannes-en-Champagne;352;6;358
52;Pays de la Loire;72;2;20;109;Crissé;587;5;592
52;Pays de la Loire;72;1;06;110;Crosmières;1044;21;1065
52;Pays de la Loire;72;2;07;111;Cures;485;15;500
52;Pays de la Loire;72;2;09;112;Dangeul;473;1;474
52;Pays de la Loire;72;2;07;113;Degré;784;12;796
52;Pays de la Loire;72;2;05;114;Dehault;270;6;276
52;Pays de la Loire;72;1;03;115;Dissay-sous-Courcillon;932;24;956
52;Pays de la Loire;72;2;18;118;Dollon;1488;29;1517
52;Pays de la Loire;72;2;07;119;Domfront-en-Champagne;1034;18;1052
52;Pays de la Loire;72;2;20;120;Doucelles;250;3;253
52;Pays de la Loire;72;2;20;121;Douillet;328;11;339
52;Pays de la Loire;72;2;05;122;Duneau;1045;21;1066
52;Pays de la Loire;72;1;17;123;Dureil;71;0;71
52;Pays de la Loire;72;3;04;124;Écommoy;4677;71;4748
52;Pays de la Loire;72;2;18;125;Écorpain;296;9;305
52;Pays de la Loire;72;1;07;126;Épineu-le-Chevreuil;295;9;304
52;Pays de la Loire;72;1;21;127;Étival-lès-le-Mans;1939;36;1975
52;Pays de la Loire;72;2;19;129;Fatines;845;16;861
52;Pays de la Loire;72;3;16;130;Fay;668;13;681
52;Pays de la Loire;72;1;21;131;Fercé-sur-Sarthe;593;8;601
52;Pays de la Loire;72;2;05;132;La Ferté-Bernard;8820;335;9155
52;Pays de la Loire;72;1;21;133;Fillé;1494;24;1518
52;Pays de la Loire;72;1;06;154;La Flèche;14956;1000;15956
52;Pays de la Loire;72;1;03;134;Flée;539;14;553
52;Pays de la Loire;72;1;08;135;La Fontaine-Saint-Martin;619;7;626
52;Pays de la Loire;72;1;07;136;Fontenay-sur-Vègre;324;8;332
52;Pays de la Loire;72;2;20;138;Fresnay-sur-Sarthe;2970;45;3015
52;Pays de la Loire;72;2;20;139;Fyé;992;44;1036
52;Pays de la Loire;72;2;20;141;Gesnes-le-Gandelin;963;22;985
52;Pays de la Loire;72;1;03;143;Le Grand-Lucé;1923;27;1950
52;Pays de la Loire;72;2;20;142;Grandchamp;156;8;164
52;Pays de la Loire;72;2;18;144;Gréez-sur-Roc;332;4;336
52;Pays de la Loire;72;2;20;145;Le Grez;397;10;407
52;Pays de la Loire;72;1;21;146;Guécélard;3019;52;3071
52;Pays de la Loire;72;3;01;147;La Guierche;1103;23;1126
52;Pays de la Loire;72;2;01;148;Jauzé;84;1;85
52;Pays de la Loire;72;1;07;149;Joué-en-Charnie;654;5;659
52;Pays de la Loire;72;3;01;150;Joué-l'Abbé;1279;23;1302
52;Pays de la Loire;72;1;17;151;Juigné-sur-Sarthe;1147;26;1173
52;Pays de la Loire;72;2;20;152;Juillé;474;13;487
52;Pays de la Loire;72;1;03;153;Jupilles;566;12;578
52;Pays de la Loire;72;3;04;155;Laigné-en-Belin;2353;30;2383
52;Pays de la Loire;72;2;18;156;Lamnay;957;23;980
52;Pays de la Loire;72;2;07;157;Lavardin;735;9;744
52;Pays de la Loire;72;2;18;158;Lavaré;856;11;867
52;Pays de la Loire;72;1;03;160;Lavernat;599;7;606
52;Pays de la Loire;72;1;03;161;Lhomme;902;14;916
52;Pays de la Loire;72;1;06;163;Ligron;504;9;513
52;Pays de la Loire;72;2;20;164;Livet-en-Saosnois;70;0;70
52;Pays de la Loire;72;1;03;262;Loir en Vallée;2173;175;2348
52;Pays de la Loire;72;2;19;165;Lombron;1909;23;1932
52;Pays de la Loire;72;1;07;166;Longnes;325;10;335
52;Pays de la Loire;72;1;17;167;Louailles;727;10;737
52;Pays de la Loire;72;1;07;168;Loué;2135;40;2175
52;Pays de la Loire;72;1;21;169;Louplande;1462;24;1486
52;Pays de la Loire;72;2;09;170;Louvigny;176;7;183
52;Pays de la Loire;72;2;09;171;Louzes;101;1;102
52;Pays de la Loire;72;2;05;172;Le Luart;1439;12;1451
52;Pays de la Loire;72;2;09;174;Lucé-sous-Ballon;105;2;107
52;Pays de la Loire;72;1;03;173;Luceau;1226;27;1253
52;Pays de la Loire;72;1;08;175;Luché-Pringé;1562;15;1577
52;Pays de la Loire;72;1;08;176;Le Lude;4255;73;4328
52;Pays de la Loire;72;1;07;177;Maigné;353;4;357
52;Pays de la Loire;72;2;18;178;Maisoncelles;193;1;194
52;Pays de la Loire;72;1;21;179;Malicorne-sur-Sarthe;1905;33;1938
52;Pays de la Loire;72;2;09;180;Mamers;5299;161;5460
52;Pays de la Loire;72;3;99;181;Le Mans;142946;2830;145776
52;Pays de la Loire;72;1;08;182;Mansigné;1553;31;1584
52;Pays de la Loire;72;1;07;184;Mareil-en-Champagne;382;6;388
52;Pays de la Loire;72;1;06;185;Mareil-sur-Loir;663;10;673
52;Pays de la Loire;72;2;20;186;Maresché;886;10;896
52;Pays de la Loire;72;3;04;187;Marigné-Laillé;1636;23;1659
52;Pays de la Loire;72;2;09;189;Marolles-les-Braults;2205;32;2237
52;Pays de la Loire;72;2;18;190;Marolles-lès-Saint-Calais;276;4;280
52;Pays de la Loire;72;2;09;188;Marollette;150;2;152
52;Pays de la Loire;72;1;03;183;Marçon;1060;18;1078
52;Pays de la Loire;72;1;08;191;Mayet;3138;37;3175
52;Pays de la Loire;72;2;09;192;Les Mées;100;2;102
52;Pays de la Loire;72;2;18;193;Melleray;432;7;439
52;Pays de la Loire;72;2;09;194;Meurcé;269;3;272
52;Pays de la Loire;72;1;21;195;Mézeray;1917;24;1941
52;Pays de la Loire;72;2;07;197;Mézières-sous-Lavardin;695;5;700
52;Pays de la Loire;72;2;09;196;Mézières-sur-Ponthouin;706;7;713
52;Pays de la Loire;72;3;11;198;La Milesse;2640;43;2683
52;Pays de la Loire;72;2;20;199;Moitron-sur-Sarthe;262;1;263
52;Pays de la Loire;72;3;04;200;Moncé-en-Belin;3670;50;3720
52;Pays de la Loire;72;2;09;201;Moncé-en-Saosnois;259;3;262
52;Pays de la Loire;72;2;09;202;Monhoudou;207;8;215
52;Pays de la Loire;72;2;20;211;Mont-Saint-Jean;640;17;657
52;Pays de la Loire;72;2;18;204;Montaillé;543;12;555
52;Pays de la Loire;72;3;01;205;Montbizot;1803;27;1830
52;Pays de la Loire;72;2;19;241;Montfort-le-Gesnois;2973;48;3021
52;Pays de la Loire;72;2;18;208;Montmirail;389;9;398
52;Pays de la Loire;72;2;20;209;Montreuil-le-Chétif;302;0;302
52;Pays de la Loire;72;1;03;210;Montreuil-le-Henri;308;4;312
52;Pays de la Loire;72;1;03;071;Montval-sur-Loir;6124;249;6373
52;Pays de la Loire;72;2;20;212;Moulins-le-Carbonnel;697;12;709
52;Pays de la Loire;72;3;04;213;Mulsanne;5238;63;5301
52;Pays de la Loire;72;2;09;214;Nauvay;11;2;13
52;Pays de la Loire;72;2;09;215;Neufchâtel-en-Saosnois;1026;11;1037
52;Pays de la Loire;72;2;07;216;Neuvillalais;590;12;602
52;Pays de la Loire;72;3;01;217;Neuville-sur-Sarthe;2421;48;2469
52;Pays de la Loire;72;2;20;218;Neuvillette-en-Charnie;293;3;296
52;Pays de la Loire;72;2;01;220;Nogent-le-Bernard;914;37;951
52;Pays de la Loire;72;1;03;221;Nogent-sur-Loir;380;3;383
52;Pays de la Loire;72;1;17;232;Notre-Dame-du-Pé;634;10;644
52;Pays de la Loire;72;2;09;222;Nouans;286;5;291
52;Pays de la Loire;72;1;07;223;Noyen-sur-Sarthe;2611;33;2644
52;Pays de la Loire;72;2;19;224;Nuillé-le-Jalais;542;6;548
52;Pays de la Loire;72;2;20;225;Oisseau-le-Petit;662;13;675
52;Pays de la Loire;72;1;08;226;Oizé;1323;17;1340
52;Pays de la Loire;72;2;09;227;Panon;44;0;44
52;Pays de la Loire;72;1;17;228;Parcé-sur-Sarthe;2100;51;2151
52;Pays de la Loire;72;2;20;229;Parennes;508;7;515
52;Pays de la Loire;72;3;02;231;Parigné-l'Évêque;5086;78;5164
52;Pays de la Loire;72;1;21;230;Parigné-le-Pôlin;1082;55;1137
52;Pays de la Loire;72;2;09;233;Peray;62;0;62
52;Pays de la Loire;72;2;20;234;Pezé-le-Robert;370;11;381
52;Pays de la Loire;72;2;20;235;Piacé;383;7;390
52;Pays de la Loire;72;1;17;236;Pincé;193;8;201
52;Pays de la Loire;72;1;07;237;Pirmil;513;8;521
52;Pays de la Loire;72;2;09;238;Pizieux;74;0;74
52;Pays de la Loire;72;1;07;239;Poillé-sur-Vègre;617;20;637
52;Pays de la Loire;72;1;08;243;Pontvallain;1675;25;1700
52;Pays de la Loire;72;1;17;244;Précigné;2973;64;3037
52;Pays de la Loire;72;2;05;245;Préval;687;15;702
52;Pays de la Loire;72;2;05;246;Prévelles;218;2;220
52;Pays de la Loire;72;1;03;248;Pruillé-l'Éguillé;824;24;848
52;Pays de la Loire;72;3;16;247;Pruillé-le-Chétif;1359;37;1396
52;Pays de la Loire;72;2;07;249;La Quinte;777;13;790
52;Pays de la Loire;72;2;18;250;Rahay;158;9;167
52;Pays de la Loire;72;2;09;251;René;379;5;384
52;Pays de la Loire;72;1;08;252;Requeil;1184;11;1195
52;Pays de la Loire;72;1;21;253;Roézé-sur-Sarthe;2626;69;2695
52;Pays de la Loire;72;2;20;254;Rouessé-Fontaine;276;5;281
52;Pays de la Loire;72;2;20;255;Rouessé-Vassé;813;17;830
52;Pays de la Loire;72;2;20;256;Rouez;771;8;779
52;Pays de la Loire;72;3;10;257;Rouillon;2259;315;2574
52;Pays de la Loire;72;2;01;259;Rouperroux-le-Coquet;290;6;296
52;Pays de la Loire;72;3;04;260;Ruaudin;3418;67;3485
52;Pays de la Loire;72;2;07;261;Ruillé-en-Champagne;322;12;334
52;Pays de la Loire;72;1;17;264;Sablé-sur-Sarthe;12220;499;12719
52;Pays de la Loire;72;2;09;265;Saint-Aignan;251;1;252
52;Pays de la Loire;72;2;20;266;Saint-Aubin-de-Locquenay;690;16;706
52;Pays de la Loire;72;2;05;267;Saint-Aubin-des-Coudrais;926;21;947
52;Pays de la Loire;72;3;04;268;Saint-Biez-en-Belin;714;11;725
52;Pays de la Loire;72;2;18;269;Saint-Calais;3236;195;3431
52;Pays de la Loire;72;2;09;270;Saint-Calez-en-Saosnois;187;1;188
52;Pays de la Loire;72;2;19;271;Saint-Célerin;905;15;920
52;Pays de la Loire;72;2;20;273;Saint-Christophe-du-Jambet;233;4;237
52;Pays de la Loire;72;1;07;274;Saint-Christophe-en-Champagne;209;6;215
52;Pays de la Loire;72;2;19;275;Saint-Corneille;1431;14;1445
52;Pays de la Loire;72;2;09;276;Saint-Cosme-en-Vairais;1970;51;2021
52;Pays de la Loire;72;1;07;278;Saint-Denis-d'Orques;799;11;810
52;Pays de la Loire;72;2;05;277;Saint-Denis-des-Coudrais;114;1;115
52;Pays de la Loire;72;1;03;279;Saint-Georges-de-la-Couée;159;3;162
52;Pays de la Loire;72;3;16;280;Saint-Georges-du-Bois;2121;36;2157
52;Pays de la Loire;72;2;01;281;Saint-Georges-du-Rosay;435;3;438
52;Pays de la Loire;72;2;20;282;Saint-Georges-le-Gaultier;531;5;536
52;Pays de la Loire;72;1;08;283;Saint-Germain-d'Arcé;335;5;340
52;Pays de la Loire;72;2;18;286;Saint-Gervais-de-Vic;395;7;402
52;Pays de la Loire;72;3;04;287;Saint-Gervais-en-Belin;2076;44;2120
52;Pays de la Loire;72;3;01;290;Saint-Jean-d'Assé;1759;15;1774
52;Pays de la Loire;72;1;08;291;Saint-Jean-de-la-Motte;968;22;990
52;Pays de la Loire;72;2;18;292;Saint-Jean-des-Échelles;253;8;261
52;Pays de la Loire;72;1;21;293;Saint-Jean-du-Bois;626;8;634
52;Pays de la Loire;72;2;20;294;Saint-Léonard-des-Bois;472;13;485
52;Pays de la Loire;72;2;09;295;Saint-Longis;503;8;511
52;Pays de la Loire;72;2;18;296;Saint-Maixent;740;19;759
52;Pays de la Loire;72;2;20;297;Saint-Marceau;560;6;566
52;Pays de la Loire;72;3;02;299;Saint-Mars-d'Outillé;2418;36;2454
52;Pays de la Loire;72;2;18;298;Saint-Mars-de-Locquenay;570;10;580
52;Pays de la Loire;72;2;19;300;Saint-Mars-la-Brière;2688;29;2717
52;Pays de la Loire;72;2;05;302;Saint-Martin-des-Monts;179;4;183
52;Pays de la Loire;72;2;18;303;Saint-Michel-de-Chavaignes;737;11;748
52;Pays de la Loire;72;2;20;305;Saint-Ouen-de-Mimbré;1029;11;1040
52;Pays de la Loire;72;3;04;306;Saint-Ouen-en-Belin;1303;23;1326
52;Pays de la Loire;72;1;07;307;Saint-Ouen-en-Champagne;244;2;246
52;Pays de la Loire;72;2;09;308;Saint-Paterne - Le Chevain;2120;209;2329
52;Pays de la Loire;72;2;20;309;Saint-Paul-le-Gaultier;288;8;296
52;Pays de la Loire;72;3;01;310;Saint-Pavace;1925;58;1983
52;Pays de la Loire;72;1;03;311;Saint-Pierre-de-Chevillé;364;2;366
52;Pays de la Loire;72;1;07;312;Saint-Pierre-des-Bois;235;3;238
52;Pays de la Loire;72;2;09;313;Saint-Pierre-des-Ormes;226;6;232
52;Pays de la Loire;72;1;03;314;Saint-Pierre-du-Lorouër;377;9;386
52;Pays de la Loire;72;2;20;315;Saint-Rémy-de-Sillé;831;14;845
52;Pays de la Loire;72;2;09;316;Saint-Rémy-des-Monts;686;20;706
52;Pays de la Loire;72;2;09;317;Saint-Rémy-du-Val;512;17;529
52;Pays de la Loire;72;3;11;320;Saint-Saturnin;2529;82;2611
52;Pays de la Loire;72;2;07;321;Saint-Symphorien;562;12;574
52;Pays de la Loire;72;2;18;322;Saint-Ulphace;225;4;229
52;Pays de la Loire;72;2;20;323;Saint-Victeur;456;3;459
52;Pays de la Loire;72;2;09;324;Saint-Vincent-des-Prés;513;3;516
52;Pays de la Loire;72;1;03;325;Saint-Vincent-du-Lorouër;855;17;872
52;Pays de la Loire;72;2;18;272;Sainte-Cérotte;316;6;322
52;Pays de la Loire;72;3;01;289;Sainte-Jamme-sur-Sarthe;2051;32;2083
52;Pays de la Loire;72;2;07;319;Sainte-Sabine-sur-Longève;763;18;781
52;Pays de la Loire;72;2;09;326;Saosnes;211;5;216
52;Pays de la Loire;72;1;08;327;Sarcé;299;4;303
52;Pays de la Loire;72;3;02;328;Sargé-lès-le-Mans;3614;135;3749
52;Pays de la Loire;72;2;19;329;Savigné-l'Évêque;3998;83;4081
52;Pays de la Loire;72;1;08;330;Savigné-sous-le-Lude;429;13;442
52;Pays de la Loire;72;2;05;331;Sceaux-sur-Huisne;570;11;581
52;Pays de la Loire;72;2;20;332;Ségrie;605;7;612
52;Pays de la Loire;72;2;18;333;Semur-en-Vallon;447;9;456
52;Pays de la Loire;72;2;20;334;Sillé-le-Guillaume;2305;86;2391
52;Pays de la Loire;72;2;19;335;Sillé-le-Philippe;1078;14;1092
52;Pays de la Loire;72;1;17;336;Solesmes;1198;38;1236
52;Pays de la Loire;72;2;20;337;Sougé-le-Ganelon;901;18;919
52;Pays de la Loire;72;3;01;338;Souillé;690;9;699
52;Pays de la Loire;72;1;21;339;Souligné-Flacé;686;8;694
52;Pays de la Loire;72;3;01;340;Souligné-sous-Ballon;1202;21;1223
52;Pays de la Loire;72;2;19;341;Soulitré;631;12;643
52;Pays de la Loire;72;2;05;342;Souvigné-sur-Même;174;7;181
52;Pays de la Loire;72;1;17;343;Souvigné-sur-Sarthe;629;12;641
52;Pays de la Loire;72;1;21;344;Spay;2890;48;2938
52;Pays de la Loire;72;2;19;345;Surfonds;340;6;346
52;Pays de la Loire;72;1;21;346;La Suze-sur-Sarthe;4463;56;4519
52;Pays de la Loire;72;1;07;347;Tassé;314;5;319
52;Pays de la Loire;72;1;07;348;Tassillé;134;1;135
52;Pays de la Loire;72;3;01;349;Teillé;480;2;482
52;Pays de la Loire;72;3;04;350;Teloché;3056;80;3136
52;Pays de la Loire;72;2;07;351;Tennie;1057;20;1077
52;Pays de la Loire;72;2;01;352;Terrehault;135;0;135
52;Pays de la Loire;72;2;05;353;Théligny;213;5;218
52;Pays de la Loire;72;2;09;354;Thoigné;164;4;168
52;Pays de la Loire;72;2;20;355;Thoiré-sous-Contensor;92;0;92
52;Pays de la Loire;72;1;03;356;Thoiré-sur-Dinan;439;5;444
52;Pays de la Loire;72;1;06;357;Thorée-les-Pins;724;11;735
52;Pays de la Loire;72;2;18;358;Thorigné-sur-Dué;1607;35;1642
52;Pays de la Loire;72;2;19;359;Torcé-en-Vallée;1409;11;1420
52;Pays de la Loire;72;3;16;360;Trangé;1415;30;1445
52;Pays de la Loire;72;2;18;361;Tresson;466;8;474
52;Pays de la Loire;72;2;20;362;Le Tronchet;163;1;164
52;Pays de la Loire;72;2;05;363;Tuffé Val de la Chéronne;1650;40;1690
52;Pays de la Loire;72;1;08;364;Vaas;1510;20;1530
52;Pays de la Loire;72;2;18;128;Val d'Étangson;528;5;533
52;Pays de la Loire;72;2;18;366;Valennes;318;4;322
52;Pays de la Loire;72;1;07;367;Vallon-sur-Gée;805;11;816
52;Pays de la Loire;72;2;18;368;Vancé;324;6;330
52;Pays de la Loire;72;1;08;369;Verneil-le-Chétif;613;108;721
52;Pays de la Loire;72;2;20;370;Vernie;333;7;340
52;Pays de la Loire;72;2;09;372;Vezot;76;1;77
52;Pays de la Loire;72;2;18;373;Vibraye;2553;56;2609
52;Pays de la Loire;72;2;09;374;Villaines-la-Carelle;152;5;157
52;Pays de la Loire;72;2;05;375;Villaines-la-Gonais;558;16;574
52;Pays de la Loire;72;1;03;376;Villaines-sous-Lucé;711;21;732
52;Pays de la Loire;72;1;06;377;Villaines-sous-Malicorne;1025;12;1037
52;Pays de la Loire;72;2;09;137;Villeneuve-en-Perseigne;2196;42;2238
52;Pays de la Loire;72;1;17;378;Vion;1448;33;1481
52;Pays de la Loire;72;1;07;379;Viré-en-Champagne;200;6;206
52;Pays de la Loire;72;2;20;380;Vivoin;948;22;970
52;Pays de la Loire;72;1;21;381;Voivres-lès-le-Mans;1377;11;1388
52;Pays de la Loire;72;2;18;382;Volnay;919;11;930
52;Pays de la Loire;72;2;05;383;Vouvray-sur-Huisne;128;4;132
52;Pays de la Loire;72;3;02;386;Yvré-l'Évêque;4228;133;4361
52;Pays de la Loire;72;1;08;385;Yvré-le-Pôlin;1768;24;1792
84;Auvergne-Rhône-Alpes;73;2;14;001;Aiguebelette-le-Lac;235;9;244
84;Auvergne-Rhône-Alpes;73;2;16;004;Aillon-le-Jeune;434;16;450
84;Auvergne-Rhône-Alpes;73;2;16;005;Aillon-le-Vieux;179;4;183
84;Auvergne-Rhône-Alpes;73;1;05;006;Aime-la-Plagne;4443;111;4554
84;Auvergne-Rhône-Alpes;73;3;18;007;Aiton;1667;22;1689
84;Auvergne-Rhône-Alpes;73;2;97;008;Aix-les-Bains;29794;579;30373
84;Auvergne-Rhône-Alpes;73;1;98;011;Albertville;18899;554;19453
84;Auvergne-Rhône-Alpes;73;3;17;012;Albiez-le-Jeune;146;2;148
84;Auvergne-Rhône-Alpes;73;3;17;013;Albiez-Montrond;376;11;387
84;Auvergne-Rhône-Alpes;73;1;03;014;Allondaz;275;2;277
84;Auvergne-Rhône-Alpes;73;1;13;015;Les Allues;1841;43;1884
84;Auvergne-Rhône-Alpes;73;2;11;017;Apremont;1013;21;1034
84;Auvergne-Rhône-Alpes;73;2;11;018;Arbin;777;21;798
84;Auvergne-Rhône-Alpes;73;3;18;019;Argentine;954;23;977
84;Auvergne-Rhône-Alpes;73;2;16;020;Arith;442;11;453
84;Auvergne-Rhône-Alpes;73;2;11;021;Arvillard;854;15;869
84;Auvergne-Rhône-Alpes;73;2;14;022;Attignat-Oncin;538;15;553
84;Auvergne-Rhône-Alpes;73;3;10;023;Aussois;679;22;701
84;Auvergne-Rhône-Alpes;73;1;13;024;Les Avanchers-Valmorel;784;22;806
84;Auvergne-Rhône-Alpes;73;2;06;025;Avressieux;522;11;533
84;Auvergne-Rhône-Alpes;73;3;10;026;Avrieux;388;14;402
84;Auvergne-Rhône-Alpes;73;2;14;027;Ayn;376;5;381
84;Auvergne-Rhône-Alpes;73;2;06;028;La Balme;320;3;323
84;Auvergne-Rhône-Alpes;73;2;15;029;Barberaz;4717;126;4843
84;Auvergne-Rhône-Alpes;73;2;16;030;Barby;3414;39;3453
84;Auvergne-Rhône-Alpes;73;2;16;031;Bassens;4466;121;4587
84;Auvergne-Rhône-Alpes;73;1;03;032;La Bâthie;2194;42;2236
84;Auvergne-Rhône-Alpes;73;2;14;033;La Bauche;505;5;510
84;Auvergne-Rhône-Alpes;73;1;19;034;Beaufort;2040;91;2131
84;Auvergne-Rhône-Alpes;73;2;16;036;Bellecombe-en-Bauges;668;18;686
84;Auvergne-Rhône-Alpes;73;1;13;257;Les Belleville;3494;117;3611
84;Auvergne-Rhône-Alpes;73;2;14;039;Belmont-Tramonet;561;13;574
84;Auvergne-Rhône-Alpes;73;3;10;040;Bessans;353;8;361
84;Auvergne-Rhône-Alpes;73;2;18;041;Betton-Bettonet;313;8;321
84;Auvergne-Rhône-Alpes;73;2;06;042;Billième;269;6;275
84;Auvergne-Rhône-Alpes;73;2;01;043;La Biolle;2578;32;2610
84;Auvergne-Rhône-Alpes;73;3;10;047;Bonneval-sur-Arc;261;8;269
84;Auvergne-Rhône-Alpes;73;1;04;048;Bonvillard;359;9;368
84;Auvergne-Rhône-Alpes;73;3;18;049;Bonvillaret;143;0;143
84;Auvergne-Rhône-Alpes;73;2;12;050;Bourdeau;555;20;575
84;Auvergne-Rhône-Alpes;73;1;05;054;Bourg-Saint-Maurice;7302;400;7702
84;Auvergne-Rhône-Alpes;73;2;12;051;Le Bourget-du-Lac;4866;98;4964
84;Auvergne-Rhône-Alpes;73;2;11;052;Bourget-en-Huile;147;6;153
84;Auvergne-Rhône-Alpes;73;2;18;053;Bourgneuf;682;10;692
84;Auvergne-Rhône-Alpes;73;1;13;055;Bozel;1841;57;1898
84;Auvergne-Rhône-Alpes;73;1;13;057;Brides-les-Bains;506;12;518
84;Auvergne-Rhône-Alpes;73;2;14;058;La Bridoire;1272;19;1291
84;Auvergne-Rhône-Alpes;73;2;01;059;Brison-Saint-Innocent;2131;71;2202
84;Auvergne-Rhône-Alpes;73;1;19;061;Césarches;427;15;442
84;Auvergne-Rhône-Alpes;73;1;03;063;Cevins;743;15;758
84;Auvergne-Rhône-Alpes;73;2;15;064;Challes-les-Eaux;5590;274;5864
84;Auvergne-Rhône-Alpes;73;2;99;065;Chambéry;58919;1562;60481
84;Auvergne-Rhône-Alpes;73;3;17;067;La Chambre;1164;23;1187
84;Auvergne-Rhône-Alpes;73;2;18;068;Chamousset;587;21;608
84;Auvergne-Rhône-Alpes;73;2;18;069;Chamoux-sur-Gelon;940;18;958
84;Auvergne-Rhône-Alpes;73;2;18;072;Champ-Laurent;36;2;38
84;Auvergne-Rhône-Alpes;73;2;06;070;Champagneux;688;8;696
84;Auvergne-Rhône-Alpes;73;1;13;071;Champagny-en-Vanoise;579;22;601
84;Auvergne-Rhône-Alpes;73;2;06;073;Chanaz;512;11;523
84;Auvergne-Rhône-Alpes;73;3;17;074;La Chapelle;331;4;335
84;Auvergne-Rhône-Alpes;73;2;11;075;La Chapelle-Blanche;561;15;576
84;Auvergne-Rhône-Alpes;73;2;12;076;La Chapelle-du-Mont-du-Chat;257;4;261
84;Auvergne-Rhône-Alpes;73;2;06;078;La Chapelle-Saint-Martin;148;6;154
84;Auvergne-Rhône-Alpes;73;1;05;077;Les Chapelles;561;9;570
84;Auvergne-Rhône-Alpes;73;2;18;079;Châteauneuf;894;16;910
84;Auvergne-Rhône-Alpes;73;2;16;081;Le Châtelard;670;44;714
84;Auvergne-Rhône-Alpes;73;2;11;082;La Chavanne;685;34;719
84;Auvergne-Rhône-Alpes;73;3;17;083;Les Chavannes-en-Maurienne;246;3;249
84;Auvergne-Rhône-Alpes;73;2;11;084;Chignin;862;28;890
84;Auvergne-Rhône-Alpes;73;2;06;085;Chindrieux;1361;21;1382
84;Auvergne-Rhône-Alpes;73;1;04;086;Cléry;404;12;416
84;Auvergne-Rhône-Alpes;73;2;09;087;Cognin;6204;177;6381
84;Auvergne-Rhône-Alpes;73;1;19;088;Cohennoz;161;8;169
84;Auvergne-Rhône-Alpes;73;2;18;089;Coise-Saint-Jean-Pied-Gauthier;1243;21;1264
84;Auvergne-Rhône-Alpes;73;2;16;090;La Compôte;257;6;263
84;Auvergne-Rhône-Alpes;73;2;06;091;Conjux;201;1;202
84;Auvergne-Rhône-Alpes;73;2;14;092;Corbel;157;4;161
84;Auvergne-Rhône-Alpes;73;1;13;227;Courchevel;2361;59;2420
84;Auvergne-Rhône-Alpes;73;1;19;094;Crest-Voland;341;14;355
84;Auvergne-Rhône-Alpes;73;2;11;095;La Croix-de-la-Rochette;365;8;373
84;Auvergne-Rhône-Alpes;73;2;18;096;Cruet;1038;19;1057
84;Auvergne-Rhône-Alpes;73;2;16;097;Curienne;682;21;703
84;Auvergne-Rhône-Alpes;73;2;16;098;Les Déserts;795;22;817
84;Auvergne-Rhône-Alpes;73;2;11;099;Détrier;427;4;431
84;Auvergne-Rhône-Alpes;73;2;14;100;Domessin;1855;41;1896
84;Auvergne-Rhône-Alpes;73;2;16;101;Doucy-en-Bauges;95;3;98
84;Auvergne-Rhône-Alpes;73;2;12;103;Drumettaz-Clarafond;2807;79;2886
84;Auvergne-Rhône-Alpes;73;2;14;104;Dullin;444;5;449
84;Auvergne-Rhône-Alpes;73;2;14;105;Les Échelles;1223;16;1239
84;Auvergne-Rhône-Alpes;73;2;16;106;École;291;6;297
84;Auvergne-Rhône-Alpes;73;2;01;010;Entrelacs;6268;131;6399
84;Auvergne-Rhône-Alpes;73;2;14;107;Entremont-le-Vieux;649;8;657
84;Auvergne-Rhône-Alpes;73;3;18;109;Épierre;759;10;769
84;Auvergne-Rhône-Alpes;73;1;03;110;Esserts-Blay;809;14;823
84;Auvergne-Rhône-Alpes;73;1;13;113;Feissons-sur-Salins;182;3;185
84;Auvergne-Rhône-Alpes;73;1;19;114;Flumet;810;29;839
84;Auvergne-Rhône-Alpes;73;3;17;116;Fontcouverte-la-Toussuire;510;14;524
84;Auvergne-Rhône-Alpes;73;3;10;117;Fourneaux;676;9;685
84;Auvergne-Rhône-Alpes;73;3;10;119;Freney;103;3;106
84;Auvergne-Rhône-Alpes;73;2;18;120;Fréterive;576;17;593
84;Auvergne-Rhône-Alpes;73;1;04;121;Frontenex;1898;41;1939
84;Auvergne-Rhône-Alpes;73;2;06;122;Gerbaix;401;15;416
84;Auvergne-Rhône-Alpes;73;1;19;123;La Giettaz;403;16;419
84;Auvergne-Rhône-Alpes;73;1;04;124;Gilly-sur-Isère;3013;76;3089
84;Auvergne-Rhône-Alpes;73;1;13;003;Grand-Aigueblanche;3850;112;3962
84;Auvergne-Rhône-Alpes;73;2;01;128;Grésy-sur-Aix;4545;101;4646
84;Auvergne-Rhône-Alpes;73;1;04;129;Grésy-sur-Isère;1242;31;1273
84;Auvergne-Rhône-Alpes;73;1;04;130;Grignon;2119;38;2157
84;Auvergne-Rhône-Alpes;73;1;13;131;Hautecour;307;13;320
84;Auvergne-Rhône-Alpes;73;1;19;132;Hauteluce;757;20;777
84;Auvergne-Rhône-Alpes;73;2;18;133;Hauteville;352;8;360
84;Auvergne-Rhône-Alpes;73;2;08;137;Jacob-Bellecombette;3984;77;4061
84;Auvergne-Rhône-Alpes;73;3;17;138;Jarrier;503;13;516
84;Auvergne-Rhône-Alpes;73;2;16;139;Jarsy;267;12;279
84;Auvergne-Rhône-Alpes;73;2;06;140;Jongieux;293;8;301
84;Auvergne-Rhône-Alpes;73;2;11;141;Laissaud;671;14;685
84;Auvergne-Rhône-Alpes;73;1;05;142;Landry;825;20;845
84;Auvergne-Rhône-Alpes;73;1;13;187;La Léchère;2586;55;2641
84;Auvergne-Rhône-Alpes;73;2;14;145;Lépin-le-Lac;454;6;460
84;Auvergne-Rhône-Alpes;73;2;16;146;Lescheraines;764;15;779
84;Auvergne-Rhône-Alpes;73;2;06;147;Loisieux;205;0;205
84;Auvergne-Rhône-Alpes;73;2;06;149;Lucey;318;11;329
84;Auvergne-Rhône-Alpes;73;2;06;152;Marcieux;190;5;195
84;Auvergne-Rhône-Alpes;73;1;19;153;Marthod;1367;31;1398
84;Auvergne-Rhône-Alpes;73;1;03;154;Mercury;3088;86;3174
84;Auvergne-Rhône-Alpes;73;2;12;155;Méry;1803;38;1841
84;Auvergne-Rhône-Alpes;73;2;06;156;Meyrieux-Trouet;311;6;317
84;Auvergne-Rhône-Alpes;73;3;10;157;Modane;3097;138;3235
84;Auvergne-Rhône-Alpes;73;2;11;159;Les Mollettes;816;12;828
84;Auvergne-Rhône-Alpes;73;2;14;160;Montagnole;887;22;909
84;Auvergne-Rhône-Alpes;73;1;13;161;Montagny;661;26;687
84;Auvergne-Rhône-Alpes;73;1;04;162;Montailleur;679;23;702
84;Auvergne-Rhône-Alpes;73;2;01;164;Montcel;999;60;1059
84;Auvergne-Rhône-Alpes;73;2;18;166;Montendry;58;2;60
84;Auvergne-Rhône-Alpes;73;3;18;168;Montgilbert;123;1;124
84;Auvergne-Rhône-Alpes;73;1;04;170;Monthion;550;11;561
84;Auvergne-Rhône-Alpes;73;2;11;171;Montmélian;4123;77;4200
84;Auvergne-Rhône-Alpes;73;3;17;173;Montricher-Albanne;471;10;481
84;Auvergne-Rhône-Alpes;73;3;18;175;Montsapey;63;0;63
84;Auvergne-Rhône-Alpes;73;1;05;176;Montvalezan;686;21;707
84;Auvergne-Rhône-Alpes;73;3;17;177;Montvernier;230;9;239
84;Auvergne-Rhône-Alpes;73;2;16;178;La Motte-en-Bauges;498;11;509
84;Auvergne-Rhône-Alpes;73;2;12;179;La Motte-Servolex;11826;564;12390
84;Auvergne-Rhône-Alpes;73;2;06;180;Motz;437;6;443
84;Auvergne-Rhône-Alpes;73;1;13;181;Moûtiers;3501;457;3958
84;Auvergne-Rhône-Alpes;73;2;02;182;Mouxy;2234;50;2284
84;Auvergne-Rhône-Alpes;73;2;11;183;Myans;1236;33;1269
84;Auvergne-Rhône-Alpes;73;2;14;184;Nances;490;10;500
84;Auvergne-Rhône-Alpes;73;1;19;186;Notre-Dame-de-Bellecombe;479;14;493
84;Auvergne-Rhône-Alpes;73;1;04;188;Notre-Dame-des-Millières;1031;23;1054
84;Auvergne-Rhône-Alpes;73;3;17;189;Notre-Dame-du-Cruet;226;3;229
84;Auvergne-Rhône-Alpes;73;1;13;190;Notre-Dame-du-Pré;249;5;254
84;Auvergne-Rhône-Alpes;73;2;06;191;Novalaise;2071;60;2131
84;Auvergne-Rhône-Alpes;73;2;16;192;Le Noyer;214;5;219
84;Auvergne-Rhône-Alpes;73;2;06;193;Ontex;105;3;108
84;Auvergne-Rhône-Alpes;73;3;10;194;Orelle;349;12;361
84;Auvergne-Rhône-Alpes;73;1;19;196;Pallud;780;19;799
84;Auvergne-Rhône-Alpes;73;1;05;197;Peisey-Nancroix;642;25;667
84;Auvergne-Rhône-Alpes;73;1;05;150;La Plagne Tarentaise;3638;96;3734
84;Auvergne-Rhône-Alpes;73;2;11;200;Planaise;545;7;552
84;Auvergne-Rhône-Alpes;73;1;13;201;Planay;428;12;440
84;Auvergne-Rhône-Alpes;73;1;04;202;Plancherine;439;10;449
84;Auvergne-Rhône-Alpes;73;2;14;204;Le Pont-de-Beauvoisin;2074;32;2106
84;Auvergne-Rhône-Alpes;73;2;11;205;Le Pontet;122;5;127
84;Auvergne-Rhône-Alpes;73;2;11;151;Porte-de-Savoie;3680;85;3765
84;Auvergne-Rhône-Alpes;73;1;13;206;Pralognan-la-Vanoise;724;23;747
84;Auvergne-Rhône-Alpes;73;2;11;207;Presle;418;12;430
84;Auvergne-Rhône-Alpes;73;2;01;208;Pugny-Chatenod;951;40;991
84;Auvergne-Rhône-Alpes;73;2;16;210;Puygros;385;5;390
84;Auvergne-Rhône-Alpes;73;1;19;211;Queige;805;26;831
84;Auvergne-Rhône-Alpes;73;2;15;213;La Ravoire;8457;588;9045
84;Auvergne-Rhône-Alpes;73;2;06;214;Rochefort;232;10;242
84;Auvergne-Rhône-Alpes;73;1;03;216;Rognaix;478;8;486
84;Auvergne-Rhône-Alpes;73;2;11;217;Rotherens;367;3;370
84;Auvergne-Rhône-Alpes;73;2;06;218;Ruffieux;837;16;853
84;Auvergne-Rhône-Alpes;73;3;18;220;Saint-Alban-d'Hurtières;356;10;366
84;Auvergne-Rhône-Alpes;73;2;14;219;Saint-Alban-de-Montbel;643;16;659
84;Auvergne-Rhône-Alpes;73;3;17;221;Saint-Alban-des-Villards;100;3;103
84;Auvergne-Rhône-Alpes;73;2;16;222;Saint-Alban-Leysse;6007;206;6213
84;Auvergne-Rhône-Alpes;73;3;10;223;Saint-André;457;6;463
84;Auvergne-Rhône-Alpes;73;3;17;224;Saint-Avre;868;10;878
84;Auvergne-Rhône-Alpes;73;2;15;225;Saint-Baldoph;2809;93;2902
84;Auvergne-Rhône-Alpes;73;2;14;226;Saint-Béron;1671;21;1692
84;Auvergne-Rhône-Alpes;73;2;14;228;Saint-Cassin;838;22;860
84;Auvergne-Rhône-Alpes;73;2;14;229;Saint-Christophe;531;13;544
84;Auvergne-Rhône-Alpes;73;3;17;230;Saint-Colomban-des-Villards;135;1;136
84;Auvergne-Rhône-Alpes;73;3;17;231;Saint-Étienne-de-Cuines;1195;23;1218
84;Auvergne-Rhône-Alpes;73;2;14;233;Saint-Franc;167;16;183
84;Auvergne-Rhône-Alpes;73;2;16;234;Saint-François-de-Sales;150;4;154
84;Auvergne-Rhône-Alpes;73;3;17;235;Saint François Longchamp;517;6;523
84;Auvergne-Rhône-Alpes;73;2;06;236;Saint-Genix-les-Villages;2944;65;3009
84;Auvergne-Rhône-Alpes;73;3;18;237;Saint-Georges-d'Hurtières;339;3;342
84;Auvergne-Rhône-Alpes;73;3;17;242;Saint-Jean-d'Arves;266;9;275
84;Auvergne-Rhône-Alpes;73;2;16;243;Saint-Jean-d'Arvey;1697;56;1753
84;Auvergne-Rhône-Alpes;73;2;06;245;Saint-Jean-de-Chevelu;813;17;830
84;Auvergne-Rhône-Alpes;73;2;14;246;Saint-Jean-de-Couz;291;8;299
84;Auvergne-Rhône-Alpes;73;2;18;247;Saint-Jean-de-la-Porte;937;76;1013
84;Auvergne-Rhône-Alpes;73;3;17;248;Saint-Jean-de-Maurienne;7746;400;8146
84;Auvergne-Rhône-Alpes;73;2;15;249;Saint-Jeoire-Prieuré;1704;41;1745
84;Auvergne-Rhône-Alpes;73;3;17;250;Saint-Julien-Mont-Denis;1618;45;1663
84;Auvergne-Rhône-Alpes;73;3;18;252;Saint-Léger;224;5;229
84;Auvergne-Rhône-Alpes;73;1;13;253;Saint-Marcel;607;8;615
84;Auvergne-Rhône-Alpes;73;3;10;256;Saint-Martin-d'Arc;361;5;366
84;Auvergne-Rhône-Alpes;73;3;10;258;Saint-Martin-de-la-Porte;679;18;697
84;Auvergne-Rhône-Alpes;73;3;17;259;Saint-Martin-sur-la-Chambre;552;14;566
84;Auvergne-Rhône-Alpes;73;3;10;261;Saint-Michel-de-Maurienne;2461;270;2731
84;Auvergne-Rhône-Alpes;73;1;19;262;Saint-Nicolas-la-Chapelle;454;30;484
84;Auvergne-Rhône-Alpes;73;2;01;263;Saint-Offenge;1104;21;1125
84;Auvergne-Rhône-Alpes;73;2;01;265;Saint-Ours;677;18;695
84;Auvergne-Rhône-Alpes;73;3;17;267;Saint-Pancrace;290;11;301
84;Auvergne-Rhône-Alpes;73;2;06;269;Saint-Paul;686;12;698
84;Auvergne-Rhône-Alpes;73;1;03;268;Saint-Paul-sur-Isère;524;66;590
84;Auvergne-Rhône-Alpes;73;2;18;270;Saint-Pierre-d'Albigny;3943;95;4038
84;Auvergne-Rhône-Alpes;73;2;06;271;Saint-Pierre-d'Alvey;292;9;301
84;Auvergne-Rhône-Alpes;73;2;14;274;Saint-Pierre-d'Entremont;457;15;472
84;Auvergne-Rhône-Alpes;73;3;18;272;Saint-Pierre-de-Belleville;171;4;175
84;Auvergne-Rhône-Alpes;73;2;06;273;Saint-Pierre-de-Curtille;491;5;496
84;Auvergne-Rhône-Alpes;73;2;14;275;Saint-Pierre-de-Genebroz;334;9;343
84;Auvergne-Rhône-Alpes;73;2;11;276;Saint-Pierre-de-Soucy;437;20;457
84;Auvergne-Rhône-Alpes;73;3;17;278;Saint-Rémy-de-Maurienne;1253;22;1275
84;Auvergne-Rhône-Alpes;73;3;17;280;Saint-Sorlin-d'Arves;331;8;339
84;Auvergne-Rhône-Alpes;73;2;14;281;Saint-Sulpice;760;19;779
84;Auvergne-Rhône-Alpes;73;2;14;282;Saint-Thibaud-de-Couz;1060;20;1080
84;Auvergne-Rhône-Alpes;73;1;04;283;Saint-Vital;694;13;707
84;Auvergne-Rhône-Alpes;73;1;05;232;Sainte-Foy-Tarentaise;768;15;783
84;Auvergne-Rhône-Alpes;73;2;11;240;Sainte-Hélène-du-Lac;779;20;799
84;Auvergne-Rhône-Alpes;73;1;04;241;Sainte-Hélène-sur-Isère;1183;20;1203
84;Auvergne-Rhône-Alpes;73;2;06;254;Sainte-Marie-d'Alvey;117;2;119
84;Auvergne-Rhône-Alpes;73;3;17;255;Sainte-Marie-de-Cuines;803;20;823
84;Auvergne-Rhône-Alpes;73;2;16;277;Sainte-Reine;159;6;165
84;Auvergne-Rhône-Alpes;73;1;13;284;Salins-Fontaine;1011;19;1030
84;Auvergne-Rhône-Alpes;73;1;05;285;Séez;2355;74;2429
84;Auvergne-Rhône-Alpes;73;2;06;286;Serrières-en-Chautagne;1208;22;1230
84;Auvergne-Rhône-Alpes;73;2;07;288;Sonnaz;1857;36;1893
84;Auvergne-Rhône-Alpes;73;2;11;289;La Table;448;8;456
84;Auvergne-Rhône-Alpes;73;1;19;292;Thénésol;310;7;317
84;Auvergne-Rhône-Alpes;73;2;16;293;Thoiry;457;11;468
84;Auvergne-Rhône-Alpes;73;2;16;294;La Thuile;330;7;337
84;Auvergne-Rhône-Alpes;73;1;05;296;Tignes;2196;45;2241
84;Auvergne-Rhône-Alpes;73;3;17;135;La Tour-en-Maurienne;1074;30;1104
84;Auvergne-Rhône-Alpes;73;1;04;297;Tournon;611;20;631
84;Auvergne-Rhône-Alpes;73;1;03;298;Tours-en-Savoie;959;11;970
84;Auvergne-Rhône-Alpes;73;2;06;299;Traize;318;6;324
84;Auvergne-Rhône-Alpes;73;2;02;300;Tresserve;3014;105;3119
84;Auvergne-Rhône-Alpes;73;2;01;301;Trévignin;776;20;796
84;Auvergne-Rhône-Alpes;73;2;11;302;La Trinité;345;2;347
84;Auvergne-Rhône-Alpes;73;1;19;303;Ugine;7039;293;7332
84;Auvergne-Rhône-Alpes;73;3;10;290;Val-Cenis;2088;38;2126
84;Auvergne-Rhône-Alpes;73;3;18;212;Val-d'Arc;2008;33;2041
84;Auvergne-Rhône-Alpes;73;1;05;304;Val-d'Isère;1555;27;1582
84;Auvergne-Rhône-Alpes;73;2;11;215;Valgelon-La Rochette;4111;104;4215
84;Auvergne-Rhône-Alpes;73;3;10;306;Valloire;1083;27;1110
84;Auvergne-Rhône-Alpes;73;3;10;307;Valmeinier;515;3;518
84;Auvergne-Rhône-Alpes;73;1;19;308;Venthon;621;20;641
84;Auvergne-Rhône-Alpes;73;2;14;309;Verel-de-Montbel;303;6;309
84;Auvergne-Rhône-Alpes;73;2;16;310;Verel-Pragondran;476;12;488
84;Auvergne-Rhône-Alpes;73;2;11;311;Le Verneil;102;1;103
84;Auvergne-Rhône-Alpes;73;1;04;312;Verrens-Arvey;900;30;930
84;Auvergne-Rhône-Alpes;73;2;06;313;Verthemex;229;1;230
84;Auvergne-Rhône-Alpes;73;2;11;314;Villard-d'Héry;268;8;276
84;Auvergne-Rhône-Alpes;73;2;18;315;Villard-Léger;473;8;481
84;Auvergne-Rhône-Alpes;73;2;11;316;Villard-Sallet;290;5;295
84;Auvergne-Rhône-Alpes;73;1;19;317;Villard-sur-Doron;712;28;740
84;Auvergne-Rhône-Alpes;73;3;17;318;Villarembert;247;9;256
84;Auvergne-Rhône-Alpes;73;3;17;320;Villargondran;862;25;887
84;Auvergne-Rhône-Alpes;73;3;10;322;Villarodin-Bourget;529;11;540
84;Auvergne-Rhône-Alpes;73;1;05;323;Villaroger;366;15;381
84;Auvergne-Rhône-Alpes;73;2;11;324;Villaroux;203;9;212
84;Auvergne-Rhône-Alpes;73;2;14;326;Vimines;2028;38;2066
84;Auvergne-Rhône-Alpes;73;2;06;327;Vions;403;6;409
84;Auvergne-Rhône-Alpes;73;2;12;328;Viviers-du-Lac;2235;44;2279
84;Auvergne-Rhône-Alpes;73;2;12;329;Voglans;1897;36;1933
84;Auvergne-Rhône-Alpes;73;2;06;330;Yenne;2978;34;3012
84;Auvergne-Rhône-Alpes;74;4;07;001;Abondance;1439;116;1555
84;Auvergne-Rhône-Alpes;74;1;12;002;Alby-sur-Chéran;2579;54;2633
84;Auvergne-Rhône-Alpes;74;1;08;003;Alex;1072;33;1105
84;Auvergne-Rhône-Alpes;74;1;12;004;Allèves;411;8;419
84;Auvergne-Rhône-Alpes;74;4;17;005;Allinges;4459;118;4577
84;Auvergne-Rhône-Alpes;74;3;11;006;Allonzier-la-Caille;2071;28;2099
84;Auvergne-Rhône-Alpes;74;2;11;007;Amancy;2665;54;2719
84;Auvergne-Rhône-Alpes;74;3;04;008;Ambilly;6385;85;6470
84;Auvergne-Rhône-Alpes;74;3;11;009;Andilly;900;19;919
84;Auvergne-Rhône-Alpes;74;1;99;010;Annecy;126924;3251;130175
84;Auvergne-Rhône-Alpes;74;3;04;012;Annemasse;35712;393;36105
84;Auvergne-Rhône-Alpes;74;4;15;013;Anthy-sur-Léman;2171;89;2260
84;Auvergne-Rhône-Alpes;74;2;14;014;Arâches-la-Frasse;1910;46;1956
84;Auvergne-Rhône-Alpes;74;3;11;015;Arbusigny;1115;23;1138
84;Auvergne-Rhône-Alpes;74;3;13;016;Archamps;2556;36;2592
84;Auvergne-Rhône-Alpes;74;2;05;018;Arenthon;1741;44;1785
84;Auvergne-Rhône-Alpes;74;1;03;019;Argonay;3025;250;3275
84;Auvergne-Rhône-Alpes;74;4;17;020;Armoy;1295;54;1349
84;Auvergne-Rhône-Alpes;74;3;09;021;Arthaz-Pont-Notre-Dame;1577;30;1607
84;Auvergne-Rhône-Alpes;74;2;05;024;Ayse;2145;59;2204
84;Auvergne-Rhône-Alpes;74;4;15;025;Ballaison;1470;20;1490
84;Auvergne-Rhône-Alpes;74;1;01;026;La Balme-de-Sillingy;5037;162;5199
84;Auvergne-Rhône-Alpes;74;1;08;027;La Balme-de-Thuy;462;5;467
84;Auvergne-Rhône-Alpes;74;3;13;029;Bassy;413;14;427
84;Auvergne-Rhône-Alpes;74;4;07;030;La Baume;309;2;311
84;Auvergne-Rhône-Alpes;74;3;13;031;Beaumont;2838;67;2905
84;Auvergne-Rhône-Alpes;74;4;17;032;Bellevaux;1294;40;1334
84;Auvergne-Rhône-Alpes;74;4;07;033;Bernex;1352;28;1380
84;Auvergne-Rhône-Alpes;74;4;07;034;Le Biot;572;14;586
84;Auvergne-Rhône-Alpes;74;1;12;035;Bloye;609;25;634
84;Auvergne-Rhône-Alpes;74;1;08;036;Bluffy;391;12;403
84;Auvergne-Rhône-Alpes;74;4;15;037;Boëge;1765;57;1822
84;Auvergne-Rhône-Alpes;74;4;15;038;Bogève;1111;26;1137
84;Auvergne-Rhône-Alpes;74;3;09;040;Bonne;3218;146;3364
84;Auvergne-Rhône-Alpes;74;4;07;041;Bonnevaux;277;7;284
84;Auvergne-Rhône-Alpes;74;2;05;042;Bonneville;12608;402;13010
84;Auvergne-Rhône-Alpes;74;4;15;043;Bons-en-Chablais;5631;105;5736
84;Auvergne-Rhône-Alpes;74;3;13;044;Bossey;1018;14;1032
84;Auvergne-Rhône-Alpes;74;1;08;045;Le Bouchet-Mont-Charvin;242;3;245
84;Auvergne-Rhône-Alpes;74;1;12;046;Boussy;505;12;517
84;Auvergne-Rhône-Alpes;74;4;15;048;Brenthonne;1037;20;1057
84;Auvergne-Rhône-Alpes;74;2;05;049;Brizon;485;2;487
84;Auvergne-Rhône-Alpes;74;4;15;050;Burdignin;628;15;643
84;Auvergne-Rhône-Alpes;74;3;11;051;Cercier;678;11;689
84;Auvergne-Rhône-Alpes;74;3;11;052;Cernex;1010;16;1026
84;Auvergne-Rhône-Alpes;74;4;17;053;Cervens;1205;21;1226
84;Auvergne-Rhône-Alpes;74;1;12;054;Chainaz-les-Frasses;728;27;755
84;Auvergne-Rhône-Alpes;74;3;13;055;Challonges;536;13;549
84;Auvergne-Rhône-Alpes;74;2;10;056;Chamonix-Mont-Blanc;8611;385;8996
84;Auvergne-Rhône-Alpes;74;4;07;057;Champanges;1015;28;1043
84;Auvergne-Rhône-Alpes;74;1;12;061;Chapeiry;812;31;843
84;Auvergne-Rhône-Alpes;74;4;07;058;La Chapelle-d'Abondance;911;17;928
84;Auvergne-Rhône-Alpes;74;2;11;059;La Chapelle-Rambaud;256;6;262
84;Auvergne-Rhône-Alpes;74;1;16;060;La Chapelle-Saint-Maurice;119;0;119
84;Auvergne-Rhône-Alpes;74;1;03;062;Charvonnex;1356;25;1381
84;Auvergne-Rhône-Alpes;74;4;07;063;Châtel;1246;41;1287
84;Auvergne-Rhône-Alpes;74;2;06;064;Châtillon-sur-Cluses;1245;46;1291
84;Auvergne-Rhône-Alpes;74;3;13;065;Chaumont;492;14;506
84;Auvergne-Rhône-Alpes;74;3;13;066;Chavannaz;236;2;238
84;Auvergne-Rhône-Alpes;74;1;16;067;Chavanod;2643;167;2810
84;Auvergne-Rhône-Alpes;74;3;13;068;Chêne-en-Semine;496;8;504
84;Auvergne-Rhône-Alpes;74;3;13;069;Chênex;828;9;837
84;Auvergne-Rhône-Alpes;74;4;15;070;Chens-sur-Léman;2776;34;2810
84;Auvergne-Rhône-Alpes;74;3;13;071;Chessenaz;214;7;221
84;Auvergne-Rhône-Alpes;74;1;08;072;Chevaline;203;7;210
84;Auvergne-Rhône-Alpes;74;4;07;073;Chevenoz;607;11;618
84;Auvergne-Rhône-Alpes;74;3;13;074;Chevrier;545;6;551
84;Auvergne-Rhône-Alpes;74;3;13;075;Chilly;1382;21;1403
84;Auvergne-Rhône-Alpes;74;1;01;076;Choisy;1604;29;1633
84;Auvergne-Rhône-Alpes;74;3;13;077;Clarafond-Arcine;1033;26;1059
84;Auvergne-Rhône-Alpes;74;1;08;079;Les Clefs;659;6;665
84;Auvergne-Rhône-Alpes;74;3;13;078;Clermont;409;6;415
84;Auvergne-Rhône-Alpes;74;1;08;080;La Clusaz;1734;55;1789
84;Auvergne-Rhône-Alpes;74;2;06;081;Cluses;17059;395;17454
84;Auvergne-Rhône-Alpes;74;3;13;082;Collonges-sous-Salève;3979;117;4096
84;Auvergne-Rhône-Alpes;74;2;14;083;Combloux;2106;113;2219
84;Auvergne-Rhône-Alpes;74;3;13;086;Contamine-Sarzin;704;13;717
84;Auvergne-Rhône-Alpes;74;2;05;087;Contamine-sur-Arve;2083;149;2232
84;Auvergne-Rhône-Alpes;74;2;10;085;Les Contamines-Montjoie;1167;49;1216
84;Auvergne-Rhône-Alpes;74;3;11;088;Copponex;1154;22;1176
84;Auvergne-Rhône-Alpes;74;2;14;089;Cordon;973;26;999
84;Auvergne-Rhône-Alpes;74;2;11;090;Cornier;1333;19;1352
84;Auvergne-Rhône-Alpes;74;2;07;091;La Côte-d'Arbroz;339;2;341
84;Auvergne-Rhône-Alpes;74;3;09;094;Cranves-Sales;6793;167;6960
84;Auvergne-Rhône-Alpes;74;1;12;095;Crempigny-Bonneguête;316;2;318
84;Auvergne-Rhône-Alpes;74;3;11;096;Cruseilles;4431;291;4722
84;Auvergne-Rhône-Alpes;74;1;12;097;Cusy;1850;55;1905
84;Auvergne-Rhône-Alpes;74;1;11;098;Cuvat;1391;48;1439
84;Auvergne-Rhône-Alpes;74;2;14;099;Demi-Quartier;909;33;942
84;Auvergne-Rhône-Alpes;74;3;13;100;Desingy;806;16;822
84;Auvergne-Rhône-Alpes;74;3;13;101;Dingy-en-Vuache;682;21;703
84;Auvergne-Rhône-Alpes;74;1;08;102;Dingy-Saint-Clair;1433;41;1474
84;Auvergne-Rhône-Alpes;74;2;14;103;Domancy;2113;73;2186
84;Auvergne-Rhône-Alpes;74;1;08;104;Doussard;3592;87;3679
84;Auvergne-Rhône-Alpes;74;4;15;105;Douvaine;5948;71;6019
84;Auvergne-Rhône-Alpes;74;4;17;106;Draillant;859;30;889
84;Auvergne-Rhône-Alpes;74;3;13;107;Droisy;159;5;164
84;Auvergne-Rhône-Alpes;74;1;16;108;Duingt;972;20;992
84;Auvergne-Rhône-Alpes;74;3;13;109;Éloise;864;18;882
84;Auvergne-Rhône-Alpes;74;1;16;111;Entrevernes;214;3;217
84;Auvergne-Rhône-Alpes;74;1;03;112;Epagny Metz-Tessy;7824;189;8013
84;Auvergne-Rhône-Alpes;74;4;07;114;Essert-Romand;513;6;519
84;Auvergne-Rhône-Alpes;74;2;11;116;Etaux;1979;68;2047
84;Auvergne-Rhône-Alpes;74;1;12;117;Étercy;813;20;833
84;Auvergne-Rhône-Alpes;74;3;09;118;Étrembières;2453;25;2478
84;Auvergne-Rhône-Alpes;74;4;07;119;Évian-les-Bains;9098;257;9355
84;Auvergne-Rhône-Alpes;74;4;15;121;Excenevex;1104;16;1120
84;Auvergne-Rhône-Alpes;74;2;05;122;Faucigny;628;16;644
84;Auvergne-Rhône-Alpes;74;1;08;123;Faverges-Seythenex;7606;250;7856
84;Auvergne-Rhône-Alpes;74;3;13;124;Feigères;1682;33;1715
84;Auvergne-Rhône-Alpes;74;4;15;126;Fessy;923;26;949
84;Auvergne-Rhône-Alpes;74;4;07;127;Féternes;1418;43;1461
84;Auvergne-Rhône-Alpes;74;1;03;282;Fillière;9255;233;9488
84;Auvergne-Rhône-Alpes;74;3;05;128;Fillinges;3413;86;3499
84;Auvergne-Rhône-Alpes;74;4;07;129;La Forclaz;233;4;237
84;Auvergne-Rhône-Alpes;74;3;13;130;Franclens;533;43;576
84;Auvergne-Rhône-Alpes;74;3;13;131;Frangy;2119;40;2159
84;Auvergne-Rhône-Alpes;74;3;09;133;Gaillard;10619;112;10731
84;Auvergne-Rhône-Alpes;74;2;07;134;Les Gets;1239;27;1266
84;Auvergne-Rhône-Alpes;74;1;08;135;Giez;541;8;549
84;Auvergne-Rhône-Alpes;74;2;89;212;Glières-Val-de-Borne;1798;33;1831
84;Auvergne-Rhône-Alpes;74;1;08;136;Le Grand-Bornand;2118;49;2167
84;Auvergne-Rhône-Alpes;74;1;03;137;Groisy;3629;140;3769
84;Auvergne-Rhône-Alpes;74;1;12;138;Gruffy;1567;64;1631
84;Auvergne-Rhône-Alpes;74;4;15;139;Habère-Lullin;1010;30;1040
84;Auvergne-Rhône-Alpes;74;4;15;140;Habère-Poche;1465;25;1490
84;Auvergne-Rhône-Alpes;74;1;12;141;Hauteville-sur-Fier;958;24;982
84;Auvergne-Rhône-Alpes;74;1;12;142;Héry-sur-Alby;975;31;1006
84;Auvergne-Rhône-Alpes;74;2;10;143;Les Houches;2943;77;3020
84;Auvergne-Rhône-Alpes;74;3;13;144;Jonzier-Épagny;798;20;818
84;Auvergne-Rhône-Alpes;74;3;09;145;Juvigny;639;14;653
84;Auvergne-Rhône-Alpes;74;4;07;146;Larringes;1424;43;1467
84;Auvergne-Rhône-Alpes;74;1;08;147;Lathuile;1016;25;1041
84;Auvergne-Rhône-Alpes;74;1;16;148;Leschaux;274;7;281
84;Auvergne-Rhône-Alpes;74;4;15;150;Loisin;1551;28;1579
84;Auvergne-Rhône-Alpes;74;1;12;151;Lornay;560;10;570
84;Auvergne-Rhône-Alpes;74;1;01;152;Lovagny;1286;43;1329
84;Auvergne-Rhône-Alpes;74;3;09;153;Lucinges;1625;65;1690
84;Auvergne-Rhône-Alpes;74;4;07;154;Lugrin;2435;50;2485
84;Auvergne-Rhône-Alpes;74;4;17;155;Lullin;799;21;820
84;Auvergne-Rhône-Alpes;74;4;15;156;Lully;701;13;714
84;Auvergne-Rhône-Alpes;74;4;17;157;Lyaud;1729;35;1764
84;Auvergne-Rhône-Alpes;74;3;09;158;Machilly;1086;20;1106
84;Auvergne-Rhône-Alpes;74;2;14;159;Magland;3279;68;3347
84;Auvergne-Rhône-Alpes;74;1;08;160;Manigod;1004;22;1026
84;Auvergne-Rhône-Alpes;74;2;05;162;Marcellaz;1018;18;1036
84;Auvergne-Rhône-Alpes;74;1;12;161;Marcellaz-Albanais;1906;41;1947
84;Auvergne-Rhône-Alpes;74;4;15;163;Margencel;2145;77;2222
84;Auvergne-Rhône-Alpes;74;2;05;164;Marignier;6445;172;6617
84;Auvergne-Rhône-Alpes;74;1;12;165;Marigny-Saint-Marcel;685;9;694
84;Auvergne-Rhône-Alpes;74;4;07;166;Marin;1789;51;1840
84;Auvergne-Rhône-Alpes;74;3;13;168;Marlioz;1012;12;1024
84;Auvergne-Rhône-Alpes;74;2;06;169;Marnaz;5521;116;5637
84;Auvergne-Rhône-Alpes;74;1;12;170;Massingy;875;19;894
84;Auvergne-Rhône-Alpes;74;4;15;171;Massongy;1494;33;1527
84;Auvergne-Rhône-Alpes;74;4;07;172;Maxilly-sur-Léman;1414;34;1448
84;Auvergne-Rhône-Alpes;74;2;14;173;Megève;3036;128;3164
84;Auvergne-Rhône-Alpes;74;2;05;174;Mégevette;581;24;605
84;Auvergne-Rhône-Alpes;74;4;07;175;Meillerie;317;5;322
84;Auvergne-Rhône-Alpes;74;1;08;176;Menthon-Saint-Bernard;1889;70;1959
84;Auvergne-Rhône-Alpes;74;3;11;177;Menthonnex-en-Bornes;1076;19;1095
84;Auvergne-Rhône-Alpes;74;3;13;178;Menthonnex-sous-Clermont;715;13;728
84;Auvergne-Rhône-Alpes;74;1;01;179;Mésigny;753;17;770
84;Auvergne-Rhône-Alpes;74;4;15;180;Messery;2134;47;2181
84;Auvergne-Rhône-Alpes;74;2;06;183;Mieussy;2340;59;2399
84;Auvergne-Rhône-Alpes;74;3;13;184;Minzier;1023;19;1042
84;Auvergne-Rhône-Alpes;74;3;11;185;Monnetier-Mornex;2295;34;2329
84;Auvergne-Rhône-Alpes;74;2;06;189;Mont-Saxonnex;1668;50;1718
84;Auvergne-Rhône-Alpes;74;1;16;186;Montagny-les-Lanches;705;20;725
84;Auvergne-Rhône-Alpes;74;4;07;188;Montriond;905;24;929
84;Auvergne-Rhône-Alpes;74;2;06;190;Morillon;662;14;676
84;Auvergne-Rhône-Alpes;74;4;07;191;Morzine;2785;75;2860
84;Auvergne-Rhône-Alpes;74;1;12;192;Moye;1018;38;1056
84;Auvergne-Rhône-Alpes;74;3;11;193;La Muraz;1063;11;1074
84;Auvergne-Rhône-Alpes;74;1;12;194;Mûres;784;22;806
84;Auvergne-Rhône-Alpes;74;3;13;195;Musièges;416;7;423
84;Auvergne-Rhône-Alpes;74;2;06;196;Nancy-sur-Cluses;460;15;475
84;Auvergne-Rhône-Alpes;74;3;11;197;Nangy;1618;35;1653
84;Auvergne-Rhône-Alpes;74;1;03;198;Nâves-Parmelan;969;38;1007
84;Auvergne-Rhône-Alpes;74;4;15;199;Nernier;380;7;387
84;Auvergne-Rhône-Alpes;74;4;07;200;Neuvecelle;3048;92;3140
84;Auvergne-Rhône-Alpes;74;3;13;201;Neydens;1915;44;1959
84;Auvergne-Rhône-Alpes;74;1;01;202;Nonglard;654;7;661
84;Auvergne-Rhône-Alpes;74;4;07;203;Novel;48;0;48
84;Auvergne-Rhône-Alpes;74;2;05;205;Onnion;1293;29;1322
84;Auvergne-Rhône-Alpes;74;4;17;206;Orcier;981;17;998
84;Auvergne-Rhône-Alpes;74;2;10;208;Passy;10902;417;11319
84;Auvergne-Rhône-Alpes;74;2;05;209;Peillonnex;1400;42;1442
84;Auvergne-Rhône-Alpes;74;4;17;210;Perrignier;1845;37;1882
84;Auvergne-Rhône-Alpes;74;3;11;211;Pers-Jussy;3052;90;3142
84;Auvergne-Rhône-Alpes;74;1;01;213;Poisy;8124;357;8481
84;Auvergne-Rhône-Alpes;74;2;14;215;Praz-sur-Arly;1228;36;1264
84;Auvergne-Rhône-Alpes;74;3;13;216;Présilly;960;19;979
84;Auvergne-Rhône-Alpes;74;4;07;218;Publier;7148;208;7356
84;Auvergne-Rhône-Alpes;74;1;16;219;Quintal;1238;51;1289
84;Auvergne-Rhône-Alpes;74;3;11;220;Reignier-Ésery;7994;209;8203
84;Auvergne-Rhône-Alpes;74;2;06;221;Le Reposoir;522;22;544
84;Auvergne-Rhône-Alpes;74;4;17;222;Reyvroz;510;8;518
84;Auvergne-Rhône-Alpes;74;2;06;223;La Rivière-Enverse;468;7;475
84;Auvergne-Rhône-Alpes;74;2;11;224;La Roche-sur-Foron;11339;344;11683
84;Auvergne-Rhône-Alpes;74;1;12;225;Rumilly;15379;362;15741
84;Auvergne-Rhône-Alpes;74;4;15;226;Saint-André-de-Boëge;542;16;558
84;Auvergne-Rhône-Alpes;74;3;11;228;Saint-Blaise;350;12;362
84;Auvergne-Rhône-Alpes;74;3;09;229;Saint-Cergues;3613;72;3685
84;Auvergne-Rhône-Alpes;74;1;12;231;Saint-Eusèbe;547;13;560
84;Auvergne-Rhône-Alpes;74;1;16;232;Saint-Eustache;513;26;539
84;Auvergne-Rhône-Alpes;74;1;12;233;Saint-Félix;2421;29;2450
84;Auvergne-Rhône-Alpes;74;1;08;234;Saint-Ferréol;867;22;889
84;Auvergne-Rhône-Alpes;74;3;13;235;Saint-Germain-sur-Rhône;526;13;539
84;Auvergne-Rhône-Alpes;74;2;10;236;Saint-Gervais-les-Bains;5573;129;5702
84;Auvergne-Rhône-Alpes;74;4;07;237;Saint-Gingolph;840;4;844
84;Auvergne-Rhône-Alpes;74;4;07;238;Saint-Jean-d'Aulps;1440;24;1464
84;Auvergne-Rhône-Alpes;74;1;08;239;Saint-Jean-de-Sixt;1453;32;1485
84;Auvergne-Rhône-Alpes;74;2;05;240;Saint-Jean-de-Tholome;990;29;1019
84;Auvergne-Rhône-Alpes;74;2;05;241;Saint-Jeoire;3282;115;3397
84;Auvergne-Rhône-Alpes;74;1;16;242;Saint-Jorioz;5738;189;5927
84;Auvergne-Rhône-Alpes;74;3;13;243;Saint-Julien-en-Genevois;14258;218;14476
84;Auvergne-Rhône-Alpes;74;2;11;244;Saint-Laurent;836;22;858
84;Auvergne-Rhône-Alpes;74;4;07;249;Saint-Paul-en-Chablais;2412;78;2490
84;Auvergne-Rhône-Alpes;74;2;05;250;Saint-Pierre-en-Faucigny;6573;131;6704
84;Auvergne-Rhône-Alpes;74;2;06;252;Saint-Sigismond;589;32;621
84;Auvergne-Rhône-Alpes;74;2;11;253;Saint-Sixt;1021;32;1053
84;Auvergne-Rhône-Alpes;74;1;12;254;Saint-Sylvestre;607;16;623
84;Auvergne-Rhône-Alpes;74;1;12;255;Sales;1978;49;2027
84;Auvergne-Rhône-Alpes;74;2;14;256;Sallanches;16088;515;16603
84;Auvergne-Rhône-Alpes;74;1;01;257;Sallenôves;703;20;723
84;Auvergne-Rhône-Alpes;74;2;06;258;Samoëns;2458;61;2519
84;Auvergne-Rhône-Alpes;74;3;11;259;Le Sappey;409;10;419
84;Auvergne-Rhône-Alpes;74;3;13;260;Savigny;893;20;913
84;Auvergne-Rhône-Alpes;74;4;15;261;Saxel;484;8;492
84;Auvergne-Rhône-Alpes;74;3;11;262;Scientrier;1159;22;1181
84;Auvergne-Rhône-Alpes;74;4;15;263;Sciez;6033;135;6168
84;Auvergne-Rhône-Alpes;74;2;06;264;Scionzier;8683;111;8794
84;Auvergne-Rhône-Alpes;74;1;08;265;Serraval;700;72;772
84;Auvergne-Rhône-Alpes;74;2;10;266;Servoz;999;34;1033
84;Auvergne-Rhône-Alpes;74;1;02;267;Sevrier;4161;181;4342
84;Auvergne-Rhône-Alpes;74;3;13;269;Seyssel;2325;74;2399
84;Auvergne-Rhône-Alpes;74;4;07;271;Seytroux;513;13;526
84;Auvergne-Rhône-Alpes;74;1;01;272;Sillingy;5245;126;5371
84;Auvergne-Rhône-Alpes;74;2;06;273;Sixt-Fer-à-Cheval;769;18;787
84;Auvergne-Rhône-Alpes;74;1;08;275;Talloires-Montmin;1996;64;2060
84;Auvergne-Rhône-Alpes;74;2;06;276;Taninges;3443;74;3517
84;Auvergne-Rhône-Alpes;74;4;07;279;Thollon-les-Mémises;793;24;817
84;Auvergne-Rhône-Alpes;74;1;08;280;Thônes;6576;321;6897
84;Auvergne-Rhône-Alpes;74;4;17;281;Thonon-les-Bains;34756;1107;35863
84;Auvergne-Rhône-Alpes;74;1;12;283;Thusy;1101;20;1121
84;Auvergne-Rhône-Alpes;74;2;06;278;Thyez;6198;148;6346
84;Auvergne-Rhône-Alpes;74;2;05;284;La Tour;1275;24;1299
84;Auvergne-Rhône-Alpes;74;3;13;285;Usinens;402;10;412
84;Auvergne-Rhône-Alpes;74;4;07;286;Vacheresse;855;17;872
84;Auvergne-Rhône-Alpes;74;4;17;287;Vailly;910;20;930
84;Auvergne-Rhône-Alpes;74;1;08;167;Val de Chaise;1363;25;1388
84;Auvergne-Rhône-Alpes;74;3;13;288;Valleiry;4697;60;4757
84;Auvergne-Rhône-Alpes;74;1;12;289;Vallières-sur-Fier;2503;58;2561
84;Auvergne-Rhône-Alpes;74;2;10;290;Vallorcine;400;13;413
84;Auvergne-Rhône-Alpes;74;3;13;291;Vanzy;329;8;337
84;Auvergne-Rhône-Alpes;74;1;12;292;Vaulx;978;26;1004
84;Auvergne-Rhône-Alpes;74;4;15;293;Veigy-Foncenex;3685;41;3726
84;Auvergne-Rhône-Alpes;74;2;06;294;Verchaix;752;21;773
84;Auvergne-Rhône-Alpes;74;4;07;295;La Vernaz;337;5;342
84;Auvergne-Rhône-Alpes;74;3;13;296;Vers;893;19;912
84;Auvergne-Rhône-Alpes;74;1;12;297;Versonnex;612;24;636
84;Auvergne-Rhône-Alpes;74;3;09;298;Vétraz-Monthoux;8900;267;9167
84;Auvergne-Rhône-Alpes;74;1;08;299;Veyrier-du-Lac;2251;81;2332
84;Auvergne-Rhône-Alpes;74;4;15;301;Villard;812;17;829
84;Auvergne-Rhône-Alpes;74;1;08;302;Les Villards-sur-Thônes;1068;37;1105
84;Auvergne-Rhône-Alpes;74;1;03;303;Villaz;3427;124;3551
84;Auvergne-Rhône-Alpes;74;2;05;304;Ville-en-Sallaz;905;10;915
84;Auvergne-Rhône-Alpes;74;3;04;305;Ville-la-Grand;8802;117;8919
84;Auvergne-Rhône-Alpes;74;3;11;306;Villy-le-Bouveret;597;17;614
84;Auvergne-Rhône-Alpes;74;1;11;307;Villy-le-Pelloux;938;15;953
84;Auvergne-Rhône-Alpes;74;4;07;308;Vinzier;821;22;843
84;Auvergne-Rhône-Alpes;74;3;13;309;Viry;5182;82;5264
84;Auvergne-Rhône-Alpes;74;2;05;311;Viuz-en-Sallaz;4374;81;4455
84;Auvergne-Rhône-Alpes;74;1;12;310;Viuz-la-Chiésaz;1324;32;1356
84;Auvergne-Rhône-Alpes;74;2;05;312;Vougy;1561;28;1589
84;Auvergne-Rhône-Alpes;74;3;11;313;Vovray-en-Bornes;524;10;534
84;Auvergne-Rhône-Alpes;74;3;13;314;Vulbens;1588;68;1656
84;Auvergne-Rhône-Alpes;74;4;15;315;Yvoire;993;18;1011
11;Île-de-France;75;1;null;101;Paris 1er Arrondissement;16266;129;16395
11;Île-de-France;75;1;null;102;Paris 2e Arrondissement;20900;142;21042
11;Île-de-France;75;1;null;103;Paris 3e Arrondissement;34115;274;34389
11;Île-de-France;75;1;null;104;Paris 4e Arrondissement;28088;282;28370
11;Île-de-France;75;1;null;105;Paris 5e Arrondissement;58850;781;59631
11;Île-de-France;75;1;null;106;Paris 6e Arrondissement;41100;876;41976
11;Île-de-France;75;1;null;107;Paris 7e Arrondissement;51367;826;52193
11;Île-de-France;75;1;null;108;Paris 8e Arrondissement;36808;560;37368
11;Île-de-France;75;1;null;109;Paris 9e Arrondissement;59555;516;60071
11;Île-de-France;75;1;null;110;Paris 10e Arrondissement;90372;464;90836
11;Île-de-France;75;1;null;111;Paris 11e Arrondissement;146643;827;147470
11;Île-de-France;75;1;null;112;Paris 12e Arrondissement;140296;991;141287
11;Île-de-France;75;1;null;113;Paris 13e Arrondissement;182099;1300;183399
11;Île-de-France;75;1;null;114;Paris 14e Arrondissement;135964;977;136941
11;Île-de-France;75;1;null;115;Paris 15e Arrondissement;233392;1786;235178
11;Île-de-France;75;1;null;116;Paris 16e Arrondissement;166361;2193;168554
11;Île-de-France;75;1;null;117;Paris 17e Arrondissement;167288;1449;168737
11;Île-de-France;75;1;null;118;Paris 18e Arrondissement;195233;898;196131
11;Île-de-France;75;1;null;119;Paris 19e Arrondissement;187015;1051;188066
11;Île-de-France;75;1;null;120;Paris 20e Arrondissement;195814;925;196739
28;Normandie;76;3;35;001;Allouville-Bellefosse;1157;19;1176
28;Normandie;76;2;33;002;Alvimare;615;9;624
28;Normandie;76;1;07;004;Ambrumesnil;472;14;486
28;Normandie;76;3;06;005;Amfreville-la-Mi-Voie;3273;29;3302
28;Normandie;76;3;35;006;Amfreville-les-Champs;171;4;175
28;Normandie;76;3;02;007;Anceaumeville;647;12;659
28;Normandie;76;1;08;008;Ancourt;653;11;664
28;Normandie;76;1;33;009;Ancourteville-sur-Héricourt;333;6;339
28;Normandie;76;3;35;010;Ancretiéville-Saint-Victor;381;6;387
28;Normandie;76;2;11;011;Ancretteville-sur-Mer;170;4;174
28;Normandie;76;2;32;012;Angerville-Bailleul;191;3;194
28;Normandie;76;2;26;014;Angerville-l'Orcher;1426;16;1442
28;Normandie;76;2;11;013;Angerville-la-Martel;1060;29;1089
28;Normandie;76;1;33;015;Angiens;516;11;527
28;Normandie;76;2;26;017;Anglesqueville-l'Esneval;598;7;605
28;Normandie;76;1;33;016;Anglesqueville-la-Bras-Long;117;2;119
28;Normandie;76;3;01;020;Anneville-Ambourville;1190;22;1212
28;Normandie;76;1;20;019;Anneville-sur-Scie;432;10;442
28;Normandie;76;2;32;021;Annouville-Vilmesnil;477;7;484
28;Normandie;76;3;25;022;Anquetierville;341;14;355
28;Normandie;76;3;35;023;Anvéville;295;5;300
28;Normandie;76;1;23;024;Ardouval;162;4;166
28;Normandie;76;3;25;401;Arelaune-en-Seine;2576;46;2622
28;Normandie;76;1;12;025;Argueil;341;8;349
28;Normandie;76;1;08;026;Arques-la-Bataille;2583;53;2636
28;Normandie;76;1;12;028;Aubéguimont;197;1;198
28;Normandie;76;1;10;029;Aubermesnil-aux-Érables;203;4;207
28;Normandie;76;1;07;030;Aubermesnil-Beaumais;468;4;472
28;Normandie;76;1;33;032;Auberville-la-Manuel;130;1;131
28;Normandie;76;2;32;033;Auberville-la-Renault;462;7;469
28;Normandie;76;1;12;035;Aumale;2024;52;2076
28;Normandie;76;1;20;036;Auppegard;716;19;735
28;Normandie;76;3;02;038;Authieux-Ratiéville;405;3;408
28;Normandie;76;3;06;039;Les Authieux-sur-le-Port-Saint-Ouen;1265;26;1291
28;Normandie;76;1;33;040;Autigny;313;0;313
28;Normandie;76;1;23;042;Auvilliers;101;0;101
28;Normandie;76;3;35;043;Auzebosc;1123;338;1461
28;Normandie;76;3;35;045;Auzouville-l'Esneval;358;8;366
28;Normandie;76;3;21;046;Auzouville-sur-Ry;733;6;739
28;Normandie;76;1;20;047;Auzouville-sur-Saâne;152;1;153
28;Normandie;76;1;12;048;Avesnes-en-Bray;301;6;307
28;Normandie;76;1;23;049;Avesnes-en-Val;279;6;285
28;Normandie;76;1;20;050;Avremesnil;1016;18;1034
28;Normandie;76;1;20;051;Bacqueville-en-Caux;1901;38;1939
28;Normandie;76;1;23;052;Bailleul-Neuville;216;3;219
28;Normandie;76;1;23;053;Baillolet;106;1;107
28;Normandie;76;1;08;054;Bailly-en-Rivière;526;5;531
28;Normandie;76;3;35;055;Baons-le-Comte;349;17;366
28;Normandie;76;3;01;056;Bardouville;639;5;644
28;Normandie;76;3;01;057;Barentin;11822;212;12034
28;Normandie;76;1;10;058;Baromesnil;228;5;233
28;Normandie;76;1;10;059;Bazinval;415;11;426
28;Normandie;76;1;12;060;Beaubec-la-Rosière;498;13;511
28;Normandie;76;3;23;062;Beaumont-le-Hareng;265;3;268
28;Normandie;76;2;26;064;Beaurepaire;497;13;510
28;Normandie;76;1;12;065;Beaussault;411;4;415
28;Normandie;76;1;20;066;Beautot;147;4;151
28;Normandie;76;1;20;063;Beauval-en-Caux;491;15;506
28;Normandie;76;1;12;067;Beauvoir-en-Lyons;617;14;631
28;Normandie;76;2;32;068;Bec-de-Mortagne;661;17;678
28;Normandie;76;3;06;069;Belbeuf;2201;50;2251
28;Normandie;76;1;23;070;Bellencombre;680;7;687
28;Normandie;76;1;08;071;Bellengreville;476;7;483
28;Normandie;76;1;20;072;Belleville-en-Caux;711;12;723
28;Normandie;76;1;12;074;La Bellière;57;1;58
28;Normandie;76;1;20;075;Belmesnil;457;2;459
28;Normandie;76;2;32;076;Bénarville;265;5;270
28;Normandie;76;3;35;077;Bénesville;195;4;199
28;Normandie;76;2;26;079;Bénouville;179;1;180
28;Normandie;76;2;03;082;Bernières;641;6;647
28;Normandie;76;1;33;083;Bertheauville;106;1;107
28;Normandie;76;1;33;084;Bertreville;120;1;121
28;Normandie;76;1;20;085;Bertreville-Saint-Ouen;345;10;355
28;Normandie;76;1;20;086;Bertrimont;219;6;225
28;Normandie;76;3;35;087;Berville-en-Caux;649;9;658
28;Normandie;76;3;01;088;Berville-sur-Seine;559;7;566
28;Normandie;76;2;03;090;Beuzeville-la-Grenier;1227;16;1243
28;Normandie;76;1;33;091;Beuzeville-la-Guérard;225;2;227
28;Normandie;76;2;03;092;Beuzevillette;647;10;657
28;Normandie;76;1;12;093;Bézancourt;352;9;361
28;Normandie;76;3;21;094;Bierville;317;3;320
28;Normandie;76;3;02;095;Bihorel;8398;184;8582
28;Normandie;76;1;20;096;Biville-la-Baignarde;656;12;668
28;Normandie;76;1;20;097;Biville-la-Rivière;106;0;106
28;Normandie;76;3;01;099;Blacqueville;707;9;716
28;Normandie;76;3;21;100;Blainville-Crevon;1209;17;1226
28;Normandie;76;1;10;101;Blangy-sur-Bresle;2972;52;3024
28;Normandie;76;1;33;104;Blosseville;254;14;268
28;Normandie;76;3;02;105;Le Bocasse;666;8;674
28;Normandie;76;3;21;106;Bois-d'Ennebourg;563;8;571
28;Normandie;76;3;21;107;Bois-Guilbert;315;3;318
28;Normandie;76;3;02;108;Bois-Guillaume;13796;375;14171
28;Normandie;76;3;21;109;Bois-Héroult;200;5;205
28;Normandie;76;3;35;110;Bois-Himont;460;5;465
28;Normandie;76;3;21;111;Bois-l'Évêque;554;9;563
28;Normandie;76;1;20;112;Le Bois-Robert;351;8;359
28;Normandie;76;3;21;113;Boissay;406;6;412
28;Normandie;76;2;03;114;Bolbec;11417;136;11553
28;Normandie;76;2;25;115;Bolleville;580;3;583
28;Normandie;76;3;06;103;Bonsecours;6462;104;6566
28;Normandie;76;3;21;116;Boos;3810;45;3855
28;Normandie;76;2;26;117;Bordeaux-Saint-Clair;666;14;680
28;Normandie;76;2;32;118;Bornambusc;260;8;268
28;Normandie;76;1;23;119;Bosc-Bérenger;190;2;192
28;Normandie;76;3;21;120;Bosc-Bordel;452;10;462
28;Normandie;76;3;21;121;Bosc-Édeline;360;3;363
28;Normandie;76;3;02;123;Bosc-Guérard-Saint-Adrien;948;25;973
28;Normandie;76;1;12;124;Bosc-Hyons;419;8;427
28;Normandie;76;3;23;125;Bosc-le-Hard;1462;20;1482
28;Normandie;76;1;23;126;Bosc-Mesnil;312;6;318
28;Normandie;76;1;33;128;Bosville;579;15;594
28;Normandie;76;3;35;129;Boudeville;210;6;216
28;Normandie;76;1;23;130;Bouelles;276;4;280
28;Normandie;76;3;09;131;La Bouille;753;11;764
28;Normandie;76;3;35;132;Bourdainville;463;2;465
28;Normandie;76;1;33;133;Le Bourg-Dun;431;9;440
28;Normandie;76;1;33;134;Bourville;297;4;301
28;Normandie;76;3;01;135;Bouville;982;14;996
28;Normandie;76;1;20;136;Brachy;768;7;775
28;Normandie;76;1;23;138;Bracquetuit;336;5;341
28;Normandie;76;1;23;139;Bradiancourt;217;3;220
28;Normandie;76;1;33;140;Brametot;206;1;207
28;Normandie;76;2;32;141;Bréauté;1340;13;1353
28;Normandie;76;1;12;142;Brémontier-Merval;459;124;583
28;Normandie;76;2;32;143;Bretteville-du-Grand-Caux;1345;22;1367
28;Normandie;76;3;35;144;Bretteville-Saint-Laurent;159;2;161
28;Normandie;76;3;21;146;Buchy;2757;97;2854
28;Normandie;76;1;23;147;Bully;916;21;937
28;Normandie;76;1;23;148;Bures-en-Bray;323;5;328
28;Normandie;76;3;35;149;Butot;281;4;285
28;Normandie;76;1;33;732;Butot-Vénesville;247;4;251
28;Normandie;76;1;33;151;Cailleville;264;10;274
28;Normandie;76;3;21;152;Cailly;790;3;793
28;Normandie;76;1;23;122;Callengeville;511;5;516
28;Normandie;76;1;20;153;Calleville-les-Deux-Églises;332;3;335
28;Normandie;76;1;10;154;Campneuseville;476;11;487
28;Normandie;76;1;10;155;Canehan;364;2;366
28;Normandie;76;1;33;156;Canouville;335;9;344
28;Normandie;76;3;04;157;Canteleu;14181;448;14629
28;Normandie;76;3;35;158;Canville-les-Deux-Églises;328;2;330
28;Normandie;76;1;33;159;Cany-Barville;3052;53;3105
28;Normandie;76;3;24;160;Carville-la-Folletière;425;8;433
28;Normandie;76;3;35;161;Carville-Pot-de-Fer;106;3;109
28;Normandie;76;1;20;162;Le Catelier;261;5;266
28;Normandie;76;3;21;163;Catenay;678;9;687
28;Normandie;76;3;05;165;Caudebec-lès-Elbeuf;10335;78;10413
28;Normandie;76;1;12;166;Le Caule-Sainte-Beuve;487;5;492
28;Normandie;76;2;26;167;Cauville-sur-Mer;1547;26;1573
28;Normandie;76;1;20;168;Les Cent-Acres;64;1;65
28;Normandie;76;2;32;169;La Cerlangue;1289;111;1400
28;Normandie;76;1;20;170;La Chapelle-du-Bourgay;130;0;130
28;Normandie;76;1;12;171;La Chapelle-Saint-Ouen;130;3;133
28;Normandie;76;1;33;172;La Chapelle-sur-Dun;160;3;163
28;Normandie;76;1;20;173;La Chaussée;549;6;555
28;Normandie;76;3;35;174;Cideville;386;5;391
28;Normandie;76;1;23;175;Clais;259;7;266
28;Normandie;76;1;33;176;Clasville;326;7;333
28;Normandie;76;3;02;177;Claville-Motteville;279;6;285
28;Normandie;76;3;05;178;Cléon;4994;32;5026
28;Normandie;76;3;02;179;Clères;1369;16;1385
28;Normandie;76;1;33;180;Cleuville;194;8;202
28;Normandie;76;2;33;181;Cléville;159;2;161
28;Normandie;76;2;33;182;Cliponville;277;6;283
28;Normandie;76;2;11;183;Colleville;759;17;776
28;Normandie;76;1;07;184;Colmesnil-Manneville;107;2;109
28;Normandie;76;1;12;185;Compainville;180;4;184
28;Normandie;76;1;12;186;Conteville;491;7;498
28;Normandie;76;2;11;187;Contremoulins;155;9;164
28;Normandie;76;3;23;188;Cottévrard;470;4;474
28;Normandie;76;1;33;189;Crasville-la-Mallet;154;6;160
28;Normandie;76;1;33;190;Crasville-la-Rocquefort;214;4;218
28;Normandie;76;1;10;192;Criel-sur-Mer;2680;54;2734
28;Normandie;76;1;23;193;La Crique;350;5;355
28;Normandie;76;2;11;194;Criquebeuf-en-Caux;404;3;407
28;Normandie;76;2;26;196;Criquetot-l'Esneval;2567;83;2650
28;Normandie;76;2;11;195;Criquetot-le-Mauconduit;176;1;177
28;Normandie;76;1;20;197;Criquetot-sur-Longueville;228;1;229
28;Normandie;76;3;35;198;Criquetot-sur-Ouville;811;18;829
28;Normandie;76;1;12;199;Criquiers;651;10;661
28;Normandie;76;1;23;200;Critot;465;12;477
28;Normandie;76;1;12;201;Croisy-sur-Andelle;554;4;558
28;Normandie;76;3;24;203;Croix-Mare;803;7;810
28;Normandie;76;1;23;202;Croixdalle;307;4;311
28;Normandie;76;1;23;204;Cropus;249;1;250
28;Normandie;76;1;20;205;Crosville-sur-Scie;248;2;250
28;Normandie;76;2;26;206;Cuverville;351;5;356
28;Normandie;76;1;10;207;Cuverville-sur-Yères;199;6;205
28;Normandie;76;1;12;208;Cuy-Saint-Fiacre;659;17;676
28;Normandie;76;1;12;209;Dampierre-en-Bray;453;8;461
28;Normandie;76;1;08;210;Dampierre-Saint-Nicolas;472;2;474
28;Normandie;76;1;10;211;Dancourt;229;2;231
28;Normandie;76;3;06;212;Darnétal;9707;80;9787
28;Normandie;76;2;32;213;Daubeuf-Serville;393;8;401
28;Normandie;76;1;20;214;Dénestanville;266;1;267
28;Normandie;76;3;22;216;Déville-lès-Rouen;10492;96;10588
28;Normandie;76;1;95;217;Dieppe;29080;558;29638
28;Normandie;76;1;12;218;Doudeauville;87;1;88
28;Normandie;76;3;35;219;Doudeville;2484;41;2525
28;Normandie;76;1;08;220;Douvrend;522;11;533
28;Normandie;76;1;33;221;Drosay;198;7;205
28;Normandie;76;3;01;222;Duclair;4198;47;4245
28;Normandie;76;3;24;223;Écalles-Alix;533;6;539
28;Normandie;76;2;32;224;Écrainville;1022;21;1043
28;Normandie;76;3;35;225;Écretteville-lès-Baons;387;13;400
28;Normandie;76;2;11;226;Écretteville-sur-Mer;159;2;161
28;Normandie;76;3;35;227;Ectot-l'Auber;677;11;688
28;Normandie;76;3;35;228;Ectot-lès-Baons;394;7;401
28;Normandie;76;3;09;231;Elbeuf;16166;142;16308
28;Normandie;76;1;12;229;Elbeuf-en-Bray;415;13;428
28;Normandie;76;3;21;230;Elbeuf-sur-Andelle;473;6;479
28;Normandie;76;2;11;232;Életot;645;9;654
28;Normandie;76;1;12;233;Ellecourt;147;5;152
28;Normandie;76;3;24;234;Émanville;707;11;718
28;Normandie;76;1;08;235;Envermeu;2097;162;2259
28;Normandie;76;2;33;236;Envronville;343;1;344
28;Normandie;76;3;01;237;Épinay-sur-Duclair;529;9;538
28;Normandie;76;2;26;238;Épouville;2686;45;2731
28;Normandie;76;2;32;239;Épretot;735;14;749
28;Normandie;76;2;11;240;Épreville;1022;13;1035
28;Normandie;76;1;33;241;Ermenouville;140;6;146
28;Normandie;76;1;12;242;Ernemont-la-Villette;180;1;181
28;Normandie;76;3;21;243;Ernemont-sur-Buchy;299;4;303
28;Normandie;76;1;23;244;Esclavelles;378;6;384
28;Normandie;76;3;24;245;Eslettes;1567;16;1583
28;Normandie;76;3;02;247;Esteville;495;4;499
28;Normandie;76;1;20;249;Étaimpuis;805;11;816
28;Normandie;76;2;32;250;Étainhus;1160;25;1185
28;Normandie;76;3;35;251;Étalleville;454;3;457
28;Normandie;76;1;10;252;Étalondes;1057;28;1085
28;Normandie;76;3;35;253;Étoutteville;807;14;821
28;Normandie;76;2;26;254;Étretat;1291;7;1298
28;Normandie;76;1;10;255;Eu;6883;193;7076
28;Normandie;76;1;10;257;Fallencourt;188;2;190
28;Normandie;76;2;11;259;Fécamp;18641;314;18955
28;Normandie;76;1;12;260;Ferrières-en-Bray;1674;19;1693
28;Normandie;76;1;12;261;La Ferté-Saint-Samson;466;11;477
28;Normandie;76;1;23;262;Fesques;119;0;119
28;Normandie;76;1;12;263;La Feuillie;1296;22;1318
28;Normandie;76;3;35;264;Flamanville;492;12;504
28;Normandie;76;1;23;265;Flamets-Frétils;162;7;169
28;Normandie;76;1;10;266;Flocques;711;15;726
28;Normandie;76;2;26;268;Fongueusemare;189;5;194
28;Normandie;76;1;23;269;Fontaine-en-Bray;176;3;179
28;Normandie;76;2;26;270;Fontaine-la-Mallet;2626;61;2687
28;Normandie;76;3;02;271;Fontaine-le-Bourg;1759;18;1777
28;Normandie;76;1;33;272;Fontaine-le-Dun;903;17;920
28;Normandie;76;3;06;273;Fontaine-sous-Préaux;508;15;523
28;Normandie;76;1;20;274;La Fontelaye;31;0;31
28;Normandie;76;2;26;275;Fontenay;1240;20;1260
28;Normandie;76;1;12;276;Forges-les-Eaux;3805;191;3996
28;Normandie;76;1;10;278;Foucarmont;817;15;832
28;Normandie;76;2;33;279;Foucart;354;10;364
28;Normandie;76;3;21;475;Franqueville-Saint-Pierre;6123;188;6311
28;Normandie;76;1;23;280;Fréauville;132;1;133
28;Normandie;76;2;25;281;La Frénaye;2134;46;2180
28;Normandie;76;3;05;282;Freneuse;932;13;945
28;Normandie;76;1;23;283;Fresles;236;4;240
28;Normandie;76;1;20;284;Fresnay-le-Long;331;5;336
28;Normandie;76;3;21;285;Fresne-le-Plan;609;8;617
28;Normandie;76;1;23;286;Fresnoy-Folny;699;7;706
28;Normandie;76;3;24;287;Fresquiennes;997;14;1011
28;Normandie;76;1;08;288;Freulleville;364;5;369
28;Normandie;76;3;02;290;Frichemesnil;412;11;423
28;Normandie;76;2;11;291;Froberville;1245;19;1264
28;Normandie;76;1;12;292;Fry;148;3;151
28;Normandie;76;3;35;293;Fultot;220;0;220
28;Normandie;76;1;33;294;La Gaillarde;386;8;394
28;Normandie;76;1;12;295;Gaillefontaine;1225;9;1234
28;Normandie;76;2;16;296;Gainneville;2582;31;2613
28;Normandie;76;1;12;297;Gancourt-Saint-Étienne;228;7;235
28;Normandie;76;2;11;298;Ganzeville;477;6;483
28;Normandie;76;2;11;299;Gerponville;398;4;402
28;Normandie;76;2;11;300;Gerville;424;4;428
28;Normandie;76;2;32;302;Goderville;2851;40;2891
28;Normandie;76;2;32;303;Gommerville;738;12;750
28;Normandie;76;2;32;304;Gonfreville-Caillot;359;1;360
28;Normandie;76;2;16;305;Gonfreville-l'Orcher;9057;58;9115
28;Normandie;76;1;20;306;Gonnetot;197;2;199
28;Normandie;76;2;26;307;Gonneville-la-Mallet;1334;22;1356
28;Normandie;76;1;20;308;Gonneville-sur-Scie;465;4;469
28;Normandie;76;3;35;309;Gonzeville;115;2;117
28;Normandie;76;3;24;311;Goupillières;417;5;422
28;Normandie;76;1;12;312;Gournay-en-Bray;6072;97;6169
28;Normandie;76;3;06;313;Gouy;869;25;894
28;Normandie;76;2;32;314;Graimbouville;615;9;624
28;Normandie;76;1;33;315;Grainville-la-Teinturière;1078;21;1099
28;Normandie;76;3;21;316;Grainville-sur-Ry;446;4;450
28;Normandie;76;2;32;317;Grainville-Ymauville;439;12;451
28;Normandie;76;2;25;318;Grand-Camp;708;26;734
28;Normandie;76;3;09;319;Grand-Couronne;9648;194;9842
28;Normandie;76;3;13;322;Le Grand-Quevilly;25698;247;25945
28;Normandie;76;1;23;320;Grandcourt;341;5;346
28;Normandie;76;1;23;321;Les Grandes-Ventes;1821;27;1848
28;Normandie;76;1;23;323;Graval;155;2;157
28;Normandie;76;1;08;324;Grèges;838;21;859
28;Normandie;76;3;35;325;Grémonville;433;4;437
28;Normandie;76;1;20;327;Greuville;379;5;384
28;Normandie;76;3;23;328;Grigneuseville;368;6;374
28;Normandie;76;2;03;329;Gruchet-le-Valasse;3160;38;3198
28;Normandie;76;1;20;330;Gruchet-Saint-Siméon;687;13;700
28;Normandie;76;3;02;331;Grugny;1011;7;1018
28;Normandie;76;1;12;332;Grumesnil;441;2;443
28;Normandie;76;1;10;333;Guerville;473;6;479
28;Normandie;76;1;20;334;Gueures;535;20;555
28;Normandie;76;1;20;335;Gueutteville;85;0;85
28;Normandie;76;1;33;336;Gueutteville-les-Grès;370;11;381
28;Normandie;76;1;12;338;La Hallotière;221;1;222
28;Normandie;76;1;33;339;Le Hanouard;249;5;254
28;Normandie;76;3;35;340;Harcanville;510;7;517
28;Normandie;76;2;15;341;Harfleur;8449;65;8514
28;Normandie;76;2;33;342;Hattenville;724;17;741
28;Normandie;76;1;12;343;Haucourt;207;4;211
28;Normandie;76;1;12;344;Haudricourt;416;11;427
28;Normandie;76;1;12;345;Haussez;278;2;280
28;Normandie;76;1;33;346;Hautot-l'Auvray;329;8;337
28;Normandie;76;3;35;347;Hautot-le-Vatois;354;6;360
28;Normandie;76;3;35;348;Hautot-Saint-Sulpice;678;8;686
28;Normandie;76;1;07;349;Hautot-sur-Mer;1914;71;1985
28;Normandie;76;3;04;350;Hautot-sur-Seine;413;7;420
28;Normandie;76;3;35;041;Les Hauts-de-Caux;1384;34;1418
28;Normandie;76;2;96;351;Le Havre;170147;1920;172067
28;Normandie;76;1;12;352;La Haye;381;1;382
28;Normandie;76;1;33;353;Héberville;116;5;121
28;Normandie;76;3;01;354;Hénouville;1302;14;1316
28;Normandie;76;3;35;355;Héricourt-en-Caux;955;13;968
28;Normandie;76;1;20;356;Hermanville;116;2;118
28;Normandie;76;2;26;357;Hermeville;366;16;382
28;Normandie;76;1;12;358;Le Héron;252;2;254
28;Normandie;76;3;21;359;Héronchelles;139;2;141
28;Normandie;76;1;20;360;Heugleville-sur-Scie;637;7;644
28;Normandie;76;2;26;361;Heuqueville;718;8;726
28;Normandie;76;3;25;362;Heurteauville;310;2;312
28;Normandie;76;1;10;363;Hodeng-au-Bosc;575;8;583
28;Normandie;76;1;12;364;Hodeng-Hodenger;279;3;282
28;Normandie;76;1;33;365;Houdetot;180;0;180
28;Normandie;76;3;24;366;Le Houlme;4050;29;4079
28;Normandie;76;3;24;367;Houppeville;2784;46;2830
28;Normandie;76;2;32;368;Houquetot;353;6;359
28;Normandie;76;3;02;369;La Houssaye-Béranger;534;7;541
28;Normandie;76;3;35;370;Hugleville-en-Caux;428;3;431
28;Normandie;76;1;08;371;Les Ifs;75;0;75
28;Normandie;76;1;12;372;Illois;407;3;410
28;Normandie;76;1;20;373;Imbleville;307;6;313
28;Normandie;76;1;10;374;Incheville;1247;14;1261
28;Normandie;76;1;33;375;Ingouville;270;14;284
28;Normandie;76;3;02;377;Isneauville;3158;64;3222
28;Normandie;76;3;01;378;Jumièges;1719;33;1752
28;Normandie;76;1;20;379;Lamberville;192;2;194
28;Normandie;76;1;20;380;Lammerville;335;8;343
28;Normandie;76;1;12;381;Landes-Vieilles-et-Neuves;137;1;138
28;Normandie;76;2;03;382;Lanquetot;1147;13;1160
28;Normandie;76;1;20;383;Lestanville;95;0;95
28;Normandie;76;2;03;384;Lillebonne;8894;152;9046
28;Normandie;76;3;24;385;Limésy;1523;42;1565
28;Normandie;76;2;11;386;Limpiville;370;6;376
28;Normandie;76;3;35;387;Lindebeuf;399;7;406
28;Normandie;76;2;25;388;Lintot;449;3;452
28;Normandie;76;1;20;389;Lintot-les-Bois;181;7;188
28;Normandie;76;2;11;390;Les Loges;1157;22;1179
28;Normandie;76;3;09;391;La Londe;2334;67;2401
28;Normandie;76;1;23;392;Londinières;1263;13;1276
28;Normandie;76;1;12;393;Longmesnil;52;0;52
28;Normandie;76;1;10;394;Longroy;634;5;639
28;Normandie;76;1;07;395;Longueil;561;11;572
28;Normandie;76;3;21;396;Longuerue;327;3;330
28;Normandie;76;1;20;397;Longueville-sur-Scie;980;26;1006
28;Normandie;76;3;25;398;Louvetot;738;6;744
28;Normandie;76;1;23;399;Lucy;189;1;190
28;Normandie;76;1;20;400;Luneray;2211;37;2248
28;Normandie;76;3;24;402;Malaunay;6110;45;6155
28;Normandie;76;1;33;403;Malleville-les-Grès;202;1;203
28;Normandie;76;2;26;404;Manéglise;1261;21;1282
28;Normandie;76;1;20;405;Manéhouville;226;1;227
28;Normandie;76;2;11;406;Maniquerville;411;6;417
28;Normandie;76;1;33;407;Manneville-ès-Plains;280;7;287
28;Normandie;76;2;32;408;Manneville-la-Goupil;1021;14;1035
28;Normandie;76;2;26;409;Mannevillette;868;12;880
28;Normandie;76;3;04;410;Maromme;10908;137;11045
28;Normandie;76;1;12;411;Marques;232;1;233
28;Normandie;76;3;21;412;Martainville-Épreville;697;11;708
28;Normandie;76;1;07;413;Martigny;439;10;449
28;Normandie;76;1;08;414;Martin-Église;1587;51;1638
28;Normandie;76;1;23;415;Massy;343;5;348
28;Normandie;76;1;23;416;Mathonville;319;6;325
28;Normandie;76;1;23;417;Maucomble;415;3;418
28;Normandie;76;3;25;418;Maulévrier-Sainte-Gertrude;987;20;1007
28;Normandie;76;3;01;419;Mauny;172;6;178
28;Normandie;76;1;12;420;Mauquenchy;352;5;357
28;Normandie;76;2;03;421;Mélamare;889;13;902
28;Normandie;76;1;10;422;Melleville;264;8;272
28;Normandie;76;1;12;423;Ménerval;173;2;175
28;Normandie;76;1;23;424;Ménonval;221;4;225
28;Normandie;76;2;32;425;Mentheville;301;5;306
28;Normandie;76;1;12;426;Mésangueville;164;1;165
28;Normandie;76;1;23;427;Mesnières-en-Bray;927;248;1175
28;Normandie;76;1;33;428;Le Mesnil-Durdent;18;3;21
28;Normandie;76;3;21;429;Le Mesnil-Esnard;7967;351;8318
28;Normandie;76;1;23;430;Mesnil-Follemprise;128;4;132
28;Normandie;76;1;12;431;Le Mesnil-Lieubray;99;3;102
28;Normandie;76;1;12;432;Mesnil-Mauger;247;4;251
28;Normandie;76;3;24;433;Mesnil-Panneville;719;7;726
28;Normandie;76;3;21;434;Mesnil-Raoul;1024;7;1031
28;Normandie;76;1;10;435;Le Mesnil-Réaume;793;16;809
28;Normandie;76;3;01;436;Le Mesnil-sous-Jumièges;639;3;642
28;Normandie;76;1;08;437;Meulers;563;5;568
28;Normandie;76;1;10;438;Millebosc;247;5;252
28;Normandie;76;2;03;439;Mirville;335;9;344
28;Normandie;76;1;12;440;Molagnies;167;4;171
28;Normandie;76;1;10;441;Monchaux-Soreng;654;15;669
28;Normandie;76;1;10;442;Monchy-sur-Eu;587;9;596
28;Normandie;76;3;02;443;Mont-Cauvaire;741;14;755
28;Normandie;76;3;22;451;Mont-Saint-Aignan;18850;369;19219
28;Normandie;76;1;23;445;Montérolier;596;7;603
28;Normandie;76;3;24;446;Montigny;1240;17;1257
28;Normandie;76;2;15;447;Montivilliers;15612;250;15862
28;Normandie;76;3;21;448;Montmain;1314;23;1337
28;Normandie;76;1;20;449;Montreuil-en-Caux;507;8;515
28;Normandie;76;1;12;450;Montroty;273;26;299
28;Normandie;76;3;02;452;Montville;4760;54;4814
28;Normandie;76;3;21;453;Morgny-la-Pommeraye;1023;21;1044
28;Normandie;76;1;12;606;Morienne;179;26;205
28;Normandie;76;1;23;454;Mortemer;83;0;83
28;Normandie;76;1;12;455;Morville-sur-Andelle;345;4;349
28;Normandie;76;3;35;456;Motteville;791;11;802
28;Normandie;76;3;09;457;Moulineaux;944;15;959
28;Normandie;76;1;20;458;Muchedent;131;3;134
28;Normandie;76;1;23;459;Nesle-Hodeng;349;5;354
28;Normandie;76;1;10;460;Nesle-Normandeuse;546;8;554
28;Normandie;76;1;12;463;Neuf-Marché;667;22;689
28;Normandie;76;1;23;461;Neufbosc;403;5;408
28;Normandie;76;1;23;462;Neufchâtel-en-Bray;4737;206;4943
28;Normandie;76;3;21;464;La Neuville-Chant-d'Oisel;2240;33;2273
28;Normandie;76;1;23;465;Neuville-Ferrières;579;5;584
28;Normandie;76;1;33;467;Néville;1306;20;1326
28;Normandie;76;2;03;468;Nointot;1346;33;1379
28;Normandie;76;1;12;469;Nolléval;447;4;451
28;Normandie;76;1;33;470;Normanville;669;25;694
28;Normandie;76;2;25;471;Norville;987;26;1013
28;Normandie;76;1;08;472;Notre-Dame-d'Aliermont;771;2;773
28;Normandie;76;3;25;473;Notre-Dame-de-Bliquetuit;754;12;766
28;Normandie;76;3;24;474;Notre-Dame-de-Bondeville;7015;104;7119
28;Normandie;76;2;26;477;Notre-Dame-du-Bec;452;7;459
28;Normandie;76;1;20;478;Notre-Dame-du-Parc;172;1;173
28;Normandie;76;1;12;479;Nullemont;135;1;136
28;Normandie;76;1;33;480;Ocqueville;449;11;460
28;Normandie;76;2;26;481;Octeville-sur-Mer;5918;118;6036
28;Normandie;76;1;07;482;Offranville;3119;237;3356
28;Normandie;76;1;33;483;Oherville;228;2;230
28;Normandie;76;3;31;484;Oissel;11895;86;11981
28;Normandie;76;1;20;485;Omonville;262;55;317
28;Normandie;76;3;09;486;Orival;913;4;917
28;Normandie;76;1;23;487;Osmoy-Saint-Valery;324;6;330
28;Normandie;76;1;33;488;Ouainville;527;16;543
28;Normandie;76;2;32;489;Oudalle;440;11;451
28;Normandie;76;1;33;490;Ourville-en-Caux;1146;13;1159
28;Normandie;76;3;35;491;Ouville-l'Abbaye;672;7;679
28;Normandie;76;1;07;492;Ouville-la-Rivière;495;17;512
28;Normandie;76;1;33;493;Paluel;432;13;445
28;Normandie;76;2;03;494;Parc-d'Anxtot;567;7;574
28;Normandie;76;3;24;495;Pavilly;6308;56;6364
28;Normandie;76;1;08;618;Petit-Caux;9553;202;9755
28;Normandie;76;3;13;497;Petit-Couronne;8619;190;8809
28;Normandie;76;3;27;498;Le Petit-Quevilly;21995;265;22260
28;Normandie;76;2;25;499;Petiville;1125;30;1155
28;Normandie;76;1;10;500;Pierrecourt;476;5;481
28;Normandie;76;2;26;501;Pierrefiques;135;7;142
28;Normandie;76;3;21;502;Pierreval;555;9;564
28;Normandie;76;3;24;503;Pissy-Pôville;1264;19;1283
28;Normandie;76;1;33;504;Pleine-Sève;133;2;135
28;Normandie;76;1;12;505;Pommereux;96;1;97
28;Normandie;76;1;23;506;Pommeréval;463;5;468
28;Normandie;76;1;10;507;Ponts-et-Marais;799;13;812
28;Normandie;76;2;25;476;Port-Jérôme-sur-Seine;10030;180;10210
28;Normandie;76;2;26;508;La Poterie-Cap-d'Antifer;453;6;459
28;Normandie;76;3;21;509;Préaux;1812;31;1843
28;Normandie;76;3;35;510;Prétot-Vicquemare;224;3;227
28;Normandie;76;1;23;511;Preuseville;137;1;138
28;Normandie;76;1;23;512;Puisenval;25;0;25
28;Normandie;76;3;01;513;Quevillon;598;14;612
28;Normandie;76;3;06;514;Quévreville-la-Poterie;992;13;1005
28;Normandie;76;1;07;515;Quiberville;552;8;560
28;Normandie;76;1;23;516;Quièvrecourt;448;8;456
28;Normandie;76;3;02;517;Quincampoix;2994;84;3078
28;Normandie;76;2;03;518;Raffetot;503;9;512
28;Normandie;76;1;20;519;Rainfreville;69;3;72
28;Normandie;76;1;10;520;Réalcamp;627;13;640
28;Normandie;76;3;21;521;Rebets;147;1;148
28;Normandie;76;2;32;522;La Remuée;1284;26;1310
28;Normandie;76;1;10;523;Rétonval;195;4;199
28;Normandie;76;3;35;524;Reuville;123;1;124
28;Normandie;76;1;08;526;Ricarville-du-Val;169;4;173
28;Normandie;76;1;12;527;Richemont;453;2;455
28;Normandie;76;1;10;528;Rieux;632;12;644
28;Normandie;76;3;25;164;Rives-en-Seine;4259;77;4336
28;Normandie;76;2;11;529;Riville;293;12;305
28;Normandie;76;3;35;530;Robertot;215;5;220
28;Normandie;76;3;33;531;Rocquefort;315;8;323
28;Normandie;76;1;23;532;Rocquemont;802;16;818
28;Normandie;76;2;16;533;Rogerville;1416;16;1432
28;Normandie;76;2;26;534;Rolleville;1195;18;1213
28;Normandie;76;1;12;535;Roncherolles-en-Bray;479;8;487
28;Normandie;76;3;06;536;Roncherolles-sur-le-Vivier;1114;20;1134
28;Normandie;76;1;12;537;Ronchois;175;6;181
28;Normandie;76;1;23;538;Rosay;267;5;272
28;Normandie;76;3;97;540;Rouen;110145;1615;111760
28;Normandie;76;3;24;541;Roumare;1508;26;1534
28;Normandie;76;3;35;542;Routes;273;7;280
28;Normandie;76;2;03;543;Rouville;617;12;629
28;Normandie;76;1;12;544;Rouvray-Catillon;228;6;234
28;Normandie;76;1;07;545;Rouxmesnil-Bouteilles;1847;43;1890
28;Normandie;76;1;20;546;Royville;282;8;290
28;Normandie;76;3;21;547;La Rue-Saint-Pierre;785;10;795
28;Normandie;76;3;21;548;Ry;712;8;720
28;Normandie;76;1;20;549;Saâne-Saint-Just;159;3;162
28;Normandie;76;3;04;550;Sahurs;1226;23;1249
28;Normandie;76;2;32;551;Sainneville;846;11;857
28;Normandie;76;3;21;554;Saint-Aignan-sur-Ry;348;2;350
28;Normandie;76;3;21;555;Saint-André-sur-Cailly;857;15;872
28;Normandie;76;2;03;556;Saint-Antoine-la-Forêt;1079;21;1100
28;Normandie;76;3;25;557;Saint-Arnoult;1384;20;1404
28;Normandie;76;3;06;558;Saint-Aubin-Celloville;1057;5;1062
28;Normandie;76;3;25;559;Saint-Aubin-de-Crétot;522;8;530
28;Normandie;76;3;06;560;Saint-Aubin-Épinay;1033;16;1049
28;Normandie;76;1;08;562;Saint-Aubin-le-Cauf;853;18;871
28;Normandie;76;3;05;561;Saint-Aubin-lès-Elbeuf;8309;84;8393
28;Normandie;76;2;32;563;Saint-Aubin-Routot;1900;14;1914
28;Normandie;76;1;33;564;Saint-Aubin-sur-Mer;170;3;173
28;Normandie;76;1;07;565;Saint-Aubin-sur-Scie;1085;71;1156
28;Normandie;76;3;35;568;Saint-Clair-sur-les-Monts;591;21;612
28;Normandie;76;1;20;570;Saint-Crespin;295;4;299
28;Normandie;76;1;07;572;Saint-Denis-d'Aclon;132;5;137
28;Normandie;76;3;21;573;Saint-Denis-le-Thiboult;504;14;518
28;Normandie;76;1;20;574;Saint-Denis-sur-Scie;674;4;678
28;Normandie;76;3;98;575;Saint-Étienne-du-Rouvray;28641;280;28921
28;Normandie;76;2;03;576;Saint-Eustache-la-Forêt;1146;16;1162
28;Normandie;76;3;02;580;Saint-Georges-sur-Fontaine;911;18;929
28;Normandie;76;1;20;582;Saint-Germain-d'Étables;263;1;264
28;Normandie;76;3;21;581;Saint-Germain-des-Essourts;406;6;412
28;Normandie;76;3;21;583;Saint-Germain-sous-Cailly;344;5;349
28;Normandie;76;1;23;584;Saint-Germain-sur-Eaulne;207;5;212
28;Normandie;76;3;25;585;Saint-Gilles-de-Crétot;434;11;445
28;Normandie;76;2;32;586;Saint-Gilles-de-la-Neuville;645;6;651
28;Normandie;76;1;23;588;Saint-Hellier;459;5;464
28;Normandie;76;1;20;589;Saint-Honoré;208;3;211
28;Normandie;76;1;08;590;Saint-Jacques-d'Aliermont;349;2;351
28;Normandie;76;3;06;591;Saint-Jacques-sur-Darnétal;2835;42;2877
28;Normandie;76;2;03;592;Saint-Jean-de-Folleville;827;20;847
28;Normandie;76;2;03;593;Saint-Jean-de-la-Neuville;587;11;598
28;Normandie;76;3;24;594;Saint-Jean-du-Cardonnay;1377;23;1400
28;Normandie;76;2;26;595;Saint-Jouin-Bruneval;1869;38;1907
28;Normandie;76;2;32;596;Saint-Laurent-de-Brèvedent;1467;37;1504
28;Normandie;76;3;35;597;Saint-Laurent-en-Caux;771;10;781
28;Normandie;76;1;10;598;Saint-Léger-aux-Bois;497;7;504
28;Normandie;76;3;06;599;Saint-Léger-du-Bourg-Denis;3450;49;3499
28;Normandie;76;2;11;600;Saint-Léonard;1724;32;1756
28;Normandie;76;1;12;601;Saint-Lucien;245;3;248
28;Normandie;76;1;20;602;Saint-Maclou-de-Folleville;632;12;644
28;Normandie;76;2;32;603;Saint-Maclou-la-Brière;477;6;483
28;Normandie;76;1;20;604;Saint-Mards;194;6;200
28;Normandie;76;1;10;612;Saint-Martin-au-Bosc;251;5;256
28;Normandie;76;3;35;611;Saint-Martin-aux-Arbres;324;9;333
28;Normandie;76;1;33;613;Saint-Martin-aux-Buneaux;660;19;679
28;Normandie;76;3;01;614;Saint-Martin-de-Boscherville;1521;32;1553
28;Normandie;76;3;24;289;Saint Martin de l'If;1699;26;1725
28;Normandie;76;2;26;615;Saint-Martin-du-Bec;609;24;633
28;Normandie;76;2;26;616;Saint-Martin-du-Manoir;1512;33;1545
28;Normandie;76;3;06;617;Saint-Martin-du-Vivier;1629;64;1693
28;Normandie;76;1;23;620;Saint-Martin-l'Hortier;278;7;285
28;Normandie;76;1;10;619;Saint-Martin-le-Gaillard;298;6;304
28;Normandie;76;1;23;621;Saint-Martin-Osmonville;1171;22;1193
28;Normandie;76;2;25;622;Saint-Maurice-d'Ételan;305;10;315
28;Normandie;76;1;12;623;Saint-Michel-d'Halescourt;122;5;127
28;Normandie;76;1;08;624;Saint-Nicolas-d'Aliermont;3705;59;3764
28;Normandie;76;3;25;626;Saint-Nicolas-de-la-Haie;413;6;419
28;Normandie;76;2;03;627;Saint-Nicolas-de-la-Taille;1572;18;1590
28;Normandie;76;1;20;628;Saint-Ouen-du-Breuil;778;14;792
28;Normandie;76;1;20;629;Saint-Ouen-le-Mauger;302;6;308
28;Normandie;76;1;08;630;Saint-Ouen-sous-Bailly;220;6;226
28;Normandie;76;3;01;631;Saint-Paër;1346;15;1361
28;Normandie;76;1;20;632;Saint-Pierre-Bénouville;379;3;382
28;Normandie;76;3;04;634;Saint-Pierre-de-Manneville;921;8;929
28;Normandie;76;3;01;636;Saint-Pierre-de-Varengeville;2338;23;2361
28;Normandie;76;1;23;635;Saint-Pierre-des-Jonquières;74;0;74
28;Normandie;76;2;11;637;Saint-Pierre-en-Port;831;11;842
28;Normandie;76;1;10;638;Saint-Pierre-en-Val;1100;20;1120
28;Normandie;76;1;33;641;Saint-Pierre-le-Vieux;192;5;197
28;Normandie;76;1;33;642;Saint-Pierre-le-Viger;257;3;260
28;Normandie;76;3;05;640;Saint-Pierre-lès-Elbeuf;8202;77;8279
28;Normandie;76;1;10;644;Saint-Rémy-Boscrocourt;803;16;819
28;Normandie;76;1;10;645;Saint-Riquier-en-Rivière;148;5;153
28;Normandie;76;1;33;646;Saint-Riquier-ès-Plains;585;21;606
28;Normandie;76;2;32;647;Saint-Romain-de-Colbosc;4132;40;4172
28;Normandie;76;1;23;648;Saint-Saëns;2391;23;2414
28;Normandie;76;1;23;649;Saint-Saire;611;11;622
28;Normandie;76;2;32;650;Saint-Sauveur-d'Émalleville;1214;26;1240
28;Normandie;76;1;33;651;Saint-Sylvain;179;2;181
28;Normandie;76;1;08;652;Saint-Vaast-d'Équiqueville;750;5;755
28;Normandie;76;1;33;653;Saint-Vaast-Dieppedalle;368;3;371
28;Normandie;76;1;20;654;Saint-Vaast-du-Val;471;8;479
28;Normandie;76;1;33;655;Saint-Valery-en-Caux;4006;161;4167
28;Normandie;76;1;20;656;Saint-Victor-l'Abbaye;771;8;779
28;Normandie;76;2;32;657;Saint-Vigor-d'Ymonville;1130;27;1157
28;Normandie;76;2;32;658;Saint-Vincent-Cramesnil;655;20;675
28;Normandie;76;2;19;552;Sainte-Adresse;7389;260;7649
28;Normandie;76;1;23;553;Sainte-Agathe-d'Aliermont;310;5;315
28;Normandie;76;3;24;566;Sainte-Austreberthe;612;5;617
28;Normandie;76;1;23;567;Sainte-Beuve-en-Rivière;183;5;188
28;Normandie;76;1;33;569;Sainte-Colombe;215;4;219
28;Normandie;76;3;21;571;Sainte-Croix-sur-Buchy;697;4;701
28;Normandie;76;1;20;577;Sainte-Foy;593;12;605
28;Normandie;76;1;23;578;Sainte-Geneviève;270;3;273
28;Normandie;76;2;11;587;Sainte-Hélène-Bondeville;709;10;719
28;Normandie;76;3;01;608;Sainte-Marguerite-sur-Duclair;2028;41;2069
28;Normandie;76;1;07;605;Sainte-Marguerite-sur-Mer;477;11;488
28;Normandie;76;2;26;609;Sainte-Marie-au-Bosc;367;12;379
28;Normandie;76;3;35;610;Sainte-Marie-des-Champs;1582;13;1595
28;Normandie;76;2;32;660;Sandouville;801;8;809
28;Normandie;76;1;20;662;Sassetot-le-Malgardé;116;0;116
28;Normandie;76;2;11;663;Sassetot-le-Mauconduit;1100;18;1118
28;Normandie;76;1;33;664;Sasseville;273;5;278
28;Normandie;76;1;08;665;Sauchay;415;5;420
28;Normandie;76;1;12;666;Saumont-la-Poterie;412;2;414
28;Normandie;76;1;07;667;Sauqueville;345;6;351
28;Normandie;76;3;35;668;Saussay;376;7;383
28;Normandie;76;2;32;669;Sausseuzemare-en-Caux;435;7;442
28;Normandie;76;2;11;670;Senneville-sur-Fécamp;882;11;893
28;Normandie;76;1;10;671;Sept-Meules;193;2;195
28;Normandie;76;1;12;672;Serqueux;991;21;1012
28;Normandie;76;3;21;673;Servaville-Salmonville;1133;15;1148
28;Normandie;76;3;02;675;Sierville;1039;11;1050
28;Normandie;76;1;12;676;Sigy-en-Bray;515;12;527
28;Normandie;76;1;23;677;Smermesnil;407;8;415
28;Normandie;76;1;23;678;Sommery;809;8;817
28;Normandie;76;1;33;679;Sommesnil;103;1;104
28;Normandie;76;2;11;680;Sorquainville;185;4;189
28;Normandie;76;3;99;681;Sotteville-lès-Rouen;28965;444;29409
28;Normandie;76;3;05;682;Sotteville-sous-le-Val;791;4;795
28;Normandie;76;1;33;683;Sotteville-sur-Mer;390;10;400
28;Normandie;76;2;03;684;Tancarville;1284;20;1304
28;Normandie;76;2;33;258;Terres-de-Caux;4142;110;4252
28;Normandie;76;2;11;685;Thérouldeville;664;3;667
28;Normandie;76;2;11;686;Theuville-aux-Maillots;554;6;560
28;Normandie;76;2;11;688;Thiergeville;406;12;418
28;Normandie;76;2;11;689;Thiétreville;371;38;409
28;Normandie;76;1;20;690;Thil-Manneville;608;11;619
28;Normandie;76;1;12;691;Le Thil-Riberpré;219;8;227
28;Normandie;76;1;33;692;Thiouville;309;6;315
28;Normandie;76;2;26;693;Le Tilleul;695;7;702
28;Normandie;76;1;20;694;Tocqueville-en-Caux;121;3;124
28;Normandie;76;2;32;695;Tocqueville-les-Murs;278;1;279
28;Normandie;76;1;20;697;Torcy-le-Grand;773;24;797
28;Normandie;76;1;20;698;Torcy-le-Petit;485;8;493
28;Normandie;76;3;35;699;Le Torp-Mesnil;441;4;445
28;Normandie;76;1;20;700;Tôtes;1559;31;1590
28;Normandie;76;3;35;702;Touffreville-la-Corbeline;826;15;841
28;Normandie;76;1;10;703;Touffreville-sur-Eu;209;4;213
28;Normandie;76;3;05;705;Tourville-la-Rivière;2501;21;2522
28;Normandie;76;2;11;706;Tourville-les-Ifs;613;7;620
28;Normandie;76;1;07;707;Tourville-sur-Arques;1234;39;1273
28;Normandie;76;2;11;708;Toussaint;717;11;728
28;Normandie;76;3;01;709;Le Trait;4942;45;4987
28;Normandie;76;2;33;710;Trémauville;106;2;108
28;Normandie;76;1;10;711;Le Tréport;4870;94;4964
28;Normandie;76;2;03;712;La Trinité-du-Mont;798;26;824
28;Normandie;76;2;32;714;Les Trois-Pierres;751;14;765
28;Normandie;76;2;25;715;Trouville;632;8;640
28;Normandie;76;2;26;716;Turretot;1469;24;1493
28;Normandie;76;3;04;717;Val-de-la-Haye;710;4;714
28;Normandie;76;1;20;018;Val-de-Saâne;1504;19;1523
28;Normandie;76;1;89;034;Val-de-Scie;2555;24;2579
28;Normandie;76;3;35;718;Valliquerville;1418;34;1452
28;Normandie;76;2;11;719;Valmont;847;12;859
28;Normandie;76;1;07;720;Varengeville-sur-Mer;957;33;990
28;Normandie;76;1;20;721;Varneville-Bretteville;324;9;333
28;Normandie;76;1;20;723;Vassonville;455;5;460
28;Normandie;76;1;23;724;Vatierville;133;2;135
28;Normandie;76;2;32;725;Vattetot-sous-Beaumont;576;5;581
28;Normandie;76;2;11;726;Vattetot-sur-Mer;319;6;325
28;Normandie;76;3;25;727;Vatteville-la-Rue;1140;27;1167
28;Normandie;76;3;24;728;La Vaupalière;1057;19;1076
28;Normandie;76;1;33;730;Veauville-lès-Quelles;130;2;132
28;Normandie;76;1;20;731;Vénestanville;205;2;207
28;Normandie;76;1;23;733;Ventes-Saint-Rémy;226;4;230
28;Normandie;76;2;26;734;Vergetot;442;12;454
28;Normandie;76;1;33;735;Veules-les-Roses;605;10;615
28;Normandie;76;1;33;736;Veulettes-sur-Mer;275;6;281
28;Normandie;76;3;35;737;Vibeuf;608;20;628
28;Normandie;76;3;21;738;Vieux-Manoir;736;16;752
28;Normandie;76;1;12;739;Vieux-Rouen-sur-Bresle;564;7;571
28;Normandie;76;3;21;740;La Vieux-Rue;571;10;581
28;Normandie;76;2;26;741;Villainville;294;12;306
28;Normandie;76;3;01;743;Villers-Écalles;1768;19;1787
28;Normandie;76;1;10;744;Villers-sous-Foucarmont;193;2;195
28;Normandie;76;1;10;745;Villy-sur-Yères;194;1;195
28;Normandie;76;2;11;746;Vinnemerville;216;2;218
28;Normandie;76;2;32;747;Virville;357;8;365
28;Normandie;76;1;33;748;Vittefleur;655;7;662
28;Normandie;76;1;23;749;Wanchy-Capval;356;2;358
28;Normandie;76;3;01;750;Yainville;1050;13;1063
28;Normandie;76;2;33;751;Yébleron;1284;18;1302
28;Normandie;76;3;35;752;Yerville;2418;19;2437
28;Normandie;76;3;06;753;Ymare;1154;22;1176
28;Normandie;76;2;11;754;Yport;798;16;814
28;Normandie;76;2;11;755;Ypreville-Biville;573;8;581
28;Normandie;76;3;21;756;Yquebeuf;238;8;246
28;Normandie;76;3;35;757;Yvecrique;644;7;651
28;Normandie;76;3;35;758;Yvetot;11859;264;12123
28;Normandie;76;3;01;759;Yville-sur-Seine;451;5;456
11;Île-de-France;77;4;07;001;Achères-la-Forêt;1125;19;1144
11;Île-de-France;77;1;05;002;Amillis;825;6;831
11;Île-de-France;77;4;07;003;Amponville;351;15;366
11;Île-de-France;77;2;14;004;Andrezel;284;4;288
11;Île-de-France;77;1;03;005;Annet-sur-Marne;3278;44;3322
11;Île-de-France;77;4;07;006;Arbonne-la-Forêt;995;21;1016
11;Île-de-France;77;2;14;007;Argentières;376;8;384
11;Île-de-France;77;1;06;008;Armentières-en-Brie;1242;24;1266
11;Île-de-France;77;4;15;009;Arville;125;0;125
11;Île-de-France;77;3;14;010;Aubepierre-Ozouer-le-Repos;917;10;927
11;Île-de-France;77;4;15;011;Aufferville;514;11;525
11;Île-de-France;77;3;18;012;Augers-en-Brie;300;7;307
11;Île-de-France;77;1;05;013;Aulnoy;356;8;364
11;Île-de-France;77;4;07;014;Avon;13886;240;14126
11;Île-de-France;77;3;18;015;Baby;95;2;97
11;Île-de-France;77;4;15;016;Bagneaux-sur-Loing;1666;16;1682
11;Île-de-France;77;5;21;018;Bailly-Romainvilliers;7521;61;7582
11;Île-de-France;77;3;18;019;Balloy;327;3;330
11;Île-de-France;77;3;18;020;Bannost-Villegagnon;658;11;669
11;Île-de-France;77;3;13;021;Barbey;148;2;150
11;Île-de-France;77;4;07;022;Barbizon;1135;32;1167
11;Île-de-France;77;1;03;023;Barcy;304;7;311
11;Île-de-France;77;1;06;024;Bassevelle;364;3;367
11;Île-de-France;77;3;18;025;Bazoches-lès-Bray;861;8;869
11;Île-de-France;77;3;18;026;Beauchery-Saint-Martin;368;15;383
11;Île-de-France;77;4;15;027;Beaumont-du-Gâtinais;1180;15;1195
11;Île-de-France;77;1;05;433;Beautheil-Saints;2015;34;2049
11;Île-de-France;77;2;14;029;Beauvoir;205;3;208
11;Île-de-France;77;3;05;030;Bellot;774;5;779
11;Île-de-France;77;3;08;031;Bernay-Vilbert;827;7;834
11;Île-de-France;77;3;18;032;Beton-Bazoches;906;16;922
11;Île-de-France;77;3;18;033;Bezalles;241;8;249
11;Île-de-France;77;2;14;034;Blandy;739;7;746
11;Île-de-France;77;3;15;035;Blennes;559;6;565
11;Île-de-France;77;4;14;037;Bois-le-Roi;5876;149;6025
11;Île-de-France;77;3;18;036;Boisdon;140;3;143
11;Île-de-France;77;2;20;038;Boissettes;401;5;406
11;Île-de-France;77;2;20;039;Boissise-la-Bertrand;1150;11;1161
11;Île-de-France;77;2;19;040;Boissise-le-Roi;3775;41;3816
11;Île-de-France;77;4;07;041;Boissy-aux-Cailles;290;5;295
11;Île-de-France;77;1;05;042;Boissy-le-Châtel;3151;53;3204
11;Île-de-France;77;3;05;043;Boitron;373;4;377
11;Île-de-France;77;2;14;044;Bombon;961;8;969
11;Île-de-France;77;4;15;045;Bougligny;725;9;734
11;Île-de-France;77;4;07;046;Boulancourt;347;11;358
11;Île-de-France;77;1;21;047;Bouleurs;1645;17;1662
11;Île-de-France;77;4;07;048;Bourron-Marlotte;2772;82;2854
11;Île-de-France;77;1;21;049;Boutigny;862;14;876
11;Île-de-France;77;4;15;050;Bransles;568;6;574
11;Île-de-France;77;3;18;051;Bray-sur-Seine;2243;18;2261
11;Île-de-France;77;3;14;052;Bréau;327;5;332
11;Île-de-France;77;5;04;053;Brie-Comte-Robert;17817;316;18133
11;Île-de-France;77;3;13;054;La Brosse-Montceaux;773;12;785
11;Île-de-France;77;5;23;055;Brou-sur-Chantereine;4382;11;4393
11;Île-de-France;77;4;07;056;Burcy;154;6;160
11;Île-de-France;77;1;06;057;Bussières;524;3;527
11;Île-de-France;77;5;22;058;Bussy-Saint-Georges;27379;335;27714
11;Île-de-France;77;5;22;059;Bussy-Saint-Martin;676;15;691
11;Île-de-France;77;4;07;060;Buthiers;730;16;746
11;Île-de-France;77;3;13;061;Cannes-Écluse;2466;37;2503
11;Île-de-France;77;5;09;062;Carnetin;454;9;463
11;Île-de-France;77;1;05;063;La Celle-sur-Morin;1313;13;1326
11;Île-de-France;77;4;07;065;Cély;1183;23;1206
11;Île-de-France;77;3;18;066;Cerneux;323;8;331
11;Île-de-France;77;2;20;067;Cesson;10418;140;10558
11;Île-de-France;77;3;18;068;Cessoy-en-Montois;214;4;218
11;Île-de-France;77;4;07;069;Chailly-en-Bière;2037;27;2064
11;Île-de-France;77;1;05;070;Chailly-en-Brie;1394;103;1497
11;Île-de-France;77;4;15;071;Chaintreaux;909;14;923
11;Île-de-France;77;3;18;072;Chalautre-la-Grande;703;11;714
11;Île-de-France;77;3;18;073;Chalautre-la-Petite;572;17;589
11;Île-de-France;77;5;09;075;Chalifert;1266;15;1281
11;Île-de-France;77;3;18;076;Chalmaison;752;53;805
11;Île-de-France;77;1;03;077;Chambry;979;12;991
11;Île-de-France;77;1;06;078;Chamigny;1356;54;1410
11;Île-de-France;77;4;13;079;Champagne-sur-Seine;6233;134;6367
11;Île-de-France;77;3;18;080;Champcenest;208;1;209
11;Île-de-France;77;2;14;081;Champdeuil;726;8;734
11;Île-de-France;77;2;14;082;Champeaux;823;12;835
11;Île-de-France;77;5;01;083;Champs-sur-Marne;25041;154;25195
11;Île-de-France;77;1;06;084;Changis-sur-Marne;1261;12;1273
11;Île-de-France;77;5;09;085;Chanteloup-en-Brie;3953;26;3979
11;Île-de-France;77;3;14;086;La Chapelle-Gauthier;1454;5;1459
11;Île-de-France;77;3;08;087;La Chapelle-Iger;169;0;169
11;Île-de-France;77;4;07;088;La Chapelle-la-Reine;2418;30;2448
11;Île-de-France;77;3;05;093;La Chapelle-Moutils;443;3;446
11;Île-de-France;77;3;14;089;La Chapelle-Rablais;946;6;952
11;Île-de-France;77;3;18;090;La Chapelle-Saint-Sulpice;243;4;247
11;Île-de-France;77;3;08;091;Les Chapelles-Bourbon;470;3;473
11;Île-de-France;77;1;03;094;Charmentray;289;1;290
11;Île-de-France;77;1;03;095;Charny;1313;15;1328
11;Île-de-France;77;4;14;096;Chartrettes;2554;57;2611
11;Île-de-France;77;3;05;097;Chartronges;296;2;298
11;Île-de-France;77;4;15;099;Château-Landon;2952;61;3013
11;Île-de-France;77;3;14;098;Châteaubleau;361;2;363
11;Île-de-France;77;2;14;100;Le Châtelet-en-Brie;4454;87;4541
11;Île-de-France;77;3;18;101;Châtenay-sur-Seine;1024;11;1035
11;Île-de-France;77;4;15;102;Châtenoy;168;2;170
11;Île-de-France;77;2;14;103;Châtillon-la-Borde;216;2;218
11;Île-de-France;77;3;08;104;Châtres;678;7;685
11;Île-de-France;77;1;03;335;Chauconin-Neufmontiers;3289;26;3315
11;Île-de-France;77;1;05;106;Chauffry;1022;15;1037
11;Île-de-France;77;2;08;107;Chaumes-en-Brie;3242;26;3268
11;Île-de-France;77;5;02;108;Chelles;54917;278;55195
11;Île-de-France;77;3;18;109;Chenoise-Cucharmoy;1623;26;1649
11;Île-de-France;77;4;15;110;Chenou;327;2;329
11;Île-de-France;77;5;21;111;Chessy;5633;50;5683
11;Île-de-France;77;4;15;112;Chevrainvilliers;242;4;246
11;Île-de-France;77;1;05;113;Chevru;1105;13;1118
11;Île-de-France;77;5;16;114;Chevry-Cossigny;3952;40;3992
11;Île-de-France;77;3;15;115;Chevry-en-Sereine;522;11;533
11;Île-de-France;77;3;05;116;Choisy-en-Brie;1349;18;1367
11;Île-de-France;77;1;06;117;Citry;917;9;926
11;Île-de-France;77;1;03;118;Claye-Souilly;12486;145;12631
11;Île-de-France;77;3;14;119;Clos-Fontaine;263;3;266
11;Île-de-France;77;1;06;120;Cocherel;635;4;639
11;Île-de-France;77;5;22;121;Collégien;3400;26;3426
11;Île-de-France;77;2;04;122;Combs-la-Ville;22383;173;22556
11;Île-de-France;77;1;12;123;Compans;808;1;809
11;Île-de-France;77;5;09;124;Conches-sur-Gondoire;1746;28;1774
11;Île-de-France;77;1;21;125;Condé-Sainte-Libiaire;1417;17;1434
11;Île-de-France;77;1;06;126;Congis-sur-Thérouanne;1768;193;1961
11;Île-de-France;77;2;08;127;Coubert;1934;14;1948
11;Île-de-France;77;1;21;128;Couilly-Pont-aux-Dames;2154;30;2184
11;Île-de-France;77;1;06;129;Coulombs-en-Valois;571;9;580
11;Île-de-France;77;1;21;130;Coulommes;430;6;436
11;Île-de-France;77;1;05;131;Coulommiers;14838;238;15076
11;Île-de-France;77;5;21;132;Coupvray;2864;28;2892
11;Île-de-France;77;3;13;133;Courcelles-en-Bassée;206;3;209
11;Île-de-France;77;3;18;134;Courchamp;150;3;153
11;Île-de-France;77;3;08;135;Courpalay;1323;14;1337
11;Île-de-France;77;2;08;136;Courquetaine;195;7;202
11;Île-de-France;77;3;18;137;Courtacon;242;10;252
11;Île-de-France;77;3;14;138;Courtomer;532;6;538
11;Île-de-France;77;5;23;139;Courtry;6492;48;6540
11;Île-de-France;77;3;18;140;Coutençon;300;5;305
11;Île-de-France;77;1;21;141;Coutevroult;1108;12;1120
11;Île-de-France;77;1;21;142;Crécy-la-Chapelle;4531;61;4592
11;Île-de-France;77;1;03;143;Crégy-lès-Meaux;4749;46;4795
11;Île-de-France;77;3;08;144;Crèvecœur-en-Brie;406;1;407
11;Île-de-France;77;2;14;145;Crisenoy;659;13;672
11;Île-de-France;77;5;01;146;Croissy-Beaubourg;1987;21;2008
11;Île-de-France;77;3;14;147;La Croix-en-Brie;671;8;679
11;Île-de-France;77;1;06;148;Crouy-sur-Ourcq;1914;24;1938
11;Île-de-France;77;1;03;150;Cuisy;441;2;443
11;Île-de-France;77;1;05;151;Dagny;294;4;298
11;Île-de-France;77;2;19;152;Dammarie-les-Lys;21835;152;21987
11;Île-de-France;77;1;12;153;Dammartin-en-Goële;9920;86;10006
11;Île-de-France;77;1;08;154;Dammartin-sur-Tigeaux;1068;14;1082
11;Île-de-France;77;5;09;155;Dampmart;3375;37;3412
11;Île-de-France;77;4;15;156;Darvault;875;15;890
11;Île-de-France;77;1;06;157;Dhuisy;300;6;306
11;Île-de-France;77;3;15;158;Diant;197;2;199
11;Île-de-France;77;3;18;159;Donnemarie-Dontilly;2832;48;2880
11;Île-de-France;77;4;15;161;Dormelles;806;18;824
11;Île-de-France;77;3;05;162;Doue;1019;8;1027
11;Île-de-France;77;1;06;163;Douy-la-Ramée;325;5;330
11;Île-de-France;77;2;14;164;Échouboulains;557;6;563
11;Île-de-France;77;2;14;165;Les Écrennes;604;6;610
11;Île-de-France;77;3;18;167;Égligny;331;6;337
11;Île-de-France;77;4;15;168;Égreville;2150;39;2189
11;Île-de-France;77;5;17;169;Émerainville;7720;32;7752
11;Île-de-France;77;1;21;171;Esbly;6220;44;6264
11;Île-de-France;77;3;13;172;Esmans;899;9;908
11;Île-de-France;77;1;06;173;Étrépilly;889;10;899
11;Île-de-France;77;3;18;174;Everly;590;15;605
11;Île-de-France;77;2;08;175;Évry-Grégy-sur-Yerre;2866;30;2896
11;Île-de-France;77;1;08;176;Faremoutiers;2822;26;2848
11;Île-de-France;77;3;16;177;Favières;1109;14;1123
11;Île-de-France;77;4;15;178;Faÿ-lès-Nemours;487;11;498
11;Île-de-France;77;2;14;179;Féricy;579;20;599
11;Île-de-France;77;5;16;180;Férolles-Attilly;1237;28;1265
11;Île-de-France;77;3;16;181;Ferrières-en-Brie;3433;31;3464
11;Île-de-France;77;3;05;182;La Ferté-Gaucher;4860;48;4908
11;Île-de-France;77;1;06;183;La Ferté-sous-Jouarre;9619;84;9703
11;Île-de-France;77;4;15;184;Flagy;649;16;665
11;Île-de-France;77;4;07;185;Fleury-en-Bière;656;17;673
11;Île-de-France;77;3;18;187;Fontaine-Fourches;602;3;605
11;Île-de-France;77;2;14;188;Fontaine-le-Port;1001;18;1019
11;Île-de-France;77;4;07;186;Fontainebleau;14886;437;15323
11;Île-de-France;77;3;14;190;Fontains;247;5;252
11;Île-de-France;77;3;14;191;Fontenailles;1066;13;1079
11;Île-de-France;77;3;08;192;Fontenay-Trésigny;5574;55;5629
11;Île-de-France;77;1;03;193;Forfry;218;0;218
11;Île-de-France;77;3;13;194;Forges;418;67;485
11;Île-de-France;77;2;14;195;Fouju;575;11;586
11;Île-de-France;77;1;03;196;Fresnes-sur-Marne;931;3;934
11;Île-de-France;77;3;18;197;Frétoy;167;5;172
11;Île-de-France;77;4;07;198;Fromont;239;4;243
11;Île-de-France;77;1;06;199;Fublaines;1366;12;1378
11;Île-de-France;77;4;15;200;Garentreville;114;1;115
11;Île-de-France;77;3;14;201;Gastins;689;4;693
11;Île-de-France;77;4;15;202;La Genevraye;784;11;795
11;Île-de-France;77;1;06;203;Germigny-l'Évêque;1306;19;1325
11;Île-de-France;77;1;06;204;Germigny-sous-Coulombs;209;3;212
11;Île-de-France;77;1;03;205;Gesvres-le-Chapitre;151;1;152
11;Île-de-France;77;1;05;206;Giremoutiers;172;4;176
11;Île-de-France;77;4;15;207;Gironville;155;5;160
11;Île-de-France;77;3;18;208;Gouaix;1479;34;1513
11;Île-de-France;77;5;09;209;Gouvernes;1176;18;1194
11;Île-de-France;77;3;13;210;La Grande-Paroisse;2786;35;2821
11;Île-de-France;77;3;14;211;Grandpuits-Bailly-Carrois;1028;9;1037
11;Île-de-France;77;3;18;212;Gravon;165;3;168
11;Île-de-France;77;1;03;214;Gressy;840;13;853
11;Île-de-France;77;5;16;215;Gretz-Armainvilliers;8657;62;8719
11;Île-de-France;77;4;15;216;Grez-sur-Loing;1414;37;1451
11;Île-de-France;77;2;08;217;Grisy-Suisnes;2451;30;2481
11;Île-de-France;77;3;18;218;Grisy-sur-Seine;109;1;110
11;Île-de-France;77;1;08;219;Guérard;2480;32;2512
11;Île-de-France;77;4;07;220;Guercheville;269;4;273
11;Île-de-France;77;5;09;221;Guermantes;1147;24;1171
11;Île-de-France;77;2;14;222;Guignes;4095;30;4125
11;Île-de-France;77;3;18;223;Gurcy-le-Châtel;573;6;579
11;Île-de-France;77;1;21;225;La Haute-Maison;300;9;309
11;Île-de-France;77;1;05;224;Hautefeuille;255;2;257
11;Île-de-France;77;4;07;226;Héricy;2604;106;2710
11;Île-de-France;77;3;18;227;Hermé;642;17;659
11;Île-de-France;77;3;05;228;Hondevilliers;254;4;258
11;Île-de-France;77;3;08;229;La Houssaye-en-Brie;1629;17;1646
11;Île-de-France;77;4;15;230;Ichy;166;2;168
11;Île-de-France;77;1;06;231;Isles-les-Meldeuses;806;2;808
11;Île-de-France;77;1;03;232;Isles-lès-Villenoy;1014;15;1029
11;Île-de-France;77;1;03;233;Iverny;588;3;591
11;Île-de-France;77;5;09;234;Jablines;686;7;693
11;Île-de-France;77;1;06;235;Jaignes;308;5;313
11;Île-de-France;77;3;18;236;Jaulnes;362;4;366
11;Île-de-France;77;5;22;237;Jossigny;687;2;689
11;Île-de-France;77;1;06;238;Jouarre;4337;42;4379
11;Île-de-France;77;3;18;239;Jouy-le-Châtel;1527;20;1547
11;Île-de-France;77;3;05;240;Jouy-sur-Morin;2096;27;2123
11;Île-de-France;77;1;12;241;Juilly;1963;11;1974
11;Île-de-France;77;3;18;242;Jutigny;551;7;558
11;Île-de-France;77;5;09;243;Lagny-sur-Marne;21356;245;21601
11;Île-de-France;77;4;15;244;Larchant;696;43;739
11;Île-de-France;77;3;13;245;Laval-en-Brie;448;4;452
11;Île-de-France;77;3;18;246;Léchelle;596;12;608
11;Île-de-France;77;3;05;247;Lescherolles;463;11;474
11;Île-de-France;77;5;09;248;Lesches;743;8;751
11;Île-de-France;77;5;16;249;Lésigny;7214;120;7334
11;Île-de-France;77;3;05;250;Leudon-en-Brie;164;7;171
11;Île-de-France;77;2;04;251;Lieusaint;13291;75;13366
11;Île-de-France;77;2;08;252;Limoges-Fourches;490;5;495
11;Île-de-France;77;2;08;253;Lissy;230;1;231
11;Île-de-France;77;3;08;254;Liverdy-en-Brie;1316;20;1336
11;Île-de-France;77;2;11;255;Livry-sur-Seine;2076;35;2111
11;Île-de-France;77;3;18;256;Lizines;185;1;186
11;Île-de-France;77;1;06;257;Lizy-sur-Ourcq;3566;21;3587
11;Île-de-France;77;5;01;258;Lognes;14000;63;14063
11;Île-de-France;77;1;12;259;Longperrier;2368;11;2379
11;Île-de-France;77;3;18;260;Longueville;1796;25;1821
11;Île-de-France;77;4;15;261;Lorrez-le-Bocage-Préaux;1230;20;1250
11;Île-de-France;77;3;18;262;Louan-Villegruis-Fontaine;477;9;486
11;Île-de-France;77;3;18;263;Luisetaines;243;5;248
11;Île-de-France;77;3;08;264;Lumigny-Nesles-Ormeaux;1527;15;1542
11;Île-de-France;77;1;06;265;Luzancy;1110;48;1158
11;Île-de-France;77;2;14;266;Machault;783;12;795
11;Île-de-France;77;4;15;267;La Madeleine-sur-Loing;355;4;359
11;Île-de-France;77;5;21;268;Magny-le-Hongre;8645;142;8787
11;Île-de-France;77;2;11;269;Maincy;1732;48;1780
11;Île-de-France;77;3;18;272;Maison-Rouge;879;8;887
11;Île-de-France;77;1;05;270;Maisoncelles-en-Brie;900;11;911
11;Île-de-France;77;4;15;271;Maisoncelles-en-Gâtinais;133;1;134
11;Île-de-France;77;1;12;273;Marchémoret;564;4;568
11;Île-de-France;77;1;06;274;Marcilly;473;2;475
11;Île-de-France;77;3;18;275;Les Marêts;149;4;153
11;Île-de-France;77;1;03;276;Mareuil-lès-Meaux;3108;49;3157
11;Île-de-France;77;3;08;277;Marles-en-Brie;1679;21;1700
11;Île-de-France;77;1;05;278;Marolles-en-Brie;401;3;404
11;Île-de-France;77;3;13;279;Marolles-sur-Seine;1748;33;1781
11;Île-de-France;77;1;06;280;Mary-sur-Marne;1159;12;1171
11;Île-de-France;77;1;05;281;Mauperthuis;483;3;486
11;Île-de-France;77;1;12;282;Mauregard;353;0;353
11;Île-de-France;77;1;06;283;May-en-Multien;912;3;915
11;Île-de-France;77;1;10;284;Meaux;54991;470;55461
11;Île-de-France;77;2;20;285;Le Mée-sur-Seine;20816;139;20955
11;Île-de-France;77;3;18;286;Meigneux;232;6;238
11;Île-de-France;77;3;05;287;Meilleray;501;11;512
11;Île-de-France;77;2;11;288;Melun;40032;316;40348
11;Île-de-France;77;3;18;289;Melz-sur-Seine;352;3;355
11;Île-de-France;77;1;06;290;Méry-sur-Marne;670;46;716
11;Île-de-France;77;1;12;291;Le Mesnil-Amelot;1014;5;1019
11;Île-de-France;77;1;03;292;Messy;1161;11;1172
11;Île-de-France;77;3;13;293;Misy-sur-Yonne;978;11;989
11;Île-de-France;77;1;12;294;Mitry-Mory;19931;79;20010
11;Île-de-France;77;2;14;295;Moisenay;1380;14;1394
11;Île-de-France;77;2;04;296;Moissy-Cramayel;17713;126;17839
11;Île-de-France;77;4;15;297;Mondreville;337;4;341
11;Île-de-France;77;3;18;298;Mons-en-Montois;452;10;462
11;Île-de-France;77;1;06;300;Montceaux-lès-Meaux;594;12;606
11;Île-de-France;77;3;18;301;Montceaux-lès-Provins;330;1;331
11;Île-de-France;77;4;15;302;Montcourt-Fromonville;1982;35;2017
11;Île-de-France;77;3;05;303;Montdauphin;246;3;249
11;Île-de-France;77;3;05;304;Montenils;26;0;26
11;Île-de-France;77;3;13;305;Montereau-Fault-Yonne;20206;194;20400
11;Île-de-France;77;2;11;306;Montereau-sur-le-Jard;516;6;522
11;Île-de-France;77;5;09;307;Montévrain;11563;106;11669
11;Île-de-France;77;1;12;308;Montgé-en-Goële;772;6;778
11;Île-de-France;77;1;03;309;Monthyon;1707;11;1718
11;Île-de-France;77;3;18;310;Montigny-le-Guesdier;301;6;307
11;Île-de-France;77;3;18;311;Montigny-Lencoup;1386;14;1400
11;Île-de-France;77;4;15;312;Montigny-sur-Loing;2701;76;2777
11;Île-de-France;77;3;15;313;Montmachoux;246;2;248
11;Île-de-France;77;3;05;314;Montolivet;238;2;240
11;Île-de-France;77;1;21;315;Montry;3631;30;3661
11;Île-de-France;77;4;13;316;Moret-Loing-et-Orvanne;12214;338;12552
11;Île-de-France;77;3;14;317;Mormant;4834;22;4856
11;Île-de-France;77;3;08;318;Mortcerf;1445;15;1460
11;Île-de-France;77;3;18;319;Mortery;149;3;152
11;Île-de-France;77;1;05;320;Mouroux;5491;58;5549
11;Île-de-France;77;3;18;321;Mousseaux-lès-Bray;701;6;707
11;Île-de-France;77;1;12;322;Moussy-le-Neuf;3054;20;3074
11;Île-de-France;77;1;12;323;Moussy-le-Vieux;1428;5;1433
11;Île-de-France;77;3;18;325;Mouy-sur-Seine;357;4;361
11;Île-de-France;77;2;19;326;Nandy;6042;65;6107
11;Île-de-France;77;3;14;327;Nangis;8710;83;8793
11;Île-de-France;77;4;07;328;Nanteau-sur-Essonne;435;8;443
11;Île-de-France;77;4;15;329;Nanteau-sur-Lunain;695;4;699
11;Île-de-France;77;1;06;330;Nanteuil-lès-Meaux;6160;72;6232
11;Île-de-France;77;1;06;331;Nanteuil-sur-Marne;430;5;435
11;Île-de-France;77;1;12;332;Nantouillet;277;1;278
11;Île-de-France;77;4;15;333;Nemours;13081;134;13215
11;Île-de-France;77;3;08;336;Neufmoutiers-en-Brie;1091;20;1111
11;Île-de-France;77;5;01;337;Noisiel;15230;103;15333
11;Île-de-France;77;3;15;338;Noisy-Rudignon;610;8;618
11;Île-de-France;77;4;07;339;Noisy-sur-École;1832;57;1889
11;Île-de-France;77;4;15;340;Nonville;618;12;630
11;Île-de-France;77;3;18;341;Noyen-sur-Seine;371;10;381
11;Île-de-France;77;4;15;342;Obsonville;112;1;113
11;Île-de-France;77;1;06;343;Ocquerre;429;24;453
11;Île-de-France;77;1;03;344;Oissery;2276;22;2298
11;Île-de-France;77;3;05;345;Orly-sur-Morin;677;11;688
11;Île-de-France;77;3;18;347;Les Ormes-sur-Voulzie;858;10;868
11;Île-de-France;77;4;15;348;Ormesson;243;6;249
11;Île-de-France;77;1;12;349;Othis;6680;77;6757
11;Île-de-France;77;5;16;350;Ozoir-la-Ferrière;20331;169;20500
11;Île-de-France;77;2;08;352;Ozouer-le-Voulgis;1904;21;1925
11;Île-de-France;77;4;15;353;Paley;421;7;428
11;Île-de-France;77;2;14;354;Pamfou;942;9;951
11;Île-de-France;77;3;18;355;Paroy;167;1;168
11;Île-de-France;77;3;18;356;Passy-sur-Seine;47;1;48
11;Île-de-France;77;3;08;357;Pécy;863;7;870
11;Île-de-France;77;1;03;358;Penchard;1083;13;1096
11;Île-de-France;77;4;07;359;Perthes;1995;24;2019
11;Île-de-France;77;1;05;360;Pézarches;392;4;396
11;Île-de-France;77;1;06;361;Pierre-Levée;470;7;477
11;Île-de-France;77;1;23;363;Le Pin;1467;10;1477
11;Île-de-France;77;1;03;364;Le Plessis-aux-Bois;280;2;282
11;Île-de-France;77;3;08;365;Le Plessis-Feu-Aussoux;591;6;597
11;Île-de-France;77;1;03;366;Le Plessis-l'Évêque;297;4;301
11;Île-de-France;77;1;06;367;Le Plessis-Placy;268;4;272
11;Île-de-France;77;3;18;368;Poigny;528;8;536
11;Île-de-France;77;1;06;369;Poincy;692;12;704
11;Île-de-France;77;4;15;370;Poligny;798;12;810
11;Île-de-France;77;1;08;371;Pommeuse;2925;24;2949
11;Île-de-France;77;5;09;372;Pomponne;4034;37;4071
11;Île-de-France;77;5;17;373;Pontault-Combault;37747;247;37994
11;Île-de-France;77;3;16;374;Pontcarré;2251;16;2267
11;Île-de-France;77;1;03;376;Précy-sur-Marne;803;3;806
11;Île-de-France;77;3;08;377;Presles-en-Brie;2312;31;2343
11;Île-de-France;77;2;19;378;Pringy;2924;19;2943
11;Île-de-France;77;3;18;379;Provins;11844;281;12125
11;Île-de-France;77;1;06;380;Puisieux;319;5;324
11;Île-de-France;77;3;14;381;Quiers;668;5;673
11;Île-de-France;77;1;21;382;Quincy-Voisins;5435;54;5489
11;Île-de-France;77;3;14;383;Rampillon;825;6;831
11;Île-de-France;77;2;04;384;Réau;1834;4;1838
11;Île-de-France;77;3;05;385;Rebais;2288;25;2313
11;Île-de-France;77;4;07;386;Recloses;635;24;659
11;Île-de-France;77;4;15;387;Remauville;459;10;469
11;Île-de-France;77;1;06;388;Reuil-en-Brie;834;5;839
11;Île-de-France;77;2;11;389;La Rochette;3412;98;3510
11;Île-de-France;77;5;17;390;Roissy-en-Brie;22994;106;23100
11;Île-de-France;77;3;18;391;Rouilly;486;6;492
11;Île-de-France;77;1;12;392;Rouvres;899;9;908
11;Île-de-France;77;3;08;393;Rozay-en-Brie;2826;36;2862
11;Île-de-France;77;2;11;394;Rubelles;2355;19;2374
11;Île-de-France;77;4;07;395;Rumont;123;5;128
11;Île-de-France;77;3;18;396;Rupéreux;101;0;101
11;Île-de-France;77;1;06;397;Saâcy-sur-Marne;1813;36;1849
11;Île-de-France;77;3;05;398;Sablonnières;721;8;729
11;Île-de-France;77;1;05;400;Saint-Augustin;1738;29;1767
11;Île-de-France;77;3;05;402;Saint-Barthélemy;329;5;334
11;Île-de-France;77;3;18;403;Saint-Brice;781;17;798
11;Île-de-France;77;3;05;405;Saint-Cyr-sur-Morin;1952;44;1996
11;Île-de-France;77;3;05;406;Saint-Denis-lès-Rebais;975;19;994
11;Île-de-France;77;2;19;407;Saint-Fargeau-Ponthierry;14206;128;14334
11;Île-de-France;77;1;21;408;Saint-Fiacre;402;2;404
11;Île-de-France;77;3;13;409;Saint-Germain-Laval;2762;101;2863
11;Île-de-France;77;2;11;410;Saint-Germain-Laxis;743;18;761
11;Île-de-France;77;3;05;411;Saint-Germain-sous-Doue;537;11;548
11;Île-de-France;77;4;07;412;Saint-Germain-sur-École;366;5;371
11;Île-de-France;77;1;21;413;Saint-Germain-sur-Morin;3664;49;3713
11;Île-de-France;77;3;18;414;Saint-Hilliers;473;8;481
11;Île-de-France;77;1;06;415;Saint-Jean-les-Deux-Jumeaux;1272;12;1284
11;Île-de-France;77;3;14;416;Saint-Just-en-Brie;240;5;245
11;Île-de-France;77;3;05;417;Saint-Léger;261;1;262
11;Île-de-France;77;3;18;418;Saint-Loup-de-Naud;882;11;893
11;Île-de-France;77;4;13;419;Saint-Mammès;3347;119;3466
11;Île-de-France;77;1;12;420;Saint-Mard;3857;28;3885
11;Île-de-France;77;3;05;421;Saint-Mars-Vieux-Maisons;283;2;285
11;Île-de-France;77;3;05;423;Saint-Martin-des-Champs;650;11;661
11;Île-de-France;77;3;18;424;Saint-Martin-du-Boschet;287;4;291
11;Île-de-France;77;4;07;425;Saint-Martin-en-Bière;751;17;768
11;Île-de-France;77;2;14;426;Saint-Méry;344;9;353
11;Île-de-France;77;1;03;427;Saint-Mesmes;613;6;619
11;Île-de-France;77;3;14;428;Saint-Ouen-en-Brie;836;12;848
11;Île-de-France;77;3;05;429;Saint-Ouen-sur-Morin;536;5;541
11;Île-de-France;77;1;12;430;Saint-Pathus;6055;51;6106
11;Île-de-France;77;4;15;431;Saint-Pierre-lès-Nemours;5483;90;5573
11;Île-de-France;77;3;05;432;Saint-Rémy-la-Vanne;983;9;992
11;Île-de-France;77;3;18;434;Saint-Sauveur-lès-Bray;359;5;364
11;Île-de-France;77;4;07;435;Saint-Sauveur-sur-École;1122;22;1144
11;Île-de-France;77;3;05;436;Saint-Siméon;896;5;901
11;Île-de-France;77;1;03;437;Saint-Soupplets;3243;30;3273
11;Île-de-France;77;5;09;438;Saint-Thibault-des-Vignes;6447;75;6522
11;Île-de-France;77;1;06;401;Sainte-Aulde;680;7;687
11;Île-de-France;77;3;18;404;Sainte-Colombe;1822;31;1853
11;Île-de-France;77;3;13;439;Salins;1102;21;1123
11;Île-de-France;77;1;06;440;Sammeron;1125;15;1140
11;Île-de-France;77;4;07;441;Samois-sur-Seine;2053;49;2102
11;Île-de-France;77;4;07;442;Samoreau;2308;65;2373
11;Île-de-France;77;1;21;443;Sancy;383;8;391
11;Île-de-France;77;3;18;444;Sancy-lès-Provins;321;3;324
11;Île-de-France;77;2;20;445;Savigny-le-Temple;29984;238;30222
11;Île-de-France;77;3;18;446;Savins;606;9;615
11;Île-de-France;77;2;19;447;Seine-Port;1888;42;1930
11;Île-de-France;77;1;06;448;Sept-Sorts;500;8;508
11;Île-de-France;77;5;21;449;Serris;9040;87;9127
11;Île-de-France;77;5;16;450;Servon;3251;52;3303
11;Île-de-France;77;1;06;451;Signy-Signets;584;6;590
11;Île-de-France;77;3;18;452;Sigy;57;0;57
11;Île-de-France;77;2;14;453;Sivry-Courtry;1214;15;1229
11;Île-de-France;77;3;18;454;Sognolles-en-Montois;394;6;400
11;Île-de-France;77;2;08;455;Soignolles-en-Brie;1957;11;1968
11;Île-de-France;77;3;18;456;Soisy-Bouy;820;19;839
11;Île-de-France;77;2;08;457;Solers;1211;22;1233
11;Île-de-France;77;4;15;458;Souppes-sur-Loing;5390;108;5498
11;Île-de-France;77;3;18;459;Sourdun;1484;405;1889
11;Île-de-France;77;1;06;460;Tancrou;357;4;361
11;Île-de-France;77;3;18;461;Thénisy;291;6;297
11;Île-de-France;77;1;12;462;Thieux;913;3;916
11;Île-de-France;77;4;13;463;Thomery;3467;118;3585
11;Île-de-France;77;5;09;464;Thorigny-sur-Marne;10154;112;10266
11;Île-de-France;77;3;15;465;Thoury-Férottes;673;10;683
11;Île-de-France;77;1;21;466;Tigeaux;381;3;384
11;Île-de-France;77;3;18;467;La Tombe;224;0;224
11;Île-de-France;77;5;22;468;Torcy;22568;125;22693
11;Île-de-France;77;1;05;469;Touquin;1206;13;1219
11;Île-de-France;77;5;16;470;Tournan-en-Brie;8718;134;8852
11;Île-de-France;77;4;07;471;Tousson;391;8;399
11;Île-de-France;77;3;05;472;La Trétoire;493;10;503
11;Île-de-France;77;4;15;473;Treuzy-Levelay;425;7;432
11;Île-de-France;77;1;03;474;Trilbardou;662;4;666
11;Île-de-France;77;1;06;475;Trilport;5033;30;5063
11;Île-de-France;77;1;06;476;Trocy-en-Multien;239;2;241
11;Île-de-France;77;4;07;477;Ury;847;30;877
11;Île-de-France;77;1;06;478;Ussy-sur-Marne;1067;10;1077
11;Île-de-France;77;5;23;479;Vaires-sur-Marne;13327;140;13467
11;Île-de-France;77;2;14;480;Valence-en-Brie;966;8;974
11;Île-de-France;77;3;14;481;Vanvillé;183;2;185
11;Île-de-France;77;3;13;482;Varennes-sur-Seine;3469;63;3532
11;Île-de-France;77;1;03;483;Varreddes;2004;22;2026
11;Île-de-France;77;1;21;484;Vaucourtois;256;6;262
11;Île-de-France;77;4;07;485;Le Vaudoué;739;14;753
11;Île-de-France;77;3;08;486;Vaudoy-en-Brie;902;8;910
11;Île-de-France;77;2;11;487;Vaux-le-Pénil;11062;158;11220
11;Île-de-France;77;4;15;489;Vaux-sur-Lunain;226;2;228
11;Île-de-France;77;1;06;490;Vendrest;730;10;740
11;Île-de-France;77;3;05;492;Verdelot;690;7;697
11;Île-de-France;77;3;14;493;Verneuil-l'Étang;3237;19;3256
11;Île-de-France;77;4;13;494;Vernou-la-Celle-sur-Seine;2673;40;2713
11;Île-de-France;77;2;20;495;Vert-Saint-Denis;7610;79;7689
11;Île-de-France;77;3;14;496;Vieux-Champagne;190;2;192
11;Île-de-France;77;1;03;498;Vignely;309;0;309
11;Île-de-France;77;4;13;516;Ville-Saint-Jacques;814;25;839
11;Île-de-France;77;4;15;500;Villebéon;479;9;488
11;Île-de-France;77;4;13;501;Villecerf;719;17;736
11;Île-de-France;77;4;15;504;Villemaréchal;1110;17;1127
11;Île-de-France;77;1;21;505;Villemareuil;405;5;410
11;Île-de-France;77;4;15;506;Villemer;742;11;753
11;Île-de-France;77;3;18;507;Villenauxe-la-Petite;426;7;433
11;Île-de-France;77;5;16;508;Villeneuve-le-Comte;1850;36;1886
11;Île-de-France;77;3;18;509;Villeneuve-les-Bordes;612;7;619
11;Île-de-France;77;5;16;510;Villeneuve-Saint-Denis;924;4;928
11;Île-de-France;77;1;12;511;Villeneuve-sous-Dammartin;641;1;642
11;Île-de-France;77;3;05;512;Villeneuve-sur-Bellot;1131;11;1142
11;Île-de-France;77;1;03;513;Villenoy;4903;32;4935
11;Île-de-France;77;1;23;514;Villeparisis;26322;107;26429
11;Île-de-France;77;1;03;515;Villeroy;721;5;726
11;Île-de-France;77;1;23;517;Villevaudé;2122;12;2134
11;Île-de-France;77;2;07;518;Villiers-en-Bière;211;3;214
11;Île-de-France;77;3;18;519;Villiers-Saint-Georges;1231;21;1252
11;Île-de-France;77;4;07;520;Villiers-sous-Grez;681;21;702
11;Île-de-France;77;1;21;521;Villiers-sur-Morin;1926;24;1950
11;Île-de-France;77;3;18;522;Villiers-sur-Seine;300;6;306
11;Île-de-France;77;3;18;523;Villuis;265;3;268
11;Île-de-France;77;3;18;524;Vimpelles;521;10;531
11;Île-de-France;77;1;12;525;Vinantes;379;2;381
11;Île-de-France;77;1;06;526;Vincy-Manœuvre;289;5;294
11;Île-de-France;77;3;08;527;Voinsles;596;18;614
11;Île-de-France;77;2;11;528;Voisenon;1133;16;1149
11;Île-de-France;77;1;21;529;Voulangis;1522;30;1552
11;Île-de-France;77;3;18;530;Voulton;317;12;329
11;Île-de-France;77;3;15;531;Voulx;1729;23;1752
11;Île-de-France;77;3;18;532;Vulaines-lès-Provins;64;0;64
11;Île-de-France;77;4;07;533;Vulaines-sur-Seine;2722;62;2784
11;Île-de-France;77;2;14;534;Yèbles;960;3;963
11;Île-de-France;78;2;14;003;Ablis;3439;48;3487
11;Île-de-France;78;3;13;005;Achères;21017;138;21155
11;Île-de-France;78;1;02;006;Adainville;731;18;749
11;Île-de-France;78;3;16;007;Aigremont;1084;49;1133
11;Île-de-France;78;2;14;009;Allainville;306;5;311
11;Île-de-France;78;3;19;010;Les Alluets-le-Roi;1201;36;1237
11;Île-de-France;78;3;01;013;Andelu;476;4;480
11;Île-de-France;78;3;05;015;Andrésy;13324;118;13442
11;Île-de-France;78;1;02;020;Arnouville-lès-Mantes;938;12;950
11;Île-de-France;78;1;01;029;Aubergenville;11817;64;11881
11;Île-de-France;78;2;14;030;Auffargis;1982;45;2027
11;Île-de-France;78;1;02;031;Auffreville-Brasseuil;650;10;660
11;Île-de-France;78;1;01;033;Aulnay-sur-Mauldre;1140;24;1164
11;Île-de-France;78;2;01;034;Auteuil;955;19;974
11;Île-de-France;78;2;01;036;Autouillet;509;6;515
11;Île-de-France;78;4;04;043;Bailly;3721;142;3863
11;Île-de-France;78;1;02;048;Bazainville;1454;41;1495
11;Île-de-France;78;3;01;049;Bazemont;1582;41;1623
11;Île-de-France;78;2;01;050;Bazoches-sur-Guyonne;621;9;630
11;Île-de-France;78;2;01;053;Béhoust;460;8;468
11;Île-de-France;78;1;02;057;Bennecourt;1897;22;1919
11;Île-de-France;78;2;12;062;Beynes;7662;112;7774
11;Île-de-France;78;1;02;068;Blaru;889;21;910
11;Île-de-France;78;1;02;070;Boinville-en-Mantois;292;2;294
11;Île-de-France;78;2;14;071;Boinville-le-Gaillard;608;8;616
11;Île-de-France;78;1;02;072;Boinvilliers;291;2;293
11;Île-de-France;78;4;15;073;Bois-d'Arcy;15142;131;15273
11;Île-de-France;78;1;02;076;Boissets;266;4;270
11;Île-de-France;78;2;14;077;La Boissière-École;765;73;838
11;Île-de-France;78;1;02;082;Boissy-Mauvoisin;614;11;625
11;Île-de-France;78;2;01;084;Boissy-sans-Avoir;646;11;657
11;Île-de-France;78;2;14;087;Bonnelles;1963;49;2012
11;Île-de-France;78;1;02;089;Bonnières-sur-Seine;4612;40;4652
11;Île-de-France;78;1;01;090;Bouafle;2156;27;2183
11;Île-de-France;78;4;04;092;Bougival;8699;142;8841
11;Île-de-France;78;1;02;096;Bourdonné;496;8;504
11;Île-de-France;78;1;02;104;Breuil-Bois-Robert;735;12;747
11;Île-de-France;78;1;02;107;Bréval;1820;26;1846
11;Île-de-France;78;2;14;108;Les Bréviaires;1244;29;1273
11;Île-de-France;78;1;07;113;Brueil-en-Vexin;691;12;703
11;Île-de-France;78;4;21;117;Buc;5821;159;5980
11;Île-de-France;78;1;08;118;Buchelay;3133;21;3154
11;Île-de-France;78;2;14;120;Bullion;1914;62;1976
11;Île-de-France;78;3;13;123;Carrières-sous-Poissy;16212;145;16357
11;Île-de-France;78;3;06;124;Carrières-sur-Seine;14967;193;15160
11;Île-de-France;78;2;14;125;La Celle-les-Bordes;834;30;864
11;Île-de-France;78;4;04;126;La Celle-Saint-Cloud;20966;412;21378
11;Île-de-France;78;2;14;128;Cernay-la-Ville;1577;37;1614
11;Île-de-France;78;3;16;133;Chambourcy;5634;143;5777
11;Île-de-France;78;3;05;138;Chanteloup-les-Vignes;10374;81;10455
11;Île-de-France;78;1;11;140;Chapet;1314;24;1338
11;Île-de-France;78;4;09;143;Châteaufort;1394;40;1434
11;Île-de-France;78;3;03;146;Chatou;30253;501;30754
11;Île-de-France;78;1;02;147;Chaufour-lès-Bonnières;471;7;478
11;Île-de-France;78;3;15;152;Chavenay;1815;74;1889
11;Île-de-France;78;4;04;158;Le Chesnay-Rocquencourt;31164;616;31780
11;Île-de-France;78;2;09;160;Chevreuse;5678;132;5810
11;Île-de-France;78;2;09;162;Choisel;556;15;571
11;Île-de-France;78;1;02;163;Civry-la-Forêt;335;4;339
11;Île-de-France;78;2;14;164;Clairefontaine-en-Yvelines;827;64;891
11;Île-de-France;78;4;12;165;Les Clayes-sous-Bois;17636;206;17842
11;Île-de-France;78;2;09;168;Coignières;4394;26;4420
11;Île-de-France;78;1;02;171;Condé-sur-Vesgre;1205;31;1236
11;Île-de-France;78;3;05;172;Conflans-Sainte-Honorine;35846;439;36285
11;Île-de-France;78;1;02;185;Courgent;374;11;385
11;Île-de-France;78;1;02;188;Cravent;438;6;444
11;Île-de-France;78;3;19;189;Crespières;1612;67;1679
11;Île-de-France;78;3;03;190;Croissy-sur-Seine;9701;400;10101
11;Île-de-France;78;1;02;192;Dammartin-en-Serve;1264;15;1279
11;Île-de-France;78;2;09;193;Dampierre-en-Yvelines;1037;15;1052
11;Île-de-France;78;1;02;194;Dannemarie;194;5;199
11;Île-de-France;78;3;19;196;Davron;304;15;319
11;Île-de-France;78;1;07;202;Drocourt;562;11;573
11;Île-de-France;78;1;11;206;Ecquevilly;4259;45;4304
11;Île-de-France;78;2;18;208;Élancourt;25400;260;25660
11;Île-de-France;78;2;14;209;Émancé;880;13;893
11;Île-de-France;78;1;07;217;Épône;6503;88;6591
11;Île-de-France;78;2;14;220;Les Essarts-le-Roi;6708;134;6842
11;Île-de-France;78;3;16;224;L' Étang-la-Ville;4437;183;4620
11;Île-de-France;78;1;11;227;Évecquemont;787;14;801
11;Île-de-France;78;1;07;230;La Falaise;586;8;594
11;Île-de-France;78;1;02;231;Favrieux;143;5;148
11;Île-de-France;78;3;19;233;Feucherolles;2874;136;3010
11;Île-de-France;78;1;02;234;Flacourt;166;0;166
11;Île-de-France;78;2;01;236;Flexanville;590;15;605
11;Île-de-France;78;1;02;237;Flins-Neuve-Église;156;2;158
11;Île-de-France;78;1;01;238;Flins-sur-Seine;2410;29;2439
11;Île-de-France;78;1;07;239;Follainville-Dennemont;2139;29;2168
11;Île-de-France;78;4;15;242;Fontenay-le-Fleury;13503;119;13622
11;Île-de-France;78;1;02;245;Fontenay-Mauvoisin;362;13;375
11;Île-de-France;78;1;07;246;Fontenay-Saint-Père;982;19;1001
11;Île-de-France;78;1;02;255;Freneuse;4411;57;4468
11;Île-de-France;78;1;11;261;Gaillon-sur-Montcient;677;14;691
11;Île-de-France;78;2;01;262;Galluis;1212;16;1228
11;Île-de-France;78;2;01;263;Gambais;2463;61;2524
11;Île-de-France;78;2;14;264;Gambaiseuil;62;1;63
11;Île-de-France;78;2;01;265;Garancières;2348;50;2398
11;Île-de-France;78;1;07;267;Gargenville;7467;65;7532
11;Île-de-France;78;2;14;269;Gazeran;1280;21;1301
11;Île-de-France;78;1;02;276;Gommecourt;674;6;680
11;Île-de-France;78;2;01;278;Goupillières;511;9;520
11;Île-de-France;78;1;02;281;Goussonville;622;10;632
11;Île-de-France;78;1;02;283;Grandchamp;325;7;332
11;Île-de-France;78;1;02;285;Gressey;545;14;559
11;Île-de-France;78;2;01;289;Grosrouvre;915;30;945
11;Île-de-France;78;1;07;290;Guernes;1084;15;1099
11;Île-de-France;78;1;02;291;Guerville;2144;36;2180
11;Île-de-France;78;1;07;296;Guitrancourt;615;6;621
11;Île-de-France;78;4;10;297;Guyancourt;28633;432;29065
11;Île-de-France;78;1;11;299;Hardricourt;2289;19;2308
11;Île-de-France;78;1;02;300;Hargeville;446;5;451
11;Île-de-France;78;1;02;302;La Hauteville;174;5;179
11;Île-de-France;78;3;01;305;Herbeville;247;6;253
11;Île-de-France;78;2;14;307;Hermeray;956;25;981
11;Île-de-France;78;1;02;310;Houdan;3640;42;3682
11;Île-de-France;78;3;06;311;Houilles;32151;329;32480
11;Île-de-France;78;1;07;314;Issou;4100;48;4148
11;Île-de-France;78;1;07;317;Jambville;835;14;849
11;Île-de-France;78;2;01;321;Jouars-Pontchartrain;5658;115;5773
11;Île-de-France;78;4;21;322;Jouy-en-Josas;8191;163;8354
11;Île-de-France;78;1;02;324;Jouy-Mauvoisin;555;10;565
11;Île-de-France;78;1;02;325;Jumeauville;609;7;616
11;Île-de-France;78;1;07;327;Juziers;3820;44;3864
11;Île-de-France;78;1;07;329;Lainville-en-Vexin;788;13;801
11;Île-de-France;78;2;09;334;Lévis-Saint-Nom;1604;46;1650
11;Île-de-France;78;1;07;335;Limay;16820;112;16932
11;Île-de-France;78;1;02;337;Limetz-Villez;1942;31;1973
11;Île-de-France;78;4;21;343;Les Loges-en-Josas;1564;56;1620
11;Île-de-France;78;1;02;344;Lommoye;671;8;679
11;Île-de-France;78;1;02;346;Longnes;1448;22;1470
11;Île-de-France;78;2;14;349;Longvilliers;502;12;514
11;Île-de-France;78;3;04;350;Louveciennes;7099;160;7259
11;Île-de-France;78;1;08;354;Magnanville;6030;133;6163
11;Île-de-France;78;2;09;356;Magny-les-Hameaux;9327;164;9491
11;Île-de-France;78;3;17;358;Maisons-Laffitte;23669;498;24167
11;Île-de-France;78;1;08;361;Mantes-la-Jolie;44299;229;44528
11;Île-de-France;78;1;08;362;Mantes-la-Ville;20452;140;20592
11;Île-de-France;78;2;01;364;Marcq;762;9;771
11;Île-de-France;78;2;01;366;Mareil-le-Guyon;377;12;389
11;Île-de-France;78;3;16;367;Mareil-Marly;3448;157;3605
11;Île-de-France;78;3;01;368;Mareil-sur-Mauldre;1706;37;1743
11;Île-de-France;78;3;03;372;Marly-le-Roi;16192;486;16678
11;Île-de-France;78;3;01;380;Maule;5854;221;6075
11;Île-de-France;78;1;02;381;Maulette;972;6;978
11;Île-de-France;78;3;05;382;Maurecourt;4358;53;4411
11;Île-de-France;78;2;09;383;Maurepas;18281;262;18543
11;Île-de-France;78;3;19;384;Médan;1375;44;1419
11;Île-de-France;78;1;02;385;Ménerville;210;1;211
11;Île-de-France;78;2;01;389;Méré;1677;53;1730
11;Île-de-France;78;1;02;391;Méricourt;422;5;427
11;Île-de-France;78;3;17;396;Le Mesnil-le-Roi;6292;149;6441
11;Île-de-France;78;2;09;397;Le Mesnil-Saint-Denis;6789;114;6903
11;Île-de-France;78;2;01;398;Les Mesnuls;857;22;879
11;Île-de-France;78;1;11;401;Meulan-en-Yvelines;8990;75;9065
11;Île-de-France;78;1;07;402;Mézières-sur-Seine;3676;40;3716
11;Île-de-France;78;1;11;403;Mézy-sur-Seine;2197;33;2230
11;Île-de-France;78;2;01;404;Millemont;258;4;262
11;Île-de-France;78;2;09;406;Milon-la-Chapelle;289;12;301
11;Île-de-France;78;2;14;407;Mittainville;607;15;622
11;Île-de-France;78;1;02;410;Moisson;977;7;984
11;Île-de-France;78;1;02;413;Mondreville;406;3;409
11;Île-de-France;78;3;01;415;Montainville;506;20;526
11;Île-de-France;78;1;07;416;Montalet-le-Bois;315;5;320
11;Île-de-France;78;1;02;417;Montchauvet;285;7;292
11;Île-de-France;78;3;06;418;Montesson;15019;270;15289
11;Île-de-France;78;2;01;420;Montfort-l'Amaury;2940;75;3015
11;Île-de-France;78;4;10;423;Montigny-le-Bretonneux;32929;467;33396
11;Île-de-France;78;3;19;431;Morainvilliers;2930;79;3009
11;Île-de-France;78;1;02;437;Mousseaux-sur-Seine;682;9;691
11;Île-de-France;78;1;02;439;Mulcent;110;1;111
11;Île-de-France;78;1;11;440;Les Mureaux;32792;181;32973
11;Île-de-France;78;2;01;442;Neauphle-le-Château;3373;55;3428
11;Île-de-France;78;2;01;443;Neauphle-le-Vieux;936;19;955
11;Île-de-France;78;1;02;444;Neauphlette;826;15;841
11;Île-de-France;78;1;01;451;Nézel;1042;15;1057
11;Île-de-France;78;4;19;455;Noisy-le-Roi;7550;262;7812
11;Île-de-France;78;1;02;320;Notre-Dame-de-la-Mer;652;10;662
11;Île-de-France;78;1;07;460;Oinville-sur-Montcient;1076;20;1096
11;Île-de-France;78;2;14;464;Orcemont;1004;22;1026
11;Île-de-France;78;1;02;465;Orgerus;2370;65;2435
11;Île-de-France;78;3;19;466;Orgeval;6263;138;6401
11;Île-de-France;78;2;14;470;Orphin;898;26;924
11;Île-de-France;78;2;14;472;Orsonville;334;8;342
11;Île-de-France;78;1;02;474;Orvilliers;876;9;885
11;Île-de-France;78;1;02;475;Osmoy;364;8;372
11;Île-de-France;78;2;14;478;Paray-Douaville;259;3;262
11;Île-de-France;78;3;16;481;Le Pecq;16072;363;16435
11;Île-de-France;78;1;02;484;Perdreauville;632;16;648
11;Île-de-France;78;2;14;486;Le Perray-en-Yvelines;6724;115;6839
11;Île-de-France;78;4;12;490;Plaisir;31419;389;31808
11;Île-de-France;78;2;14;497;Poigny-la-Forêt;931;40;971
11;Île-de-France;78;3;13;498;Poissy;37388;295;37683
11;Île-de-France;78;2;14;499;Ponthévrard;636;18;654
11;Île-de-France;78;1;07;501;Porcheville;3203;20;3223
11;Île-de-France;78;3;03;502;Le Port-Marly;5532;57;5589
11;Île-de-France;78;2;14;506;Prunay-en-Yvelines;870;10;880
11;Île-de-France;78;1;02;505;Prunay-le-Temple;419;17;436
11;Île-de-France;78;2;01;513;La Queue-les-Yvelines;2180;31;2211
11;Île-de-France;78;2;14;516;Raizeux;952;15;967
11;Île-de-France;78;2;14;517;Rambouillet;26736;513;27249
11;Île-de-France;78;4;15;518;Rennemoulin;107;0;107
11;Île-de-France;78;1;02;520;Richebourg;1452;25;1477
11;Île-de-France;78;2;14;522;Rochefort-en-Yvelines;906;38;944
11;Île-de-France;78;1;02;528;Rolleboise;391;3;394
11;Île-de-France;78;1;02;530;Rosay;368;2;370
11;Île-de-France;78;1;08;531;Rosny-sur-Seine;6433;42;6475
11;Île-de-France;78;1;07;536;Sailly;378;11;389
11;Île-de-France;78;2;14;537;Saint-Arnoult-en-Yvelines;6001;138;6139
11;Île-de-France;78;4;15;545;Saint-Cyr-l'École;18795;612;19407
11;Île-de-France;78;2;09;548;Saint-Forget;518;10;528
11;Île-de-France;78;2;01;550;Saint-Germain-de-la-Grange;1869;38;1907
11;Île-de-France;78;3;16;551;Saint-Germain-en-Laye;44753;1817;46570
11;Île-de-France;78;2;14;557;Saint-Hilarion;920;17;937
11;Île-de-France;78;1;02;558;Saint-Illiers-la-Ville;395;8;403
11;Île-de-France;78;1;02;559;Saint-Illiers-le-Bois;427;5;432
11;Île-de-France;78;2;09;561;Saint-Lambert;452;39;491
11;Île-de-France;78;2;14;562;Saint-Léger-en-Yvelines;1378;32;1410
11;Île-de-France;78;2;14;564;Saint-Martin-de-Bréthencourt;642;11;653
11;Île-de-France;78;1;02;565;Saint-Martin-des-Champs;306;9;315
11;Île-de-France;78;1;07;567;Saint-Martin-la-Garenne;975;12;987
11;Île-de-France;78;3;19;571;Saint-Nom-la-Bretèche;4911;209;5120
11;Île-de-France;78;2;01;576;Saint-Rémy-l'Honoré;1568;29;1597
11;Île-de-France;78;2;09;575;Saint-Rémy-lès-Chevreuse;7862;156;8018
11;Île-de-France;78;2;14;569;Sainte-Mesme;939;20;959
11;Île-de-France;78;3;17;586;Sartrouville;51967;466;52433
11;Île-de-France;78;2;01;588;Saulx-Marchais;937;26;963
11;Île-de-France;78;2;09;590;Senlisse;491;11;502
11;Île-de-France;78;1;02;591;Septeuil;2348;24;2372
11;Île-de-France;78;1;02;597;Soindres;678;8;686
11;Île-de-France;78;2;14;601;Sonchamp;1641;66;1707
11;Île-de-France;78;1;02;605;Tacoignières;1034;17;1051
11;Île-de-France;78;1;02;606;Le Tartre-Gaudran;35;1;36
11;Île-de-France;78;1;02;608;Le Tertre-Saint-Denis;124;1;125
11;Île-de-France;78;1;11;609;Tessancourt-sur-Aubette;1024;6;1030
11;Île-de-France;78;2;12;615;Thiverval-Grignon;1058;18;1076
11;Île-de-France;78;2;01;616;Thoiry;1415;23;1438
11;Île-de-France;78;1;02;618;Tilly;529;7;536
11;Île-de-France;78;4;09;620;Toussus-le-Noble;1170;32;1202
11;Île-de-France;78;4;18;621;Trappes;32584;130;32714
11;Île-de-France;78;2;01;623;Le Tremblay-sur-Mauldre;930;123;1053
11;Île-de-France;78;3;19;624;Triel-sur-Seine;11892;216;12108
11;Île-de-France;78;1;11;638;Vaux-sur-Seine;4927;66;4993
11;Île-de-France;78;4;21;640;Vélizy-Villacoublay;22036;211;22247
11;Île-de-France;78;3;19;642;Verneuil-sur-Seine;15577;405;15982
11;Île-de-France;78;3;19;643;Vernouillet;10048;185;10233
11;Île-de-France;78;2;18;644;La Verrière;6715;105;6820
11;Île-de-France;78;4;99;646;Versailles;85862;2038;87900
11;Île-de-France;78;1;02;647;Vert;831;12;843
11;Île-de-France;78;3;03;650;Le Vésinet;15889;585;16474
11;Île-de-France;78;2;01;653;Vicq;398;3;401
11;Île-de-France;78;2;14;655;Vieille-Église-en-Yvelines;682;28;710
11;Île-de-France;78;1;02;668;La Villeneuve-en-Chevrie;640;9;649
11;Île-de-France;78;3;19;672;Villennes-sur-Seine;5282;166;5448
11;Île-de-France;78;4;15;674;Villepreux;10947;204;11151
11;Île-de-France;78;1;02;677;Villette;523;17;540
11;Île-de-France;78;2;01;681;Villiers-le-Mahieu;794;17;811
11;Île-de-France;78;2;01;683;Villiers-Saint-Frédéric;2838;159;2997
11;Île-de-France;78;4;21;686;Viroflay;16129;307;16436
11;Île-de-France;78;2;09;688;Voisins-le-Bretonneux;11088;338;11426
75;Nouvelle-Aquitaine;79;1;04;001;L' Absie;979;14;993
75;Nouvelle-Aquitaine;79;3;13;002;Adilly;305;5;310
75;Nouvelle-Aquitaine;79;2;14;003;Aiffres;5506;203;5709
75;Nouvelle-Aquitaine;79;2;03;185;Aigondigné;4747;144;4891
75;Nouvelle-Aquitaine;79;3;17;005;Airvault;3281;47;3328
75;Nouvelle-Aquitaine;79;2;08;136;Alloinay;869;16;885
75;Nouvelle-Aquitaine;79;3;06;007;Allonne;665;18;683
75;Nouvelle-Aquitaine;79;3;13;008;Amailloux;827;7;834
75;Nouvelle-Aquitaine;79;2;05;009;Amuré;428;12;440
75;Nouvelle-Aquitaine;79;3;01;012;Ardin;1243;33;1276
75;Nouvelle-Aquitaine;79;1;89;013;Argentonnay;3185;86;3271
75;Nouvelle-Aquitaine;79;2;05;010;Arçais;613;6;619
75;Nouvelle-Aquitaine;79;2;09;015;Asnières-en-Poitou;204;7;211
75;Nouvelle-Aquitaine;79;3;17;016;Assais-les-Jumeaux;774;12;786
75;Nouvelle-Aquitaine;79;2;08;018;Aubigné;210;2;212
75;Nouvelle-Aquitaine;79;3;06;019;Aubigny;169;1;170
75;Nouvelle-Aquitaine;79;2;15;020;Augé;910;19;929
75;Nouvelle-Aquitaine;79;3;17;022;Availles-Thouarsais;198;2;200
75;Nouvelle-Aquitaine;79;2;03;023;Avon;67;0;67
75;Nouvelle-Aquitaine;79;2;15;024;Azay-le-Brûlé;1951;93;2044
75;Nouvelle-Aquitaine;79;3;06;025;Azay-sur-Thouet;1148;22;1170
75;Nouvelle-Aquitaine;79;3;06;029;Beaulieu-sous-Parthenay;674;15;689
75;Nouvelle-Aquitaine;79;2;03;030;Beaussais-Vitré;977;56;1033
75;Nouvelle-Aquitaine;79;2;09;031;Beauvoir-sur-Niort;1752;29;1781
75;Nouvelle-Aquitaine;79;3;01;032;Béceleuf;757;14;771
75;Nouvelle-Aquitaine;79;2;05;034;Bessines;1675;63;1738
75;Nouvelle-Aquitaine;79;3;01;077;Beugnon-Thireuil;726;10;736
75;Nouvelle-Aquitaine;79;1;02;038;Boismé;1200;28;1228
75;Nouvelle-Aquitaine;79;3;06;040;La Boissière-en-Gâtine;246;2;248
75;Nouvelle-Aquitaine;79;2;03;042;Bougon;177;6;183
75;Nouvelle-Aquitaine;79;2;09;046;Le Bourdet;584;6;590
75;Nouvelle-Aquitaine;79;3;17;047;Boussais;457;10;467
75;Nouvelle-Aquitaine;79;1;02;049;Bressuire;19519;1014;20533
75;Nouvelle-Aquitaine;79;1;04;050;Bretignolles;600;16;616
75;Nouvelle-Aquitaine;79;2;09;055;Brieuil-sur-Chizé;123;3;126
75;Nouvelle-Aquitaine;79;1;17;056;Brion-près-Thouet;740;11;751
75;Nouvelle-Aquitaine;79;2;09;057;Brioux-sur-Boutonne;1474;50;1524
75;Nouvelle-Aquitaine;79;2;14;058;Brûlain;757;17;774
75;Nouvelle-Aquitaine;79;3;01;059;Le Busseau;732;4;736
75;Nouvelle-Aquitaine;79;2;08;060;Caunay;181;1;182
75;Nouvelle-Aquitaine;79;2;03;061;Celles-sur-Belle;3907;57;3964
75;Nouvelle-Aquitaine;79;1;04;062;Cerizay;4768;72;4840
75;Nouvelle-Aquitaine;79;3;01;066;Champdeniers;1666;37;1703
75;Nouvelle-Aquitaine;79;1;04;069;Chanteloup;1009;23;1032
75;Nouvelle-Aquitaine;79;3;01;070;La Chapelle-Bâton;398;10;408
75;Nouvelle-Aquitaine;79;3;13;071;La Chapelle-Bertrand;478;14;492
75;Nouvelle-Aquitaine;79;2;08;074;La Chapelle-Pouilloux;183;5;188
75;Nouvelle-Aquitaine;79;1;04;076;La Chapelle-Saint-Laurent;2002;24;2026
75;Nouvelle-Aquitaine;79;3;06;105;Les Châteliers;484;9;493
75;Nouvelle-Aquitaine;79;3;13;080;Châtillon-sur-Thouet;2685;53;2738
75;Nouvelle-Aquitaine;79;2;14;081;Chauray;7006;201;7207
75;Nouvelle-Aquitaine;79;2;08;083;Chef-Boutonne;2563;132;2695
75;Nouvelle-Aquitaine;79;2;03;084;Chenay;454;3;457
75;Nouvelle-Aquitaine;79;2;09;085;Chérigné;147;5;152
75;Nouvelle-Aquitaine;79;2;01;086;Cherveux;1905;42;1947
75;Nouvelle-Aquitaine;79;2;03;087;Chey;567;10;577
75;Nouvelle-Aquitaine;79;1;02;088;Chiché;1690;45;1735
75;Nouvelle-Aquitaine;79;3;17;089;Le Chillou;167;1;168
75;Nouvelle-Aquitaine;79;2;09;090;Chizé;863;23;886
75;Nouvelle-Aquitaine;79;1;04;091;Cirières;945;24;969
75;Nouvelle-Aquitaine;79;3;06;092;Clavé;363;5;368
75;Nouvelle-Aquitaine;79;1;04;094;Clessé;954;10;964
75;Nouvelle-Aquitaine;79;2;08;095;Clussais-la-Pommeraie;590;12;602
75;Nouvelle-Aquitaine;79;1;04;096;Combrand;1161;34;1195
75;Nouvelle-Aquitaine;79;2;05;100;Coulon;2263;55;2318
75;Nouvelle-Aquitaine;79;3;01;101;Coulonges-sur-l'Autize;2350;48;2398
75;Nouvelle-Aquitaine;79;1;17;102;Coulonges-Thouarsais;432;5;437
75;Nouvelle-Aquitaine;79;1;04;103;Courlay;2436;49;2485
75;Nouvelle-Aquitaine;79;3;01;104;Cours;554;13;567
75;Nouvelle-Aquitaine;79;2;08;106;Couture-d'Argenson;379;2;381
75;Nouvelle-Aquitaine;79;2;15;048;La Crèche;5635;129;5764
75;Nouvelle-Aquitaine;79;3;06;108;Doux;229;1;230
75;Nouvelle-Aquitaine;79;2;14;109;Échiré;3371;97;3468
75;Nouvelle-Aquitaine;79;2;09;111;Ensigné;286;4;290
75;Nouvelle-Aquitaine;79;2;05;112;Épannes;867;20;887
75;Nouvelle-Aquitaine;79;2;15;114;Exireuil;1583;32;1615
75;Nouvelle-Aquitaine;79;2;03;115;Exoudun;576;10;586
75;Nouvelle-Aquitaine;79;1;02;116;Faye-l'Abbesse;1066;16;1082
75;Nouvelle-Aquitaine;79;3;01;117;Faye-sur-Ardin;631;8;639
75;Nouvelle-Aquitaine;79;3;13;118;Fénery;292;5;297
75;Nouvelle-Aquitaine;79;3;01;119;Fenioux;644;11;655
75;Nouvelle-Aquitaine;79;3;06;120;La Ferrière-en-Parthenay;786;11;797
75;Nouvelle-Aquitaine;79;3;06;121;Fomperron;420;8;428
75;Nouvelle-Aquitaine;79;2;08;122;Fontenille-Saint-Martin-d'Entraigues;547;5;552
75;Nouvelle-Aquitaine;79;2;08;064;Fontivillié;861;25;886
75;Nouvelle-Aquitaine;79;1;04;123;La Forêt-sur-Sèvre;2365;33;2398
75;Nouvelle-Aquitaine;79;3;06;124;Les Forges;129;6;135
75;Nouvelle-Aquitaine;79;2;05;125;Fors;1795;56;1851
75;Nouvelle-Aquitaine;79;2;09;126;Les Fosses;448;10;458
75;Nouvelle-Aquitaine;79;2;09;127;La Foye-Monjault;846;7;853
75;Nouvelle-Aquitaine;79;2;15;128;François;954;26;980
75;Nouvelle-Aquitaine;79;2;03;129;Fressines;1673;30;1703
75;Nouvelle-Aquitaine;79;2;05;130;Frontenay-Rohan-Rohan;2862;97;2959
75;Nouvelle-Aquitaine;79;1;02;131;Geay;314;5;319
75;Nouvelle-Aquitaine;79;1;07;132;Genneton;325;6;331
75;Nouvelle-Aquitaine;79;2;01;133;Germond-Rouvre;1174;22;1196
75;Nouvelle-Aquitaine;79;1;17;134;Glénay;569;13;582
75;Nouvelle-Aquitaine;79;3;06;135;Gourgé;967;23;990
75;Nouvelle-Aquitaine;79;2;05;137;Granzay-Gript;904;22;926
75;Nouvelle-Aquitaine;79;3;06;139;Les Groseillers;58;2;60
75;Nouvelle-Aquitaine;79;3;17;141;Irais;207;4;211
75;Nouvelle-Aquitaine;79;2;09;142;Juillé;99;2;101
75;Nouvelle-Aquitaine;79;2;14;144;Juscorps;361;6;367
75;Nouvelle-Aquitaine;79;3;13;145;Lageon;359;5;364
75;Nouvelle-Aquitaine;79;1;04;147;Largeasse;747;9;756
75;Nouvelle-Aquitaine;79;2;03;148;Lezay;1999;27;2026
75;Nouvelle-Aquitaine;79;3;06;149;Lhoumois;147;2;149
75;Nouvelle-Aquitaine;79;2;08;150;Limalonges;834;17;851
75;Nouvelle-Aquitaine;79;1;17;014;Loretz-d'Argenton;2655;37;2692
75;Nouvelle-Aquitaine;79;2;08;152;Lorigné;300;6;306
75;Nouvelle-Aquitaine;79;2;08;153;Loubigné;161;4;165
75;Nouvelle-Aquitaine;79;2;08;154;Loubillé;392;6;398
75;Nouvelle-Aquitaine;79;3;17;156;Louin;684;25;709
75;Nouvelle-Aquitaine;79;1;16;157;Louzy;1358;23;1381
75;Nouvelle-Aquitaine;79;2;09;158;Luché-sur-Brioux;142;5;147
75;Nouvelle-Aquitaine;79;1;17;159;Luché-Thouarsais;509;4;513
75;Nouvelle-Aquitaine;79;2;09;160;Lusseray;157;3;160
75;Nouvelle-Aquitaine;79;1;17;161;Luzay;635;12;647
75;Nouvelle-Aquitaine;79;2;05;162;Magné;2671;66;2737
75;Nouvelle-Aquitaine;79;2;08;163;Mairé-Levescault;532;10;542
75;Nouvelle-Aquitaine;79;2;08;164;Maisonnay;256;4;260
75;Nouvelle-Aquitaine;79;3;17;165;Maisontiers;154;5;159
75;Nouvelle-Aquitaine;79;2;08;251;Marcillé;760;30;790
75;Nouvelle-Aquitaine;79;2;09;166;Marigny;877;13;890
75;Nouvelle-Aquitaine;79;1;17;167;Marnes;258;11;269
75;Nouvelle-Aquitaine;79;1;07;079;Mauléon;8519;224;8743
75;Nouvelle-Aquitaine;79;2;09;170;Mauzé-sur-le-Mignon;2818;55;2873
75;Nouvelle-Aquitaine;79;3;06;172;Mazières-en-Gâtine;1011;24;1035
75;Nouvelle-Aquitaine;79;2;08;174;Melle;6213;327;6540
75;Nouvelle-Aquitaine;79;2;08;175;Melleran;507;10;517
75;Nouvelle-Aquitaine;79;3;06;176;Ménigoute;859;23;882
75;Nouvelle-Aquitaine;79;2;03;177;Messé;188;4;192
75;Nouvelle-Aquitaine;79;1;04;179;Moncoutant-sur-Sèvre;5046;168;5214
75;Nouvelle-Aquitaine;79;2;08;180;Montalembert;302;3;305
75;Nouvelle-Aquitaine;79;1;04;183;Montravers;382;6;388
75;Nouvelle-Aquitaine;79;2;03;184;La Mothe-Saint-Héray;1692;39;1731
75;Nouvelle-Aquitaine;79;2;15;189;Nanteuil;1713;31;1744
75;Nouvelle-Aquitaine;79;1;04;190;Neuvy-Bouin;513;7;520
75;Nouvelle-Aquitaine;79;2;99;191;Niort;58707;1799;60506
75;Nouvelle-Aquitaine;79;1;07;195;Nueil-les-Aubiers;5541;120;5661
75;Nouvelle-Aquitaine;79;3;06;197;Oroux;95;1;96
75;Nouvelle-Aquitaine;79;2;09;198;Paizay-le-Chapt;261;3;264
75;Nouvelle-Aquitaine;79;3;01;200;Pamplie;273;3;276
75;Nouvelle-Aquitaine;79;2;03;201;Pamproux;1747;15;1762
75;Nouvelle-Aquitaine;79;3;13;202;Parthenay;10267;385;10652
75;Nouvelle-Aquitaine;79;1;17;203;Pas-de-Jeu;369;8;377
75;Nouvelle-Aquitaine;79;2;09;204;Périgné;1006;38;1044
75;Nouvelle-Aquitaine;79;2;08;205;Pers;74;3;77
75;Nouvelle-Aquitaine;79;1;07;207;La Petite-Boissière;634;17;651
75;Nouvelle-Aquitaine;79;3;06;208;La Peyratte;1171;49;1220
75;Nouvelle-Aquitaine;79;1;17;209;Pierrefitte;327;7;334
75;Nouvelle-Aquitaine;79;1;04;210;Le Pin;1052;23;1075
75;Nouvelle-Aquitaine;79;2;09;078;Plaine-d'Argenson;966;15;981
75;Nouvelle-Aquitaine;79;1;17;196;Plaine-et-Vallées;2405;55;2460
75;Nouvelle-Aquitaine;79;2;08;212;Pliboux;206;3;209
75;Nouvelle-Aquitaine;79;3;13;213;Pompaire;2001;56;2057
75;Nouvelle-Aquitaine;79;3;06;215;Pougne-Hérisson;370;7;377
75;Nouvelle-Aquitaine;79;2;14;216;Prahecq;2179;38;2217
75;Nouvelle-Aquitaine;79;2;03;217;Prailles-La Couarde;949;18;967
75;Nouvelle-Aquitaine;79;3;06;218;Pressigny;185;6;191
75;Nouvelle-Aquitaine;79;2;09;220;Prin-Deyrançon;606;18;624
75;Nouvelle-Aquitaine;79;3;01;223;Puihardy;61;0;61
75;Nouvelle-Aquitaine;79;3;06;225;Reffannes;368;6;374
75;Nouvelle-Aquitaine;79;3;06;226;Le Retail;278;4;282
75;Nouvelle-Aquitaine;79;2;09;229;La Rochénard;583;6;589
75;Nouvelle-Aquitaine;79;2;03;230;Rom;860;13;873
75;Nouvelle-Aquitaine;79;2;15;231;Romans;708;14;722
75;Nouvelle-Aquitaine;79;1;07;235;Saint-Amand-sur-Sèvre;1409;35;1444
75;Nouvelle-Aquitaine;79;1;04;236;Saint-André-sur-Sèvre;649;13;662
75;Nouvelle-Aquitaine;79;1;07;238;Saint-Aubin-du-Plain;550;21;571
75;Nouvelle-Aquitaine;79;3;06;239;Saint-Aubin-le-Cloud;1771;105;1876
75;Nouvelle-Aquitaine;79;3;01;241;Saint-Christophe-sur-Roc;558;11;569
75;Nouvelle-Aquitaine;79;2;03;243;Saint-Coutant;283;0;283
75;Nouvelle-Aquitaine;79;1;17;244;Saint-Cyr-la-Lande;358;4;362
75;Nouvelle-Aquitaine;79;2;14;249;Saint-Gelais;2091;63;2154
75;Nouvelle-Aquitaine;79;1;17;252;Saint-Généroux;362;13;375
75;Nouvelle-Aquitaine;79;3;06;253;Saint-Georges-de-Noisné;700;14;714
75;Nouvelle-Aquitaine;79;2;09;254;Saint-Georges-de-Rex;441;14;455
75;Nouvelle-Aquitaine;79;3;13;255;Saint-Germain-de-Longue-Chaume;403;3;406
75;Nouvelle-Aquitaine;79;3;06;256;Saint-Germier;226;6;232
75;Nouvelle-Aquitaine;79;2;09;257;Saint-Hilaire-la-Palud;1540;22;1562
75;Nouvelle-Aquitaine;79;1;16;258;Saint-Jacques-de-Thouars;438;13;451
75;Nouvelle-Aquitaine;79;1;16;259;Saint-Jean-de-Thouars;1358;35;1393
75;Nouvelle-Aquitaine;79;3;01;263;Saint-Laurs;568;8;576
75;Nouvelle-Aquitaine;79;1;17;265;Saint-Léger-de-Montbrun;1264;24;1288
75;Nouvelle-Aquitaine;79;3;06;267;Saint-Lin;331;6;337
75;Nouvelle-Aquitaine;79;3;17;268;Saint-Loup-Lamairé;986;41;1027
75;Nouvelle-Aquitaine;79;3;01;269;Saint-Maixent-de-Beugné;404;8;412
75;Nouvelle-Aquitaine;79;2;15;270;Saint-Maixent-l'École;6982;147;7129
75;Nouvelle-Aquitaine;79;3;06;271;Saint-Marc-la-Lande;363;3;366
75;Nouvelle-Aquitaine;79;2;14;273;Saint-Martin-de-Bernegoue;782;17;799
75;Nouvelle-Aquitaine;79;1;17;274;Saint-Martin-de-Mâcon;306;6;312
75;Nouvelle-Aquitaine;79;2;15;276;Saint-Martin-de-Saint-Maixent;1105;31;1136
75;Nouvelle-Aquitaine;79;1;17;277;Saint-Martin-de-Sanzay;1085;17;1102
75;Nouvelle-Aquitaine;79;3;06;278;Saint-Martin-du-Fouilloux;236;4;240
75;Nouvelle-Aquitaine;79;1;07;280;Saint Maurice Étusson;876;11;887
75;Nouvelle-Aquitaine;79;2;01;281;Saint-Maxire;1302;43;1345
75;Nouvelle-Aquitaine;79;3;06;285;Saint-Pardoux-Soutiers;1876;36;1912
75;Nouvelle-Aquitaine;79;1;04;286;Saint-Paul-en-Gâtine;448;7;455
75;Nouvelle-Aquitaine;79;1;07;289;Saint-Pierre-des-Échaubrognes;1411;25;1436
75;Nouvelle-Aquitaine;79;3;01;290;Saint-Pompain;943;12;955
75;Nouvelle-Aquitaine;79;2;01;293;Saint-Rémy;1100;23;1123
75;Nouvelle-Aquitaine;79;2;14;294;Saint-Romans-des-Champs;173;4;177
75;Nouvelle-Aquitaine;79;2;08;295;Saint-Romans-lès-Melle;718;18;736
75;Nouvelle-Aquitaine;79;2;05;298;Saint-Symphorien;1922;53;1975
75;Nouvelle-Aquitaine;79;1;17;299;Saint-Varent;2445;40;2485
75;Nouvelle-Aquitaine;79;2;08;301;Saint-Vincent-la-Châtre;641;21;662
75;Nouvelle-Aquitaine;79;2;15;246;Sainte-Eanne;613;13;626
75;Nouvelle-Aquitaine;79;1;17;250;Sainte-Gemme;400;3;403
75;Nouvelle-Aquitaine;79;2;15;283;Sainte-Néomaye;1320;38;1358
75;Nouvelle-Aquitaine;79;3;01;284;Sainte-Ouenne;805;12;817
75;Nouvelle-Aquitaine;79;2;03;297;Sainte-Soline;358;14;372
75;Nouvelle-Aquitaine;79;1;16;300;Sainte-Verge;1395;30;1425
75;Nouvelle-Aquitaine;79;2;15;302;Saivres;1461;21;1482
75;Nouvelle-Aquitaine;79;2;03;303;Salles;329;12;341
75;Nouvelle-Aquitaine;79;2;05;304;Sansais;753;51;804
75;Nouvelle-Aquitaine;79;3;06;306;Saurais;189;2;191
75;Nouvelle-Aquitaine;79;2;08;307;Sauzé-Vaussais;1596;26;1622
75;Nouvelle-Aquitaine;79;2;01;308;Sciecq;638;10;648
75;Nouvelle-Aquitaine;79;3;01;309;Scillé;355;7;362
75;Nouvelle-Aquitaine;79;2;09;310;Secondigné-sur-Belle;510;16;526
75;Nouvelle-Aquitaine;79;3;06;311;Secondigny;1843;81;1924
75;Nouvelle-Aquitaine;79;2;09;312;Séligné;115;3;118
75;Nouvelle-Aquitaine;79;2;03;313;Sepvret;616;16;632
75;Nouvelle-Aquitaine;79;2;03;316;Soudan;430;4;434
75;Nouvelle-Aquitaine;79;2;15;319;Souvigné;902;28;930
75;Nouvelle-Aquitaine;79;3;01;320;Surin;657;12;669
75;Nouvelle-Aquitaine;79;3;13;322;Le Tallud;2021;48;2069
75;Nouvelle-Aquitaine;79;3;06;326;Thénezay;1403;29;1432
75;Nouvelle-Aquitaine;79;1;16;329;Thouars;13990;351;14341
75;Nouvelle-Aquitaine;79;1;17;331;Tourtenay;117;4;121
75;Nouvelle-Aquitaine;79;1;04;332;Trayes;122;4;126
75;Nouvelle-Aquitaine;79;2;09;334;Val-du-Mignon;1095;20;1115
75;Nouvelle-Aquitaine;79;1;17;063;Val en Vignes;2047;86;2133
75;Nouvelle-Aquitaine;79;2;08;140;Valdelaume;852;9;861
75;Nouvelle-Aquitaine;79;2;05;335;Vallans;787;21;808
75;Nouvelle-Aquitaine;79;2;05;337;Le Vanneau-Irleau;872;26;898
75;Nouvelle-Aquitaine;79;2;03;338;Vanzay;237;0;237
75;Nouvelle-Aquitaine;79;2;03;336;Vançais;220;6;226
75;Nouvelle-Aquitaine;79;3;06;339;Vasles;1662;24;1686
75;Nouvelle-Aquitaine;79;3;06;340;Vausseroux;326;6;332
75;Nouvelle-Aquitaine;79;3;06;341;Vautebis;114;1;115
75;Nouvelle-Aquitaine;79;3;06;342;Vernoux-en-Gâtine;571;13;584
75;Nouvelle-Aquitaine;79;2;09;343;Vernoux-sur-Boutonne;215;2;217
75;Nouvelle-Aquitaine;79;3;06;345;Verruyes;904;34;938
75;Nouvelle-Aquitaine;79;2;09;346;Le Vert;128;3;131
75;Nouvelle-Aquitaine;79;3;13;347;Viennay;1104;21;1125
75;Nouvelle-Aquitaine;79;2;09;348;Villefollet;216;5;221
75;Nouvelle-Aquitaine;79;2;08;349;Villemain;150;2;152
75;Nouvelle-Aquitaine;79;2;09;350;Villiers-en-Bois;123;3;126
75;Nouvelle-Aquitaine;79;2;01;351;Villiers-en-Plaine;1774;31;1805
75;Nouvelle-Aquitaine;79;2;09;352;Villiers-sur-Chizé;160;6;166
75;Nouvelle-Aquitaine;79;3;06;354;Vouhé;385;11;396
75;Nouvelle-Aquitaine;79;2;14;355;Vouillé;3292;99;3391
75;Nouvelle-Aquitaine;79;1;07;242;Voulmentin;1110;29;1139
75;Nouvelle-Aquitaine;79;3;01;357;Xaintray;223;4;227
32;Hauts-de-France;80;1;98;001;Abbeville;22946;412;23358
32;Hauts-de-France;80;4;18;002;Ablaincourt-Pressoir;266;5;271
32;Hauts-de-France;80;4;05;003;Acheux-en-Amiénois;593;11;604
32;Hauts-de-France;80;1;02;004;Acheux-en-Vimeu;528;5;533
32;Hauts-de-France;80;2;14;005;Agenville;91;2;93
32;Hauts-de-France;80;1;01;006;Agenvillers;228;4;232
32;Hauts-de-France;80;1;17;008;Aigneville;890;19;909
32;Hauts-de-France;80;1;23;009;Ailly-le-Haut-Clocher;966;23;989
32;Hauts-de-France;80;3;03;010;Ailly-sur-Noye;2838;32;2870
32;Hauts-de-France;80;2;04;011;Ailly-sur-Somme;2967;26;2993
32;Hauts-de-France;80;2;04;013;Airaines;2378;32;2410
32;Hauts-de-France;80;4;20;014;Aizecourt-le-Bas;54;0;54
32;Hauts-de-France;80;4;20;015;Aizecourt-le-Haut;67;3;70
32;Hauts-de-France;80;4;05;016;Albert;9928;174;10102
32;Hauts-de-France;80;4;20;017;Allaines;466;10;476
32;Hauts-de-France;80;1;16;018;Allenay;250;5;255
32;Hauts-de-France;80;1;17;019;Allery;793;14;807
32;Hauts-de-France;80;2;07;020;Allonville;738;17;755
32;Hauts-de-France;80;2;99;021;Amiens;134057;2697;136754
32;Hauts-de-France;80;2;21;022;Andainville;254;3;257
32;Hauts-de-France;80;3;22;023;Andechy;269;4;273
32;Hauts-de-France;80;1;23;025;Argoules;326;3;329
32;Hauts-de-France;80;2;21;026;Arguel;29;0;29
32;Hauts-de-France;80;2;04;024;Argœuves;542;6;548
32;Hauts-de-France;80;3;22;027;Armancourt;33;0;33
32;Hauts-de-France;80;4;05;028;Arquèves;165;3;168
32;Hauts-de-France;80;1;02;029;Arrest;869;26;895
32;Hauts-de-France;80;1;23;030;Arry;212;8;220
32;Hauts-de-France;80;3;19;031;Arvillers;778;8;786
32;Hauts-de-France;80;3;22;032;Assainvillers;108;0;108
32;Hauts-de-France;80;4;18;033;Assevillers;296;4;300
32;Hauts-de-France;80;4;18;034;Athies;594;6;600
32;Hauts-de-France;80;3;19;035;Aubercourt;81;1;82
32;Hauts-de-France;80;2;08;036;Aubigny;505;4;509
32;Hauts-de-France;80;3;03;037;Aubvillers;142;2;144
32;Hauts-de-France;80;4;05;038;Auchonvillers;143;3;146
32;Hauts-de-France;80;1;16;039;Ault;1464;18;1482
32;Hauts-de-France;80;2;21;040;Aumâtre;180;5;185
32;Hauts-de-France;80;2;21;041;Aumont;145;4;149
32;Hauts-de-France;80;2;14;042;Autheux;120;2;122
32;Hauts-de-France;80;4;05;043;Authie;286;10;296
32;Hauts-de-France;80;2;14;044;Authieule;409;6;415
32;Hauts-de-France;80;4;05;045;Authuille;165;2;167
32;Hauts-de-France;80;2;04;046;Avelesges;57;0;57
32;Hauts-de-France;80;4;05;047;Aveluy;522;4;526
32;Hauts-de-France;80;2;21;048;Avesnes-Chaussoy;64;3;67
32;Hauts-de-France;80;3;22;049;Ayencourt;192;13;205
32;Hauts-de-France;80;2;03;050;Bacouel-sur-Selle;501;10;511
32;Hauts-de-France;80;1;17;051;Bailleul;266;3;269
32;Hauts-de-France;80;2;13;052;Baizieux;207;5;212
32;Hauts-de-France;80;3;22;053;Balâtre;72;1;73
32;Hauts-de-France;80;4;20;054;Barleux;230;5;235
32;Hauts-de-France;80;2;14;055;Barly;177;3;180
32;Hauts-de-France;80;2;13;056;Bavelincourt;106;1;107
32;Hauts-de-France;80;4;05;057;Bayencourt;79;3;82
32;Hauts-de-France;80;4;19;058;Bayonvillers;340;4;344
32;Hauts-de-France;80;4;05;059;Bazentin;79;1;80
32;Hauts-de-France;80;2;14;060;Béalcourt;104;0;104
32;Hauts-de-France;80;2;21;061;Beaucamps-le-Jeune;202;3;205
32;Hauts-de-France;80;2;21;062;Beaucamps-le-Vieux;1421;19;1440
32;Hauts-de-France;80;1;17;063;Beauchamps;996;21;1017
32;Hauts-de-France;80;3;19;064;Beaucourt-en-Santerre;176;3;179
32;Hauts-de-France;80;4;05;065;Beaucourt-sur-l'Ancre;95;2;97
32;Hauts-de-France;80;2;13;066;Beaucourt-sur-l'Hallue;298;7;305
32;Hauts-de-France;80;4;19;067;Beaufort-en-Santerre;204;4;208
32;Hauts-de-France;80;2;14;068;Beaumetz;226;1;227
32;Hauts-de-France;80;4;05;069;Beaumont-Hamel;215;0;215
32;Hauts-de-France;80;2;14;070;Beauquesne;1339;54;1393
32;Hauts-de-France;80;2;14;071;Beauval;2095;28;2123
32;Hauts-de-France;80;4;05;073;Bécordel-Bécourt;160;2;162
32;Hauts-de-France;80;3;22;074;Becquigny;131;1;132
32;Hauts-de-France;80;1;02;076;Béhen;509;4;513
32;Hauts-de-France;80;2;13;077;Béhencourt;333;3;336
32;Hauts-de-France;80;1;01;078;Bellancourt;513;9;522
32;Hauts-de-France;80;2;03;079;Belleuse;357;0;357
32;Hauts-de-France;80;4;18;080;Belloy-en-Santerre;149;2;151
32;Hauts-de-France;80;2;21;081;Belloy-Saint-Léonard;92;2;94
32;Hauts-de-France;80;2;04;082;Belloy-sur-Somme;752;8;760
32;Hauts-de-France;80;2;21;083;Bergicourt;145;4;149
32;Hauts-de-France;80;2;21;084;Bermesnil;222;2;224
32;Hauts-de-France;80;2;14;085;Bernâtre;32;2;34
32;Hauts-de-France;80;2;14;086;Bernaville;1070;17;1087
32;Hauts-de-France;80;1;23;087;Bernay-en-Ponthieu;231;6;237
32;Hauts-de-France;80;4;20;088;Bernes;352;2;354
32;Hauts-de-France;80;2;14;089;Berneuil;257;1;258
32;Hauts-de-France;80;4;18;090;Berny-en-Santerre;154;3;157
32;Hauts-de-France;80;2;07;092;Bertangles;627;6;633
32;Hauts-de-France;80;2;15;093;Berteaucourt-les-Dames;1162;8;1170
32;Hauts-de-France;80;3;19;094;Berteaucourt-lès-Thennes;437;10;447
32;Hauts-de-France;80;4;05;095;Bertrancourt;223;3;226
32;Hauts-de-France;80;1;16;096;Béthencourt-sur-Mer;968;9;977
32;Hauts-de-France;80;4;18;097;Béthencourt-sur-Somme;129;3;132
32;Hauts-de-France;80;2;21;098;Bettembos;102;3;105
32;Hauts-de-France;80;1;17;099;Bettencourt-Rivière;230;5;235
32;Hauts-de-France;80;2;15;100;Bettencourt-Saint-Ouen;619;5;624
32;Hauts-de-France;80;3;22;101;Beuvraignes;860;5;865
32;Hauts-de-France;80;4;20;102;Biaches;384;7;391
32;Hauts-de-France;80;3;22;103;Biarre;67;0;67
32;Hauts-de-France;80;1;17;104;Biencourt;133;4;137
32;Hauts-de-France;80;4;18;105;Billancourt;173;2;175
32;Hauts-de-France;80;2;21;106;Blangy-sous-Poix;181;3;184
32;Hauts-de-France;80;2;09;107;Blangy-Tronville;563;10;573
32;Hauts-de-France;80;2;14;108;Boisbergues;78;1;79
32;Hauts-de-France;80;1;23;109;Le Boisle;363;2;365
32;Hauts-de-France;80;1;02;110;Boismont;475;17;492
32;Hauts-de-France;80;2;13;112;Bonnay;237;1;238
32;Hauts-de-France;80;2;14;113;Bonneville;331;7;338
32;Hauts-de-France;80;2;03;114;Bosquel;334;6;340
32;Hauts-de-France;80;4;20;115;Bouchavesnes-Bergen;291;4;295
32;Hauts-de-France;80;4;19;116;Bouchoir;293;3;296
32;Hauts-de-France;80;2;15;117;Bouchon;155;1;156
32;Hauts-de-France;80;1;23;118;Boufflers;122;1;123
32;Hauts-de-France;80;2;04;119;Bougainville;448;7;455
32;Hauts-de-France;80;1;17;120;Bouillancourt-en-Séry;550;10;560
32;Hauts-de-France;80;3;22;121;Bouillancourt-la-Bataille;155;0;155
32;Hauts-de-France;80;2;14;122;Bouquemaison;503;15;518
32;Hauts-de-France;80;2;04;123;Bourdon;385;8;393
32;Hauts-de-France;80;1;16;124;Bourseville;699;14;713
32;Hauts-de-France;80;3;22;125;Boussicourt;87;0;87
32;Hauts-de-France;80;1;17;126;Bouttencourt;931;21;952
32;Hauts-de-France;80;1;17;127;Bouvaincourt-sur-Bresle;868;11;879
32;Hauts-de-France;80;4;20;128;Bouvincourt-en-Vermandois;151;4;155
32;Hauts-de-France;80;4;05;129;Bouzincourt;550;13;563
32;Hauts-de-France;80;2;04;130;Bovelles;434;6;440
32;Hauts-de-France;80;2;10;131;Boves;3192;34;3226
32;Hauts-de-France;80;3;19;132;Braches;263;3;266
32;Hauts-de-France;80;1;23;133;Brailly-Cornehotte;241;1;242
32;Hauts-de-France;80;2;03;134;Brassy;74;0;74
32;Hauts-de-France;80;1;02;135;Bray-lès-Mareuil;240;4;244
32;Hauts-de-France;80;4;05;136;Bray-sur-Somme;1276;7;1283
32;Hauts-de-France;80;2;04;137;Breilly;685;4;689
32;Hauts-de-France;80;2;13;138;Bresle;128;1;129
32;Hauts-de-France;80;4;18;139;Breuil;46;0;46
32;Hauts-de-France;80;2;14;140;Brévillers;108;3;111
32;Hauts-de-France;80;4;20;141;Brie;331;1;332
32;Hauts-de-France;80;2;04;142;Briquemesnil-Floxicourt;269;5;274
32;Hauts-de-France;80;2;21;143;Brocourt;98;1;99
32;Hauts-de-France;80;4;18;144;Brouchy;512;9;521
32;Hauts-de-France;80;1;23;145;Brucamps;139;0;139
32;Hauts-de-France;80;1;16;146;Brutelles;207;5;212
32;Hauts-de-France;80;1;23;147;Buigny-l'Abbé;311;9;320
32;Hauts-de-France;80;1;17;148;Buigny-lès-Gamaches;414;5;419
32;Hauts-de-France;80;1;01;149;Buigny-Saint-Maclou;517;12;529
32;Hauts-de-France;80;4;20;150;Buire-Courcelles;234;7;241
32;Hauts-de-France;80;4;05;151;Buire-sur-l'Ancre;310;4;314
32;Hauts-de-France;80;3;22;152;Bus-la-Mésière;167;1;168
32;Hauts-de-France;80;4;05;153;Bus-lès-Artois;134;0;134
32;Hauts-de-France;80;4;20;154;Bussu;213;7;220
32;Hauts-de-France;80;1;23;155;Bussus-Bussuel;297;8;305
32;Hauts-de-France;80;2;08;156;Bussy-lès-Daours;381;3;384
32;Hauts-de-France;80;2;21;157;Bussy-lès-Poix;101;2;103
32;Hauts-de-France;80;4;18;158;Buverchy;49;0;49
32;Hauts-de-France;80;2;09;159;Cachy;282;4;286
32;Hauts-de-France;80;2;10;160;Cagny;1204;21;1225
32;Hauts-de-France;80;1;02;161;Cahon;199;4;203
32;Hauts-de-France;80;4;19;162;Caix;740;12;752
32;Hauts-de-France;80;1;02;163;Cambron;724;11;735
32;Hauts-de-France;80;2;08;164;Camon;4432;54;4486
32;Hauts-de-France;80;2;04;165;Camps-en-Amiénois;188;1;189
32;Hauts-de-France;80;2;15;166;Canaples;706;7;713
32;Hauts-de-France;80;1;01;167;Canchy;322;4;326
32;Hauts-de-France;80;2;14;168;Candas;1100;9;1109
32;Hauts-de-France;80;2;21;169;Cannessières;70;0;70
32;Hauts-de-France;80;3;22;170;Cantigny;114;1;115
32;Hauts-de-France;80;1;01;171;Caours;603;19;622
32;Hauts-de-France;80;4;05;172;Cappy;535;7;542
32;Hauts-de-France;80;2;07;173;Cardonnette;518;7;525
32;Hauts-de-France;80;3;22;174;Le Cardonnois;83;3;86
32;Hauts-de-France;80;4;05;505;Carnoy-Mametz;285;4;289
32;Hauts-de-France;80;3;22;176;Carrépuis;272;4;276
32;Hauts-de-France;80;4;20;177;Cartigny;745;24;769
32;Hauts-de-France;80;2;21;179;Caulières;206;4;210
32;Hauts-de-France;80;2;04;180;Cavillon;103;1;104
32;Hauts-de-France;80;3;19;181;Cayeux-en-Santerre;121;0;121
32;Hauts-de-France;80;1;16;182;Cayeux-sur-Mer;2477;32;2509
32;Hauts-de-France;80;2;13;184;Cerisy;531;5;536
32;Hauts-de-France;80;2;21;183;Cerisy-Buleux;266;6;272
32;Hauts-de-France;80;3;22;185;Champien;276;10;286
32;Hauts-de-France;80;4;18;186;Chaulnes;2083;30;2113
32;Hauts-de-France;80;2;04;187;La Chaussée-Tirancourt;659;11;670
32;Hauts-de-France;80;3;03;188;Chaussoy-Epagny;581;6;587
32;Hauts-de-France;80;4;19;189;La Chavatte;73;1;74
32;Hauts-de-France;80;1;17;190;Chépy;1252;17;1269
32;Hauts-de-France;80;4;19;191;Chilly;183;5;188
32;Hauts-de-France;80;2;13;192;Chipilly;171;2;173
32;Hauts-de-France;80;3;03;193;Chirmont;119;1;120
32;Hauts-de-France;80;4;18;194;Chuignes;134;1;135
32;Hauts-de-France;80;4;05;195;Chuignolles;152;3;155
32;Hauts-de-France;80;1;17;196;Citerne;238;4;242
32;Hauts-de-France;80;4;18;197;Cizancourt;34;0;34
32;Hauts-de-France;80;2;04;198;Clairy-Saulchoix;370;4;374
32;Hauts-de-France;80;4;20;199;Cléry-sur-Somme;546;11;557
32;Hauts-de-France;80;1;23;200;Cocquerel;229;2;231
32;Hauts-de-France;80;4;05;201;Coigneux;49;2;51
32;Hauts-de-France;80;2;07;202;Coisy;340;3;343
32;Hauts-de-France;80;4;05;203;Colincamps;88;2;90
32;Hauts-de-France;80;4;20;204;Combles;765;12;777
32;Hauts-de-France;80;1;15;205;Condé-Folie;916;10;926
32;Hauts-de-France;80;4;05;206;Contalmaison;118;0;118
32;Hauts-de-France;80;2;13;207;Contay;364;1;365
32;Hauts-de-France;80;2;14;208;Conteville;211;4;215
32;Hauts-de-France;80;2;03;210;Contre;153;7;160
32;Hauts-de-France;80;2;03;211;Conty;1735;48;1783
32;Hauts-de-France;80;2;13;212;Corbie;6283;80;6363
32;Hauts-de-France;80;3;03;213;Cottenchy;576;172;748
32;Hauts-de-France;80;3;03;214;Coullemelle;332;1;333
32;Hauts-de-France;80;1;23;215;Coulonvillers;231;8;239
32;Hauts-de-France;80;4;05;216;Courcelette;154;1;155
32;Hauts-de-France;80;4;05;217;Courcelles-au-Bois;82;0;82
32;Hauts-de-France;80;2;21;218;Courcelles-sous-Moyencourt;139;3;142
32;Hauts-de-France;80;2;03;219;Courcelles-sous-Thoix;69;0;69
32;Hauts-de-France;80;3;22;220;Courtemanche;102;2;104
32;Hauts-de-France;80;1;23;221;Cramont;303;5;308
32;Hauts-de-France;80;1;23;222;Crécy-en-Ponthieu;1436;30;1466
32;Hauts-de-France;80;3;22;223;Crémery;121;0;121
32;Hauts-de-France;80;3;22;224;Cressy-Omencourt;123;1;124
32;Hauts-de-France;80;2;04;225;Creuse;190;4;194
32;Hauts-de-France;80;4;18;226;Croix-Moligneaux;278;5;283
32;Hauts-de-France;80;2;21;227;Croixrault;434;10;444
32;Hauts-de-France;80;1;23;228;Le Crotoy;2012;33;2045
32;Hauts-de-France;80;2;04;229;Crouy-Saint-Pierre;346;2;348
32;Hauts-de-France;80;4;18;230;Curchy;298;9;307
32;Hauts-de-France;80;4;05;231;Curlu;168;2;170
32;Hauts-de-France;80;3;22;232;Damery;235;5;240
32;Hauts-de-France;80;3;22;233;Dancourt-Popincourt;155;1;156
32;Hauts-de-France;80;2;08;234;Daours;797;16;813
32;Hauts-de-France;80;1;17;235;Dargnies;1246;18;1264
32;Hauts-de-France;80;3;22;236;Davenescourt;563;4;567
32;Hauts-de-France;80;3;19;237;Démuin;493;10;503
32;Hauts-de-France;80;4;05;238;Dernancourt;540;9;549
32;Hauts-de-France;80;4;20;239;Devise;50;3;53
32;Hauts-de-France;80;4;20;240;Doingt;1427;36;1463
32;Hauts-de-France;80;2;15;241;Domart-en-Ponthieu;1094;12;1106
32;Hauts-de-France;80;3;19;242;Domart-sur-la-Luce;419;9;428
32;Hauts-de-France;80;2;14;243;Domesmont;45;0;45
32;Hauts-de-France;80;1;23;244;Dominois;177;5;182
32;Hauts-de-France;80;2;14;245;Domléger-Longvillers;302;3;305
32;Hauts-de-France;80;3;03;246;Dommartin;350;3;353
32;Hauts-de-France;80;4;18;247;Dompierre-Becquincourt;706;8;714
32;Hauts-de-France;80;1;23;248;Dompierre-sur-Authie;401;5;406
32;Hauts-de-France;80;1;23;249;Domqueur;311;7;318
32;Hauts-de-France;80;1;01;250;Domvast;350;4;354
32;Hauts-de-France;80;1;17;251;Doudelainville;339;8;347
32;Hauts-de-France;80;4;18;252;Douilly;240;1;241
32;Hauts-de-France;80;2;14;253;Doullens;6106;306;6412
32;Hauts-de-France;80;2;04;256;Dreuil-lès-Amiens;1653;11;1664
32;Hauts-de-France;80;4;20;258;Driencourt;92;3;95
32;Hauts-de-France;80;2;21;259;Dromesnil;94;1;95
32;Hauts-de-France;80;1;01;260;Drucat;921;25;946
32;Hauts-de-France;80;2;11;261;Dury;1430;61;1491
32;Hauts-de-France;80;1;02;262;Eaucourt-sur-Somme;424;7;431
32;Hauts-de-France;80;3;22;263;L' Échelle-Saint-Aurin;53;0;53
32;Hauts-de-France;80;4;05;264;Éclusier-Vaux;81;39;120
32;Hauts-de-France;80;1;17;265;Embreville;557;7;564
32;Hauts-de-France;80;4;05;266;Englebelmer;299;0;299
32;Hauts-de-France;80;4;18;267;Ennemain;262;2;264
32;Hauts-de-France;80;1;02;268;Épagne-Épagnette;544;15;559
32;Hauts-de-France;80;2;21;269;Épaumesnil;133;0;133
32;Hauts-de-France;80;2;14;270;Épécamps;5;0;5
32;Hauts-de-France;80;4;20;271;Épehy;1145;14;1159
32;Hauts-de-France;80;4;18;272;Épénancourt;123;1;124
32;Hauts-de-France;80;2;21;273;Éplessier;361;9;370
32;Hauts-de-France;80;4;18;274;Eppeville;1816;18;1834
32;Hauts-de-France;80;4;20;275;Équancourt;298;3;301
32;Hauts-de-France;80;2;21;276;Équennes-Éramecourt;296;7;303
32;Hauts-de-France;80;3;22;278;Erches;187;3;190
32;Hauts-de-France;80;3;22;279;Ercheu;785;12;797
32;Hauts-de-France;80;1;02;280;Ercourt;122;2;124
32;Hauts-de-France;80;1;23;281;Ergnies;180;1;181
32;Hauts-de-France;80;1;17;282;Érondelle;511;5;516
32;Hauts-de-France;80;3;03;283;Esclainvillers;167;0;167
32;Hauts-de-France;80;4;18;284;Esmery-Hallon;767;37;804
32;Hauts-de-France;80;2;03;285;Essertaux;262;3;265
32;Hauts-de-France;80;1;02;287;Estrébœuf;243;4;247
32;Hauts-de-France;80;4;18;288;Estrées-Deniécourt;330;10;340
32;Hauts-de-France;80;1;23;290;Estrées-lès-Crécy;391;7;398
32;Hauts-de-France;80;4;20;557;Estrées-Mons;606;5;611
32;Hauts-de-France;80;2;03;291;Estrées-sur-Noye;270;3;273
32;Hauts-de-France;80;3;22;292;Étalon;136;1;137
32;Hauts-de-France;80;3;22;293;Ételfay;378;6;384
32;Hauts-de-France;80;4;20;294;Éterpigny;168;3;171
32;Hauts-de-France;80;4;05;295;Étinehem-Méricourt;592;7;599
32;Hauts-de-France;80;2;15;296;L' Étoile;1194;8;1202
32;Hauts-de-France;80;2;21;297;Étréjust;44;1;45
32;Hauts-de-France;80;4;20;298;Étricourt-Manancourt;531;4;535
32;Hauts-de-France;80;3;03;299;La Faloise;231;1;232
32;Hauts-de-France;80;4;18;300;Falvy;150;3;153
32;Hauts-de-France;80;2;21;301;Famechon;266;3;269
32;Hauts-de-France;80;3;22;302;Faverolles;161;3;164
32;Hauts-de-France;80;1;23;303;Favières;462;8;470
32;Hauts-de-France;80;4;18;304;Fay;103;2;105
32;Hauts-de-France;80;2;04;305;Ferrières;477;4;481
32;Hauts-de-France;80;3;22;306;Fescamps;138;5;143
32;Hauts-de-France;80;4;20;307;Feuillères;147;1;148
32;Hauts-de-France;80;1;17;308;Feuquières-en-Vimeu;2570;43;2613
32;Hauts-de-France;80;2;14;566;Fieffes-Montrelet;327;8;335
32;Hauts-de-France;80;2;14;310;Fienvillers;686;12;698
32;Hauts-de-France;80;3;22;311;Fignières;154;2;156
32;Hauts-de-France;80;4;20;312;Fins;277;2;279
32;Hauts-de-France;80;4;20;313;Flaucourt;291;5;296
32;Hauts-de-France;80;4;20;314;Flers;195;3;198
32;Hauts-de-France;80;3;03;315;Flers-sur-Noye;506;10;516
32;Hauts-de-France;80;2;15;316;Flesselles;2063;24;2087
32;Hauts-de-France;80;2;03;317;Fleury;223;3;226
32;Hauts-de-France;80;2;15;318;Flixecourt;3173;76;3249
32;Hauts-de-France;80;2;04;319;Fluy;332;0;332
32;Hauts-de-France;80;4;19;320;Folies;146;1;147
32;Hauts-de-France;80;3;03;321;Folleville;146;2;148
32;Hauts-de-France;80;3;22;322;Fonches-Fonchette;164;0;164
32;Hauts-de-France;80;2;21;324;Fontaine-le-Sec;154;4;158
32;Hauts-de-France;80;4;18;325;Fontaine-lès-Cappy;51;1;52
32;Hauts-de-France;80;3;22;326;Fontaine-sous-Montdidier;108;2;110
32;Hauts-de-France;80;1;23;327;Fontaine-sur-Maye;161;5;166
32;Hauts-de-France;80;1;17;328;Fontaine-sur-Somme;518;5;523
32;Hauts-de-France;80;4;05;329;Forceville;175;0;175
32;Hauts-de-France;80;2;21;330;Forceville-en-Vimeu;238;6;244
32;Hauts-de-France;80;1;01;331;Forest-l'Abbaye;301;12;313
32;Hauts-de-France;80;1;01;332;Forest-Montiers;399;9;408
32;Hauts-de-France;80;1;23;333;Fort-Mahon-Plage;1259;13;1272
32;Hauts-de-France;80;2;03;334;Fossemanant;93;5;98
32;Hauts-de-France;80;4;18;335;Foucaucourt-en-Santerre;268;3;271
32;Hauts-de-France;80;2;21;336;Foucaucourt-Hors-Nesle;80;1;81
32;Hauts-de-France;80;3;03;337;Fouencamps;208;3;211
32;Hauts-de-France;80;2;13;338;Fouilloy;1837;18;1855
32;Hauts-de-France;80;4;19;339;Fouquescourt;158;4;162
32;Hauts-de-France;80;2;21;340;Fourcigny;193;2;195
32;Hauts-de-France;80;2;04;341;Fourdrinoy;417;9;426
32;Hauts-de-France;80;4;18;342;Framerville-Rainecourt;461;3;464
32;Hauts-de-France;80;2;21;343;Framicourt;176;2;178
32;Hauts-de-France;80;1;23;344;Francières;194;8;202
32;Hauts-de-France;80;1;02;345;Franleu;552;7;559
32;Hauts-de-France;80;2;15;346;Franqueville;177;1;178
32;Hauts-de-France;80;4;19;347;Fransart;151;5;156
32;Hauts-de-France;80;2;15;348;Fransu;176;0;176
32;Hauts-de-France;80;3;03;349;Fransures;133;1;134
32;Hauts-de-France;80;2;13;350;Franvillers;513;7;520
32;Hauts-de-France;80;2;13;351;Fréchencourt;263;2;265
32;Hauts-de-France;80;2;03;352;Frémontiers;154;1;155
32;Hauts-de-France;80;4;18;353;Fresnes-Mazancourt;139;0;139
32;Hauts-de-France;80;2;21;354;Fresnes-Tilloloy;203;4;207
32;Hauts-de-France;80;2;21;355;Fresneville;105;2;107
32;Hauts-de-France;80;2;21;356;Fresnoy-Andainville;86;6;92
32;Hauts-de-France;80;2;04;357;Fresnoy-au-Val;243;3;246
32;Hauts-de-France;80;3;19;358;Fresnoy-en-Chaussée;148;1;149
32;Hauts-de-France;80;3;22;359;Fresnoy-lès-Roye;293;9;302
32;Hauts-de-France;80;1;16;360;Fressenneville;2207;43;2250
32;Hauts-de-France;80;2;21;361;Frettecuisse;74;0;74
32;Hauts-de-France;80;1;17;362;Frettemeule;324;5;329
32;Hauts-de-France;80;1;16;364;Friaucourt;742;11;753
32;Hauts-de-France;80;2;21;365;Fricamps;176;0;176
32;Hauts-de-France;80;4;05;366;Fricourt;490;4;494
32;Hauts-de-France;80;4;05;367;Frise;183;6;189
32;Hauts-de-France;80;1;16;368;Friville-Escarbotin;4569;103;4672
32;Hauts-de-France;80;2;14;369;Frohen-sur-Authie;233;5;238
32;Hauts-de-France;80;1;23;371;Froyelles;105;4;109
32;Hauts-de-France;80;1;17;372;Frucourt;132;6;138
32;Hauts-de-France;80;1;17;373;Gamaches;2548;86;2634
32;Hauts-de-France;80;1;01;374;Gapennes;281;3;284
32;Hauts-de-France;80;2;21;375;Gauville;346;7;353
32;Hauts-de-France;80;2;09;376;Gentelles;640;4;644
32;Hauts-de-France;80;2;14;377;Gézaincourt;428;6;434
32;Hauts-de-France;80;4;20;378;Ginchy;61;0;61
32;Hauts-de-France;80;2;09;379;Glisy;771;1;772
32;Hauts-de-France;80;1;23;380;Gorenflos;254;6;260
32;Hauts-de-France;80;2;14;381;Gorges;40;1;41
32;Hauts-de-France;80;3;22;383;Goyencourt;94;0;94
32;Hauts-de-France;80;1;01;385;Grand-Laviers;433;27;460
32;Hauts-de-France;80;4;05;384;Grandcourt;176;3;179
32;Hauts-de-France;80;3;22;386;Gratibus;182;3;185
32;Hauts-de-France;80;2;03;387;Grattepanche;318;1;319
32;Hauts-de-France;80;1;02;388;Grébault-Mesnil;220;2;222
32;Hauts-de-France;80;3;03;390;Grivesnes;407;6;413
32;Hauts-de-France;80;3;22;391;Grivillers;86;0;86
32;Hauts-de-France;80;2;14;392;Grouches-Luchuel;586;13;599
32;Hauts-de-France;80;3;22;393;Gruny;324;1;325
32;Hauts-de-France;80;3;22;395;Guerbigny;293;5;298
32;Hauts-de-France;80;1;23;396;Gueschart;335;4;339
32;Hauts-de-France;80;4;20;397;Gueudecourt;94;4;98
32;Hauts-de-France;80;2;04;399;Guignemicourt;360;4;364
32;Hauts-de-France;80;4;19;400;Guillaucourt;440;8;448
32;Hauts-de-France;80;4;20;401;Guillemont;137;2;139
32;Hauts-de-France;80;2;21;402;Guizancourt;127;1;128
32;Hauts-de-France;80;4;20;404;Guyencourt-Saulcourt;140;3;143
32;Hauts-de-France;80;3;03;403;Guyencourt-sur-Noye;177;3;180
32;Hauts-de-France;80;3;19;405;Hailles;422;2;424
32;Hauts-de-France;80;1;17;406;Hallencourt;1325;21;1346
32;Hauts-de-France;80;3;03;407;Hallivillers;149;6;155
32;Hauts-de-France;80;2;15;408;Halloy-lès-Pernois;343;3;346
32;Hauts-de-France;80;4;19;409;Hallu;177;5;182
32;Hauts-de-France;80;4;18;410;Ham;4611;97;4708
32;Hauts-de-France;80;2;13;411;Le Hamel;501;6;507
32;Hauts-de-France;80;2;13;412;Hamelet;630;6;636
32;Hauts-de-France;80;4;20;413;Hancourt;92;1;93
32;Hauts-de-France;80;3;19;414;Hangard;124;2;126
32;Hauts-de-France;80;3;19;415;Hangest-en-Santerre;1016;8;1024
32;Hauts-de-France;80;2;04;416;Hangest-sur-Somme;775;3;778
32;Hauts-de-France;80;4;19;417;Harbonnières;1641;12;1653
32;Hauts-de-France;80;4;20;418;Hardecourt-aux-Bois;84;0;84
32;Hauts-de-France;80;4;05;420;Harponville;180;1;181
32;Hauts-de-France;80;3;22;421;Hattencourt;291;4;295
32;Hauts-de-France;80;1;01;422;Hautvillers-Ouville;580;10;590
32;Hauts-de-France;80;2;15;423;Havernas;394;5;399
32;Hauts-de-France;80;2;11;424;Hébécourt;538;18;556
32;Hauts-de-France;80;4;05;425;Hédauville;126;1;127
32;Hauts-de-France;80;2;13;426;Heilly;424;8;432
32;Hauts-de-France;80;2;14;427;Hem-Hardinval;363;4;367
32;Hauts-de-France;80;4;20;428;Hem-Monacu;128;2;130
32;Hauts-de-France;80;2;13;429;Hénencourt;195;1;196
32;Hauts-de-France;80;4;20;430;Herbécourt;224;4;228
32;Hauts-de-France;80;4;05;431;Hérissart;614;9;623
32;Hauts-de-France;80;4;18;432;Herleville;183;1;184
32;Hauts-de-France;80;3;22;433;Herly;45;0;45
32;Hauts-de-France;80;4;20;434;Hervilly;189;4;193
32;Hauts-de-France;80;4;20;435;Hesbécourt;57;0;57
32;Hauts-de-France;80;2;21;436;Hescamps;516;5;521
32;Hauts-de-France;80;2;21;437;Heucourt-Croquoison;117;4;121
32;Hauts-de-France;80;4;20;438;Heudicourt;507;6;513
32;Hauts-de-France;80;2;14;439;Heuzecourt;169;1;170
32;Hauts-de-France;80;2;14;440;Hiermont;150;3;153
32;Hauts-de-France;80;4;18;442;Hombleux;1180;10;1190
32;Hauts-de-France;80;2;21;443;Hornoy-le-Bourg;1679;25;1704
32;Hauts-de-France;80;1;02;444;Huchenneville;665;13;678
32;Hauts-de-France;80;2;14;445;Humbercourt;268;2;270
32;Hauts-de-France;80;1;17;446;Huppy;785;20;805
32;Hauts-de-France;80;4;18;621;Hypercourt;731;17;748
32;Hauts-de-France;80;3;19;449;Ignaucourt;76;1;77
32;Hauts-de-France;80;2;21;450;Inval-Boiron;113;1;114
32;Hauts-de-France;80;4;05;451;Irles;113;0;113
32;Hauts-de-France;80;3;03;452;Jumel;518;4;522
32;Hauts-de-France;80;3;22;453;Laboissière-en-Santerre;150;0;150
32;Hauts-de-France;80;2;21;455;Lachapelle;85;2;87
32;Hauts-de-France;80;2;21;456;Lafresguimont-Saint-Martin;550;6;556
32;Hauts-de-France;80;2;13;458;Lahoussoye;471;10;481
32;Hauts-de-France;80;2;04;459;Laleu;117;6;123
32;Hauts-de-France;80;2;21;460;Lamaronde;65;0;65
32;Hauts-de-France;80;2;08;461;Lamotte-Brebière;222;4;226
32;Hauts-de-France;80;1;01;462;Lamotte-Buleux;352;11;363
32;Hauts-de-France;80;2;13;463;Lamotte-Warfusée;703;10;713
32;Hauts-de-France;80;1;16;464;Lanchères;915;13;928
32;Hauts-de-France;80;2;15;466;Lanches-Saint-Hilaire;131;1;132
32;Hauts-de-France;80;4;18;465;Languevoisin-Quiquery;195;5;200
32;Hauts-de-France;80;3;22;467;Laucourt;203;1;204
32;Hauts-de-France;80;4;05;468;Laviéville;171;3;174
32;Hauts-de-France;80;3;03;469;Lawarde-Mauger-l'Hortoy;173;1;174
32;Hauts-de-France;80;4;05;470;Léalvillers;167;2;169
32;Hauts-de-France;80;4;20;472;Lesbœufs;182;5;187
32;Hauts-de-France;80;3;22;473;Liancourt-Fosse;301;4;305
32;Hauts-de-France;80;4;18;474;Licourt;400;3;403
32;Hauts-de-France;80;4;20;475;Liéramont;227;7;234
32;Hauts-de-France;80;1;17;476;Liercourt;359;5;364
32;Hauts-de-France;80;1;23;477;Ligescourt;219;5;224
32;Hauts-de-France;80;3;22;478;Lignières;137;2;139
32;Hauts-de-France;80;2;21;479;Lignières-Châtelain;385;2;387
32;Hauts-de-France;80;2;21;480;Lignières-en-Vimeu;111;2;113
32;Hauts-de-France;80;4;18;481;Lihons;442;5;447
32;Hauts-de-France;80;1;17;482;Limeux;141;2;143
32;Hauts-de-France;80;2;21;484;Liomer;397;6;403
32;Hauts-de-France;80;1;23;486;Long;621;8;629
32;Hauts-de-France;80;4;20;487;Longavesnes;86;2;88
32;Hauts-de-France;80;1;17;488;Longpré-les-Corps-Saints;1660;25;1685
32;Hauts-de-France;80;2;09;489;Longueau;5621;44;5665
32;Hauts-de-France;80;4;20;490;Longueval;271;9;280
32;Hauts-de-France;80;2;14;491;Longuevillette;77;1;78
32;Hauts-de-France;80;4;05;493;Louvencourt;281;4;285
32;Hauts-de-France;80;3;03;494;Louvrechy;200;3;203
32;Hauts-de-France;80;2;14;495;Lucheux;534;8;542
32;Hauts-de-France;80;1;23;496;Machiel;156;1;157
32;Hauts-de-France;80;1;23;497;Machy;127;5;132
32;Hauts-de-France;80;4;05;498;Mailly-Maillet;624;5;629
32;Hauts-de-France;80;3;03;499;Mailly-Raineval;299;6;305
32;Hauts-de-France;80;1;17;500;Maisnières;516;6;522
32;Hauts-de-France;80;1;23;501;Maison-Ponthieu;274;3;277
32;Hauts-de-France;80;1;23;502;Maison-Roland;106;3;109
32;Hauts-de-France;80;2;14;503;Maizicourt;192;2;194
32;Hauts-de-France;80;3;22;504;Malpart;78;0;78
32;Hauts-de-France;80;2;13;507;Marcelcave;1239;17;1256
32;Hauts-de-France;80;3;22;508;Marché-Allouarde;53;0;53
32;Hauts-de-France;80;4;18;509;Marchélepot-Misery;599;6;605
32;Hauts-de-France;80;3;22;511;Marestmontiers;113;1;114
32;Hauts-de-France;80;1;02;512;Mareuil-Caubert;825;12;837
32;Hauts-de-France;80;4;05;513;Maricourt;178;3;181
32;Hauts-de-France;80;4;05;514;Marieux;122;1;123
32;Hauts-de-France;80;2;21;515;Marlers;141;0;141
32;Hauts-de-France;80;4;20;516;Marquaix;200;1;201
32;Hauts-de-France;80;3;22;517;Marquivillers;188;3;191
32;Hauts-de-France;80;1;17;518;Martainneville;422;3;425
32;Hauts-de-France;80;4;18;519;Matigny;503;6;509
32;Hauts-de-France;80;4;19;520;Maucourt;180;3;183
32;Hauts-de-France;80;4;20;521;Maurepas;197;0;197
32;Hauts-de-France;80;2;21;522;Le Mazis;106;1;107
32;Hauts-de-France;80;4;05;523;Méaulte;1254;16;1270
32;Hauts-de-France;80;4;19;524;Méharicourt;589;6;595
32;Hauts-de-France;80;2;21;525;Meigneux;175;4;179
32;Hauts-de-France;80;2;14;526;Le Meillard;154;3;157
32;Hauts-de-France;80;1;16;527;Méneslies;310;7;317
32;Hauts-de-France;80;2;21;528;Méréaucourt;6;1;7
32;Hauts-de-France;80;1;17;529;Mérélessart;197;5;202
32;Hauts-de-France;80;2;21;531;Méricourt-en-Vimeu;103;0;103
32;Hauts-de-France;80;2;13;530;Méricourt-l'Abbé;604;4;608
32;Hauts-de-France;80;1;16;533;Mers-les-Bains;2825;33;2858
32;Hauts-de-France;80;2;04;535;Le Mesge;176;3;179
32;Hauts-de-France;80;4;20;536;Mesnil-Bruntel;288;6;294
32;Hauts-de-France;80;1;23;537;Mesnil-Domqueur;88;0;88
32;Hauts-de-France;80;4;20;538;Mesnil-en-Arrouaise;126;0;126
32;Hauts-de-France;80;4;05;540;Mesnil-Martinsart;238;4;242
32;Hauts-de-France;80;3;22;541;Mesnil-Saint-Georges;188;3;191
32;Hauts-de-France;80;4;18;542;Mesnil-Saint-Nicaise;561;7;568
32;Hauts-de-France;80;2;04;543;Métigny;118;3;121
32;Hauts-de-France;80;2;14;544;Mézerolles;188;3;191
32;Hauts-de-France;80;3;19;545;Mézières-en-Santerre;589;0;589
32;Hauts-de-France;80;1;02;546;Miannay;564;7;571
32;Hauts-de-France;80;4;05;547;Millencourt;211;4;215
32;Hauts-de-France;80;1;01;548;Millencourt-en-Ponthieu;359;2;361
32;Hauts-de-France;80;4;05;549;Miraumont;664;12;676
32;Hauts-de-France;80;2;13;550;Mirvaux;144;4;148
32;Hauts-de-France;80;4;20;552;Moislains;1201;14;1215
32;Hauts-de-France;80;2;13;553;Molliens-au-Bois;322;10;332
32;Hauts-de-France;80;2;04;554;Molliens-Dreuil;958;11;969
32;Hauts-de-France;80;4;18;555;Monchy-Lagache;643;20;663
32;Hauts-de-France;80;1;02;556;Mons-Boubert;558;6;564
32;Hauts-de-France;80;2;03;558;Monsures;227;2;229
32;Hauts-de-France;80;2;04;559;Montagne-Fayel;145;3;148
32;Hauts-de-France;80;4;05;560;Montauban-de-Picardie;214;1;215
32;Hauts-de-France;80;3;22;561;Montdidier;6255;104;6359
32;Hauts-de-France;80;2;14;563;Montigny-les-Jongleurs;95;1;96
32;Hauts-de-France;80;2;13;562;Montigny-sur-l'Hallue;205;2;207
32;Hauts-de-France;80;2;07;565;Montonvillers;82;2;84
32;Hauts-de-France;80;4;18;568;Morchain;352;4;356
32;Hauts-de-France;80;2;13;569;Morcourt;312;3;315
32;Hauts-de-France;80;3;19;570;Moreuil;3980;28;4008
32;Hauts-de-France;80;3;19;571;Morisel;518;2;520
32;Hauts-de-France;80;4;05;572;Morlancourt;371;2;373
32;Hauts-de-France;80;2;21;573;Morvillers-Saint-Saturnin;406;5;411
32;Hauts-de-France;80;1;23;574;Mouflers;93;1;94
32;Hauts-de-France;80;2;21;575;Mouflières;86;9;95
32;Hauts-de-France;80;4;18;576;Moyencourt;317;0;317
32;Hauts-de-France;80;2;21;577;Moyencourt-lès-Poix;181;1;182
32;Hauts-de-France;80;1;02;578;Moyenneville;716;11;727
32;Hauts-de-France;80;4;18;579;Muille-Villette;831;12;843
32;Hauts-de-France;80;1;23;580;Nampont;248;3;251
32;Hauts-de-France;80;2;03;582;Namps-Maisnil;987;13;1000
32;Hauts-de-France;80;2;03;583;Nampty;289;8;297
32;Hauts-de-France;80;2;13;584;Naours;1080;10;1090
32;Hauts-de-France;80;4;18;585;Nesle;2339;30;2369
32;Hauts-de-France;80;2;21;586;Nesle-l'Hôpital;156;1;157
32;Hauts-de-France;80;2;21;587;Neslette;81;0;81
32;Hauts-de-France;80;1;01;588;Neufmoulin;361;7;368
32;Hauts-de-France;80;1;01;590;Neuilly-l'Hôpital;323;12;335
32;Hauts-de-France;80;1;23;589;Neuilly-le-Dien;96;0;96
32;Hauts-de-France;80;2;21;591;Neuville-au-Bois;153;1;154
32;Hauts-de-France;80;2;21;592;Neuville-Coppegueule;521;6;527
32;Hauts-de-France;80;4;05;593;La Neuville-lès-Bray;266;2;268
32;Hauts-de-France;80;3;19;595;La Neuville-Sire-Bernard;285;1;286
32;Hauts-de-France;80;2;14;596;Neuvillette;222;6;228
32;Hauts-de-France;80;1;16;597;Nibas;853;15;868
32;Hauts-de-France;80;1;01;598;Nouvion;1316;26;1342
32;Hauts-de-France;80;1;23;599;Noyelles-en-Chaussée;243;3;246
32;Hauts-de-France;80;1;01;600;Noyelles-sur-Mer;730;11;741
32;Hauts-de-France;80;4;20;601;Nurlu;387;4;391
32;Hauts-de-France;80;2;03;485;Ô-de-Selle;1205;9;1214
32;Hauts-de-France;80;2;14;602;Occoches;127;3;130
32;Hauts-de-France;80;1;16;603;Ochancourt;317;1;318
32;Hauts-de-France;80;2;21;604;Offignies;74;3;77
32;Hauts-de-France;80;4;18;605;Offoy;217;2;219
32;Hauts-de-France;80;2;21;606;Oisemont;1171;49;1220
32;Hauts-de-France;80;2;04;607;Oissy;221;3;224
32;Hauts-de-France;80;1;23;609;Oneux;389;6;395
32;Hauts-de-France;80;2;03;611;Oresmaux;930;13;943
32;Hauts-de-France;80;1;16;613;Oust-Marest;630;11;641
32;Hauts-de-France;80;2;14;614;Outrebois;312;6;318
32;Hauts-de-France;80;4;05;615;Ovillers-la-Boisselle;446;6;452
32;Hauts-de-France;80;4;18;616;Pargny;205;1;206
32;Hauts-de-France;80;4;19;617;Parvillers-le-Quesnoy;233;3;236
32;Hauts-de-France;80;1;16;618;Pendé;1069;14;1083
32;Hauts-de-France;80;2;15;619;Pernois;735;8;743
32;Hauts-de-France;80;4;20;620;Péronne;7579;206;7785
32;Hauts-de-France;80;2;04;622;Picquigny;1337;16;1353
32;Hauts-de-France;80;3;22;623;Piennes-Onvillers;363;4;367
32;Hauts-de-France;80;2;13;624;Pierregot;280;5;285
32;Hauts-de-France;80;2;04;626;Pissy;281;2;283
32;Hauts-de-France;80;2;03;627;Plachy-Buyon;878;21;899
32;Hauts-de-France;80;3;19;628;Le Plessier-Rozainvillers;755;4;759
32;Hauts-de-France;80;2;21;630;Poix-de-Picardie;2408;32;2440
32;Hauts-de-France;80;1;23;631;Ponches-Estruval;101;3;104
32;Hauts-de-France;80;2;12;632;Pont-de-Metz;2467;38;2505
32;Hauts-de-France;80;2;13;634;Pont-Noyelles;840;17;857
32;Hauts-de-France;80;1;23;635;Pont-Remy;1469;22;1491
32;Hauts-de-France;80;1;01;633;Ponthoile;615;10;625
32;Hauts-de-France;80;1;01;637;Port-le-Grand;283;1;284
32;Hauts-de-France;80;4;18;638;Potte;103;2;105
32;Hauts-de-France;80;2;07;639;Poulainville;1211;23;1234
32;Hauts-de-France;80;4;05;640;Pozières;266;3;269
32;Hauts-de-France;80;2;14;642;Prouville;314;2;316
32;Hauts-de-France;80;2;03;643;Prouzel;552;7;559
32;Hauts-de-France;80;4;18;644;Proyart;695;10;705
32;Hauts-de-France;80;4;05;645;Puchevillers;555;3;558
32;Hauts-de-France;80;4;18;646;Punchy;87;4;91
32;Hauts-de-France;80;4;18;647;Puzeaux;298;3;301
32;Hauts-de-France;80;4;05;648;Pys;120;1;121
32;Hauts-de-France;80;4;20;629;Pœuilly;121;2;123
32;Hauts-de-France;80;1;23;649;Quend;1396;18;1414
32;Hauts-de-France;80;2;07;650;Querrieu;648;18;666
32;Hauts-de-France;80;2;21;651;Le Quesne;267;2;269
32;Hauts-de-France;80;3;19;652;Le Quesnel;792;9;801
32;Hauts-de-France;80;1;02;654;Quesnoy-le-Montant;564;19;583
32;Hauts-de-France;80;2;04;655;Quesnoy-sur-Airaines;441;6;447
32;Hauts-de-France;80;2;04;656;Quevauvillers;1102;9;1111
32;Hauts-de-France;80;3;03;657;Quiry-le-Sec;325;2;327
32;Hauts-de-France;80;4;18;658;Quivières;142;3;145
32;Hauts-de-France;80;4;05;659;Raincheval;282;6;288
32;Hauts-de-France;80;2;07;661;Rainneville;997;7;1004
32;Hauts-de-France;80;1;17;662;Ramburelles;280;2;282
32;Hauts-de-France;80;2;21;663;Rambures;343;7;350
32;Hauts-de-France;80;4;20;664;Rancourt;198;3;201
32;Hauts-de-France;80;1;23;665;Regnière-Écluse;126;3;129
32;Hauts-de-France;80;2;14;666;Remaisnil;29;0;29
32;Hauts-de-France;80;3;22;667;Remaugies;132;0;132
32;Hauts-de-France;80;2;03;668;Remiencourt;175;3;178
32;Hauts-de-France;80;4;18;669;Rethonvillers;366;4;370
32;Hauts-de-France;80;2;04;670;Revelles;515;6;521
32;Hauts-de-France;80;2;15;671;Ribeaucourt;250;7;257
32;Hauts-de-France;80;2;13;672;Ribemont-sur-Ancre;679;2;681
32;Hauts-de-France;80;2;04;673;Riencourt;178;7;185
32;Hauts-de-France;80;2;08;674;Rivery;3552;40;3592
32;Hauts-de-France;80;3;03;675;Rogy;126;2;128
32;Hauts-de-France;80;3;22;676;Roiglise;155;7;162
32;Hauts-de-France;80;4;20;677;Roisel;1613;21;1634
32;Hauts-de-France;80;3;22;678;Rollot;751;19;770
32;Hauts-de-France;80;4;20;679;Ronssoy;587;6;593
32;Hauts-de-France;80;4;19;680;Rosières-en-Santerre;3008;26;3034
32;Hauts-de-France;80;3;03;681;Rouvrel;306;5;311
32;Hauts-de-France;80;4;19;682;Rouvroy-en-Santerre;212;3;215
32;Hauts-de-France;80;4;18;683;Rouy-le-Grand;107;3;110
32;Hauts-de-France;80;4;18;684;Rouy-le-Petit;112;4;116
32;Hauts-de-France;80;3;22;685;Roye;5786;62;5848
32;Hauts-de-France;80;2;13;686;Rubempré;726;10;736
32;Hauts-de-France;80;3;22;687;Rubescourt;134;2;136
32;Hauts-de-France;80;1;23;688;Rue;3101;103;3204
32;Hauts-de-France;80;2;11;690;Rumigny;611;9;620
32;Hauts-de-France;80;1;02;691;Saigneville;393;14;407
32;Hauts-de-France;80;1;01;692;Sailly-Flibeaucourt;1037;18;1055
32;Hauts-de-France;80;2;13;693;Sailly-Laurette;314;1;315
32;Hauts-de-France;80;2;13;694;Sailly-le-Sec;352;6;358
32;Hauts-de-France;80;4;20;695;Sailly-Saillisel;477;8;485
32;Hauts-de-France;80;2;11;696;Sains-en-Amiénois;1205;32;1237
32;Hauts-de-France;80;2;14;697;Saint-Acheul;27;0;27
32;Hauts-de-France;80;2;04;698;Saint-Aubin-Montenoy;225;4;229
32;Hauts-de-France;80;2;21;699;Saint-Aubin-Rivière;111;0;111
32;Hauts-de-France;80;1;16;700;Saint-Blimont;878;10;888
32;Hauts-de-France;80;4;18;701;Saint-Christ-Briost;437;10;447
32;Hauts-de-France;80;2;11;702;Saint-Fuscien;1170;24;1194
32;Hauts-de-France;80;2;21;703;Saint-Germain-sur-Bresle;206;3;209
32;Hauts-de-France;80;2;07;704;Saint-Gratien;377;6;383
32;Hauts-de-France;80;4;05;705;Saint-Léger-lès-Authie;89;1;90
32;Hauts-de-France;80;2;15;706;Saint-Léger-lès-Domart;1855;17;1872
32;Hauts-de-France;80;2;21;707;Saint-Léger-sur-Bresle;81;4;85
32;Hauts-de-France;80;3;22;708;Saint-Mard;165;3;168
32;Hauts-de-France;80;2;21;709;Saint-Maulvis;267;7;274
32;Hauts-de-France;80;1;17;710;Saint-Maxent;392;4;396
32;Hauts-de-France;80;2;15;711;Saint-Ouen;1907;11;1918
32;Hauts-de-France;80;1;23;713;Saint-Quentin-en-Tourmont;282;4;286
32;Hauts-de-France;80;1;16;714;Saint-Quentin-la-Motte-Croix-au-Bailly;1291;21;1312
32;Hauts-de-France;80;1;23;716;Saint-Riquier;1258;30;1288
32;Hauts-de-France;80;2;03;717;Saint-Sauflieu;995;10;1005
32;Hauts-de-France;80;2;04;718;Saint-Sauveur;1376;16;1392
32;Hauts-de-France;80;2;15;722;Saint-Vaast-en-Chaussée;495;7;502
32;Hauts-de-France;80;1;02;721;Saint-Valery-sur-Somme;2510;40;2550
32;Hauts-de-France;80;2;21;719;Sainte-Segrée;57;5;62
32;Hauts-de-France;80;2;04;723;Saisseval;239;1;240
32;Hauts-de-France;80;2;12;724;Saleux;2846;33;2879
32;Hauts-de-France;80;2;12;725;Salouël;3979;53;4032
32;Hauts-de-France;80;4;18;726;Sancourt;267;6;273
32;Hauts-de-France;80;2;21;728;Saulchoy-sous-Poix;71;0;71
32;Hauts-de-France;80;3;03;729;Sauvillers-Mongival;175;0;175
32;Hauts-de-France;80;2;04;730;Saveuse;932;8;940
32;Hauts-de-France;80;2;21;732;Senarpont;647;15;662
32;Hauts-de-France;80;4;05;733;Senlis-le-Sec;294;8;302
32;Hauts-de-France;80;2;03;734;Sentelie;208;3;211
32;Hauts-de-France;80;2;04;735;Seux;168;2;170
32;Hauts-de-France;80;4;20;737;Sorel;162;0;162
32;Hauts-de-France;80;1;17;736;Sorel-en-Vimeu;213;4;217
32;Hauts-de-France;80;2;04;738;Soues;125;4;129
32;Hauts-de-France;80;3;03;740;Sourdon;325;2;327
32;Hauts-de-France;80;4;18;741;Soyécourt;182;4;186
32;Hauts-de-France;80;2;15;742;Surcamps;64;2;66
32;Hauts-de-France;80;4;05;743;Suzanne;186;4;190
32;Hauts-de-France;80;2;04;744;Tailly;59;2;61
32;Hauts-de-France;80;2;13;746;Talmas;1067;12;1079
32;Hauts-de-France;80;4;20;747;Templeux-la-Fosse;140;3;143
32;Hauts-de-France;80;4;20;748;Templeux-le-Guérard;172;1;173
32;Hauts-de-France;80;2;14;749;Terramesnil;310;3;313
32;Hauts-de-France;80;4;18;750;Tertry;156;1;157
32;Hauts-de-France;80;3;19;751;Thennes;563;6;569
32;Hauts-de-France;80;2;03;752;Thézy-Glimont;662;8;670
32;Hauts-de-France;80;4;05;753;Thiepval;129;1;130
32;Hauts-de-France;80;2;21;754;Thieulloy-l'Abbaye;372;3;375
32;Hauts-de-France;80;2;21;755;Thieulloy-la-Ville;144;4;148
32;Hauts-de-France;80;4;05;756;Thièvres;62;0;62
32;Hauts-de-France;80;2;03;757;Thoix;144;2;146
32;Hauts-de-France;80;3;03;758;Thory;195;0;195
32;Hauts-de-France;80;3;22;759;Tilloloy;353;9;362
32;Hauts-de-France;80;1;17;760;Tilloy-Floriville;393;4;397
32;Hauts-de-France;80;4;20;762;Tincourt-Boucly;356;10;366
32;Hauts-de-France;80;1;01;763;Le Titre;358;8;366
32;Hauts-de-France;80;1;02;765;Tours-en-Vimeu;818;10;828
32;Hauts-de-France;80;4;05;766;Toutencourt;461;6;467
32;Hauts-de-France;80;2;21;767;Le Translay;248;5;253
32;Hauts-de-France;80;2;13;769;Treux;249;4;253
32;Hauts-de-France;80;3;89;625;Trois-Rivières;1504;10;1514
32;Hauts-de-France;80;1;16;770;Tully;548;9;557
32;Hauts-de-France;80;1;02;764;Tœufles;299;7;306
32;Hauts-de-France;80;4;18;771;Ugny-l'Équipée;40;1;41
32;Hauts-de-France;80;2;13;773;Vadencourt;100;0;100
32;Hauts-de-France;80;2;13;774;Vaire-sous-Corbie;288;3;291
32;Hauts-de-France;80;1;16;775;Valines;636;6;642
32;Hauts-de-France;80;4;05;776;Varennes;220;1;221
32;Hauts-de-France;80;4;05;777;Vauchelles-lès-Authie;151;1;152
32;Hauts-de-France;80;2;15;778;Vauchelles-lès-Domart;125;0;125
32;Hauts-de-France;80;1;01;779;Vauchelles-les-Quesnoy;851;19;870
32;Hauts-de-France;80;1;16;780;Vaudricourt;395;5;400
32;Hauts-de-France;80;4;18;781;Vauvillers;246;5;251
32;Hauts-de-France;80;2;15;782;Vaux-en-Amiénois;406;12;418
32;Hauts-de-France;80;1;17;783;Vaux-Marquenneville;87;3;90
32;Hauts-de-France;80;2;13;784;Vaux-sur-Somme;308;6;314
32;Hauts-de-France;80;2;08;785;Vecquemont;540;9;549
32;Hauts-de-France;80;2;03;786;Velennes;149;0;149
32;Hauts-de-France;80;1;23;787;Vercourt;93;1;94
32;Hauts-de-France;80;2;21;788;Vergies;163;3;166
32;Hauts-de-France;80;4;18;789;Vermandovillers;150;0;150
32;Hauts-de-France;80;3;22;790;Verpillières;165;3;168
32;Hauts-de-France;80;2;12;791;Vers-sur-Selle;735;7;742
32;Hauts-de-France;80;2;13;792;La Vicogne;252;1;253
32;Hauts-de-France;80;2;15;793;Vignacourt;2368;30;2398
32;Hauts-de-France;80;2;15;795;Ville-le-Marclet;473;33;506
32;Hauts-de-France;80;4;05;807;Ville-sur-Ancre;271;3;274
32;Hauts-de-France;80;4;18;794;Villecourt;58;1;59
32;Hauts-de-France;80;2;21;796;Villeroy;190;5;195
32;Hauts-de-France;80;3;19;797;Villers-aux-Érables;127;3;130
32;Hauts-de-France;80;2;07;798;Villers-Bocage;1422;54;1476
32;Hauts-de-France;80;2;09;799;Villers-Bretonneux;4464;54;4518
32;Hauts-de-France;80;2;21;800;Villers-Campsart;152;1;153
32;Hauts-de-France;80;4;20;801;Villers-Carbonnel;366;3;369
32;Hauts-de-France;80;4;20;802;Villers-Faucon;588;9;597
32;Hauts-de-France;80;3;22;803;Villers-lès-Roye;274;0;274
32;Hauts-de-France;80;1;23;804;Villers-sous-Ailly;181;5;186
32;Hauts-de-France;80;1;23;806;Villers-sur-Authie;474;7;481
32;Hauts-de-France;80;3;22;805;Villers-Tournelle;155;6;161
32;Hauts-de-France;80;1;23;808;Vironchaux;491;9;500
32;Hauts-de-France;80;1;17;809;Vismes;483;12;495
32;Hauts-de-France;80;1;23;810;Vitz-sur-Authie;127;1;128
32;Hauts-de-France;80;4;18;811;Voyennes;603;7;610
32;Hauts-de-France;80;4;20;812;Vraignes-en-Vermandois;142;3;145
32;Hauts-de-France;80;2;21;813;Vraignes-lès-Hornoy;96;3;99
32;Hauts-de-France;80;4;19;814;Vrély;437;9;446
32;Hauts-de-France;80;1;23;815;Vron;837;26;863
32;Hauts-de-France;80;2;13;819;Wargnies;89;3;92
32;Hauts-de-France;80;2;13;820;Warloy-Baillon;758;6;764
32;Hauts-de-France;80;2;04;821;Warlus;222;6;228
32;Hauts-de-France;80;3;22;822;Warsy;143;2;145
32;Hauts-de-France;80;4;19;823;Warvillers;150;5;155
32;Hauts-de-France;80;4;19;824;Wiencourt-l'Équipée;263;2;265
32;Hauts-de-France;80;1;17;825;Wiry-au-Mont;121;0;121
32;Hauts-de-France;80;1;16;826;Woignarue;816;16;832
32;Hauts-de-France;80;1;16;827;Woincourt;1268;15;1283
32;Hauts-de-France;80;2;21;828;Woirel;60;0;60
32;Hauts-de-France;80;4;18;829;Y;92;2;94
32;Hauts-de-France;80;1;23;830;Yaucourt-Bussus;244;8;252
32;Hauts-de-France;80;1;02;836;Yonval;227;7;234
32;Hauts-de-France;80;1;23;832;Yvrench;304;4;308
32;Hauts-de-France;80;1;23;833;Yvrencheux;127;2;129
32;Hauts-de-France;80;1;16;834;Yzengremer;514;53;567
32;Hauts-de-France;80;2;04;835;Yzeux;267;3;270
76;Occitanie;81;2;15;001;Aguts;223;10;233
76;Occitanie;81;2;16;002;Aiguefonde;2517;56;2573
76;Occitanie;81;1;13;003;Alban;938;42;980
76;Occitanie;81;1;96;004;Albi;48970;1789;50759
76;Occitanie;81;2;17;005;Albine;509;4;513
76;Occitanie;81;2;15;006;Algans;203;3;206
76;Occitanie;81;1;05;008;Almayrac;293;4;297
76;Occitanie;81;1;23;007;Alos;93;2;95
76;Occitanie;81;1;06;009;Amarens;68;0;68
76;Occitanie;81;1;13;010;Ambialet;459;6;465
76;Occitanie;81;2;21;011;Ambres;980;25;1005
76;Occitanie;81;1;23;012;Andillac;123;1;124
76;Occitanie;81;1;05;013;Andouque;406;8;414
76;Occitanie;81;2;14;014;Anglès;508;7;515
76;Occitanie;81;2;19;015;Appelle;72;1;73
76;Occitanie;81;2;18;016;Arfons;168;7;175
76;Occitanie;81;2;13;017;Arifat;164;1;165
76;Occitanie;81;1;22;018;Arthès;2498;53;2551
76;Occitanie;81;1;05;019;Assac;144;1;145
76;Occitanie;81;1;10;020;Aussac;263;12;275
76;Occitanie;81;2;16;021;Aussillon;5892;134;6026
76;Occitanie;81;2;15;022;Bannières;206;7;213
76;Occitanie;81;2;14;023;Barre;207;2;209
76;Occitanie;81;1;23;024;Beauvais-sur-Tescou;362;9;371
76;Occitanie;81;2;15;025;Belcastel;237;9;246
76;Occitanie;81;1;13;026;Bellegarde-Marsal;712;7;719
76;Occitanie;81;2;18;027;Belleserre;162;2;164
76;Occitanie;81;2;14;028;Berlats;105;1;106
76;Occitanie;81;1;10;029;Bernac;186;5;191
76;Occitanie;81;2;19;030;Bertre;118;1;119
76;Occitanie;81;2;14;031;Le Bez;831;18;849
76;Occitanie;81;2;19;032;Blan;1125;19;1144
76;Occitanie;81;1;06;033;Blaye-les-Mines;2987;204;3191
76;Occitanie;81;2;16;034;Boissezon;397;7;404
76;Occitanie;81;1;06;035;Bournazel;192;6;198
76;Occitanie;81;2;17;036;Bout-du-Pont-de-Larn;1261;22;1283
76;Occitanie;81;2;14;037;Brassac;1290;33;1323
76;Occitanie;81;1;11;038;Brens;2305;63;2368
76;Occitanie;81;2;12;039;Briatexte;2016;30;2046
76;Occitanie;81;2;20;040;Brousse;419;11;430
76;Occitanie;81;1;11;041;Broze;119;1;120
76;Occitanie;81;2;08;042;Burlats;2131;51;2182
76;Occitanie;81;2;12;043;Busque;745;13;758
76;Occitanie;81;2;20;044;Cabanès;289;4;293
76;Occitanie;81;1;06;045;Les Cabannes;369;9;378
76;Occitanie;81;1;10;046;Cadalen;1530;31;1561
76;Occitanie;81;1;05;047;Cadix;228;9;237
76;Occitanie;81;1;03;048;Cagnac-les-Mines;2601;32;2633
76;Occitanie;81;2;18;049;Cahuzac;375;3;378
76;Occitanie;81;1;23;051;Cahuzac-sur-Vère;1157;20;1177
76;Occitanie;81;1;22;052;Cambon;2121;55;2176
76;Occitanie;81;2;15;050;Cambon-lès-Lavaur;333;8;341
76;Occitanie;81;2;14;053;Cambounès;331;11;342
76;Occitanie;81;2;19;054;Cambounet-sur-le-Sor;932;19;951
76;Occitanie;81;2;18;055;Les Cammazes;340;1;341
76;Occitanie;81;1;23;056;Campagnac;152;2;154
76;Occitanie;81;2;20;058;Carbes;225;8;233
76;Occitanie;81;1;02;059;Carlus;678;16;694
76;Occitanie;81;1;97;060;Carmaux;9500;159;9659
76;Occitanie;81;1;10;061;Castanet;199;2;201
76;Occitanie;81;1;03;063;Castelnau-de-Lévis;1594;38;1632
76;Occitanie;81;1;23;064;Castelnau-de-Montmiral;1033;24;1057
76;Occitanie;81;2;98;065;Castres;41636;1446;43082
76;Occitanie;81;2;16;066;Caucalières;286;6;292
76;Occitanie;81;1;10;067;Cestayrols;466;9;475
76;Occitanie;81;1;06;068;Combefa;155;6;161
76;Occitanie;81;1;06;069;Cordes-sur-Ciel;869;41;910
76;Occitanie;81;1;21;070;Coufouleux;2874;51;2925
76;Occitanie;81;1;05;071;Courris;80;4;84
76;Occitanie;81;1;05;072;Crespin;131;3;134
76;Occitanie;81;1;05;073;Crespinet;174;1;175
76;Occitanie;81;1;22;074;Cunac;1558;60;1618
76;Occitanie;81;2;20;075;Cuq;495;10;505
76;Occitanie;81;2;15;076;Cuq-Toulza;699;20;719
76;Occitanie;81;1;13;077;Curvalle;398;10;408
76;Occitanie;81;2;20;078;Damiatte;1025;17;1042
76;Occitanie;81;1;22;079;Dénat;792;16;808
76;Occitanie;81;1;06;080;Donnazac;80;1;81
76;Occitanie;81;2;18;081;Dourgne;1315;44;1359
76;Occitanie;81;1;05;082;Le Dourn;114;1;115
76;Occitanie;81;2;18;083;Durfort;249;1;250
76;Occitanie;81;2;18;084;Escoussens;601;24;625
76;Occitanie;81;2;14;085;Escroux;49;1;50
76;Occitanie;81;2;14;086;Espérausses;172;3;175
76;Occitanie;81;1;13;088;Fauch;536;13;549
76;Occitanie;81;1;05;089;Faussergues;141;6;147
76;Occitanie;81;1;10;087;Fayssac;347;10;357
76;Occitanie;81;1;10;090;Fénols;245;6;251
76;Occitanie;81;2;20;092;Fiac;925;15;940
76;Occitanie;81;1;10;093;Florentin;680;46;726
76;Occitanie;81;2;14;062;Fontrieu;947;18;965
76;Occitanie;81;1;05;094;Fraissines;93;3;96
76;Occitanie;81;1;06;095;Frausseilles;85;1;86
76;Occitanie;81;1;13;096;Le Fraysse;392;3;395
76;Occitanie;81;1;22;097;Fréjairolles;1323;36;1359
76;Occitanie;81;2;20;098;Fréjeville;667;20;687
76;Occitanie;81;1;11;099;Gaillac;15294;327;15621
76;Occitanie;81;2;19;100;Garrevaques;398;10;408
76;Occitanie;81;1;04;101;Le Garric;1252;18;1270
76;Occitanie;81;2;21;102;Garrigues;252;13;265
76;Occitanie;81;2;14;103;Gijounet;129;7;136
76;Occitanie;81;2;21;104;Giroussens;1484;35;1519
76;Occitanie;81;2;12;105;Graulhet;12618;238;12856
76;Occitanie;81;1;23;106;Grazac;604;17;621
76;Occitanie;81;2;20;132;Guitalens-L'Albarède;866;13;879
76;Occitanie;81;1;06;108;Itzac;152;6;158
76;Occitanie;81;2;20;109;Jonquières;447;6;453
76;Occitanie;81;1;05;110;Jouqueviel;96;3;99
76;Occitanie;81;1;06;111;Labarthe-Bleys;75;0;75
76;Occitanie;81;1;10;112;Labastide-de-Lévis;909;20;929
76;Occitanie;81;1;06;114;Labastide-Gabausse;512;12;524
76;Occitanie;81;2;17;115;Labastide-Rouairoux;1410;25;1435
76;Occitanie;81;2;15;116;Labastide-Saint-Georges;1929;45;1974
76;Occitanie;81;1;10;117;Labessière-Candeil;749;21;770
76;Occitanie;81;2;20;118;Laboulbène;144;4;148
76;Occitanie;81;1;13;119;Laboutarie;489;6;495
76;Occitanie;81;2;18;120;Labruguière;6535;123;6658
76;Occitanie;81;2;17;121;Lacabarède;310;6;316
76;Occitanie;81;1;05;122;Lacapelle-Pinet;77;2;79
76;Occitanie;81;1;06;123;Lacapelle-Ségalar;99;2;101
76;Occitanie;81;2;14;124;Lacaune;2492;88;2580
76;Occitanie;81;2;14;125;Lacaze;298;8;306
76;Occitanie;81;2;15;126;Lacougotte-Cadoul;171;5;176
76;Occitanie;81;2;15;127;Lacroisille;114;6;120
76;Occitanie;81;2;14;128;Lacrouzette;1689;45;1734
76;Occitanie;81;2;18;129;Lagardiolle;238;5;243
76;Occitanie;81;2;16;130;Lagarrigue;1823;37;1860
76;Occitanie;81;1;10;131;Lagrave;2140;39;2179
76;Occitanie;81;1;13;133;Lamillarié;513;5;518
76;Occitanie;81;2;14;134;Lamontélarié;68;0;68
76;Occitanie;81;1;06;135;Laparrouquial;101;0;101
76;Occitanie;81;1;23;136;Larroque;158;3;161
76;Occitanie;81;2;14;137;Lasfaillades;81;1;82
76;Occitanie;81;1;10;138;Lasgraisses;519;9;528
76;Occitanie;81;2;20;139;Lautrec;1783;27;1810
76;Occitanie;81;2;15;140;Lavaur;10811;418;11229
76;Occitanie;81;1;05;141;Lédas-et-Penthiès;140;4;144
76;Occitanie;81;2;19;142;Lempaut;868;15;883
76;Occitanie;81;2;19;143;Lescout;711;13;724
76;Occitanie;81;1;04;144;Lescure-d'Albigeois;4577;93;4670
76;Occitanie;81;1;23;145;Lisle-sur-Tarn;4694;84;4778
76;Occitanie;81;1;06;146;Livers-Cazelles;216;10;226
76;Occitanie;81;1;13;147;Lombers;1141;14;1155
76;Occitanie;81;1;06;148;Loubers;78;6;84
76;Occitanie;81;1;21;149;Loupiac;408;20;428
76;Occitanie;81;2;21;150;Lugan;421;13;434
76;Occitanie;81;2;20;151;Magrin;130;5;135
76;Occitanie;81;1;03;152;Mailhoc;300;3;303
76;Occitanie;81;1;06;154;Marnaves;77;1;78
76;Occitanie;81;1;03;156;Marssac-sur-Tarn;3200;74;3274
76;Occitanie;81;2;15;157;Marzens;298;11;309
76;Occitanie;81;2;14;158;Le Masnau-Massuguiès;270;6;276
76;Occitanie;81;2;15;159;Massac-Séran;386;17;403
76;Occitanie;81;2;18;160;Massaguel;405;8;413
76;Occitanie;81;1;13;161;Massals;100;3;103
76;Occitanie;81;2;15;162;Maurens-Scopont;187;2;189
76;Occitanie;81;2;99;163;Mazamet;10013;450;10463
76;Occitanie;81;1;23;164;Mézens;490;11;501
76;Occitanie;81;1;06;165;Milhars;239;3;242
76;Occitanie;81;1;03;166;Milhavet;86;3;89
76;Occitanie;81;1;13;167;Miolles;106;1;107
76;Occitanie;81;1;05;168;Mirandol-Bourgnounac;1042;22;1064
76;Occitanie;81;2;12;169;Missècle;97;1;98
76;Occitanie;81;1;06;170;Monestiés;1367;13;1380
76;Occitanie;81;2;13;183;Mont-Roc;190;6;196
76;Occitanie;81;1;10;171;Montans;1431;31;1462
76;Occitanie;81;1;05;172;Montauriol;52;0;52
76;Occitanie;81;2;15;173;Montcabrier;304;7;311
76;Occitanie;81;2;20;174;Montdragon;622;5;627
76;Occitanie;81;1;23;175;Montdurausse;425;6;431
76;Occitanie;81;1;23;176;Montels;103;2;105
76;Occitanie;81;2;08;177;Montfa;488;6;494
76;Occitanie;81;1;23;178;Montgaillard;375;13;388
76;Occitanie;81;2;15;179;Montgey;290;7;297
76;Occitanie;81;1;06;180;Montirat;249;9;258
76;Occitanie;81;2;20;181;Montpinier;190;4;194
76;Occitanie;81;2;13;182;Montredon-Labessonnié;2004;42;2046
76;Occitanie;81;1;06;184;Montrosier;33;0;33
76;Occitanie;81;1;23;185;Montvalen;237;3;240
76;Occitanie;81;1;05;186;Moularès;273;5;278
76;Occitanie;81;2;12;187;Moulayrès;208;3;211
76;Occitanie;81;2;14;188;Moulin-Mage;313;3;316
76;Occitanie;81;2;15;189;Mouzens;125;2;127
76;Occitanie;81;1;06;191;Mouzieys-Panens;236;1;237
76;Occitanie;81;1;13;190;Mouzieys-Teulet;514;9;523
76;Occitanie;81;2;14;192;Murat-sur-Vèbre;846;15;861
76;Occitanie;81;2;14;193;Nages;333;4;337
76;Occitanie;81;2;09;195;Navès;687;22;709
76;Occitanie;81;2;16;196;Noailhac;853;20;873
76;Occitanie;81;1;06;197;Noailles;215;6;221
76;Occitanie;81;1;13;198;Orban;333;4;337
76;Occitanie;81;1;05;199;Padiès;191;3;194
76;Occitanie;81;2;19;200;Palleville;435;52;487
76;Occitanie;81;1;05;201;Pampelonne;851;19;870
76;Occitanie;81;1;10;202;Parisot;959;18;977
76;Occitanie;81;1;13;203;Paulinet;547;10;557
76;Occitanie;81;2;16;204;Payrin-Augmontel;2168;37;2205
76;Occitanie;81;2;15;205;Péchaudier;188;9;197
76;Occitanie;81;1;06;206;Penne;579;19;598
76;Occitanie;81;2;20;207;Peyregoux;80;35;115
76;Occitanie;81;1;10;208;Peyrole;580;11;591
76;Occitanie;81;2;17;209;Pont-de-Larn;2832;83;2915
76;Occitanie;81;2;19;210;Poudis;259;7;266
76;Occitanie;81;1;13;211;Poulan-Pouzols;498;7;505
76;Occitanie;81;2;20;212;Prades;130;4;134
76;Occitanie;81;2;20;213;Pratviel;87;2;89
76;Occitanie;81;2;15;214;Puéchoursi;99;1;100
76;Occitanie;81;2;12;215;Puybegon;645;9;654
76;Occitanie;81;2;20;216;Puycalvel;221;2;223
76;Occitanie;81;1;23;217;Puycelsi;449;11;460
76;Occitanie;81;1;89;218;Puygouzon;3461;83;3544
76;Occitanie;81;2;19;219;Puylaurens;3236;74;3310
76;Occitanie;81;1;23;220;Rabastens;5620;144;5764
76;Occitanie;81;2;13;221;Rayssac;242;1;243
76;Occitanie;81;1;13;222;Réalmont;3418;58;3476
76;Occitanie;81;2;17;223;Le Rialet;55;0;55
76;Occitanie;81;1;06;224;Le Riols;103;2;105
76;Occitanie;81;1;10;225;Rivières;1048;20;1068
76;Occitanie;81;2;08;227;Roquecourbe;2206;47;2253
76;Occitanie;81;1;23;228;Roquemaure;450;10;460
76;Occitanie;81;2;15;229;Roquevidal;135;4;139
76;Occitanie;81;1;05;230;Rosières;744;18;762
76;Occitanie;81;2;17;231;Rouairoux;367;12;379
76;Occitanie;81;1;02;232;Rouffiac;622;12;634
76;Occitanie;81;1;06;234;Roussayrolles;80;3;83
76;Occitanie;81;2;18;235;Saint-Affrique-les-Montagnes;729;28;757
76;Occitanie;81;2;21;236;Saint-Agnan;229;7;236
76;Occitanie;81;2;18;237;Saint-Amancet;189;3;192
76;Occitanie;81;2;17;238;Saint-Amans-Soult;1577;118;1695
76;Occitanie;81;2;17;239;Saint-Amans-Valtoret;902;12;914
76;Occitanie;81;1;13;240;Saint-André;100;4;104
76;Occitanie;81;2;18;242;Saint-Avit;265;3;268
76;Occitanie;81;1;23;243;Saint-Beauzile;129;2;131
76;Occitanie;81;1;06;244;Saint-Benoît-de-Carmaux;2165;37;2202
76;Occitanie;81;1;06;245;Saint-Christophe;125;6;131
76;Occitanie;81;1;05;247;Saint-Cirgue;210;4;214
76;Occitanie;81;2;12;248;Saint-Gauzens;855;19;874
76;Occitanie;81;2;20;250;Saint-Genest-de-Contest;289;9;298
76;Occitanie;81;2;19;251;Saint-Germain-des-Prés;915;18;933
76;Occitanie;81;2;08;252;Saint-Germier;160;1;161
76;Occitanie;81;1;05;253;Saint-Grégoire;462;7;469
76;Occitanie;81;1;05;254;Saint-Jean-de-Marcel;368;7;375
76;Occitanie;81;2;21;255;Saint-Jean-de-Rives;497;12;509
76;Occitanie;81;2;08;256;Saint-Jean-de-Vals;75;1;76
76;Occitanie;81;1;22;257;Saint-Juéry;6818;114;6932
76;Occitanie;81;2;20;258;Saint-Julien-du-Puy;431;17;448
76;Occitanie;81;1;05;259;Saint-Julien-Gaulène;215;1;216
76;Occitanie;81;2;21;261;Saint-Lieux-lès-Lavaur;1046;18;1064
76;Occitanie;81;1;06;262;Saint-Marcel-Campes;210;2;212
76;Occitanie;81;1;06;263;Saint-Martin-Laguépie;395;11;406
76;Occitanie;81;1;06;265;Saint-Michel-de-Vax;71;1;72
76;Occitanie;81;1;05;264;Saint-Michel-Labadié;94;2;96
76;Occitanie;81;2;20;266;Saint-Paul-Cap-de-Joux;1117;19;1136
76;Occitanie;81;2;14;267;Saint-Pierre-de-Trivisy;621;12;633
76;Occitanie;81;2;14;268;Saint-Salvi-de-Carcavès;72;4;76
76;Occitanie;81;2;08;269;Saint-Salvy-de-la-Balme;522;8;530
76;Occitanie;81;2;19;270;Saint-Sernin-lès-Lavaur;166;3;169
76;Occitanie;81;2;21;271;Saint-Sulpice-la-Pointe;9117;272;9389
76;Occitanie;81;1;23;272;Saint-Urcisse;212;1;213
76;Occitanie;81;1;23;246;Sainte-Cécile-du-Cayrou;113;2;115
76;Occitanie;81;1;03;326;Sainte-Croix;378;12;390
76;Occitanie;81;1;05;249;Sainte-Gemme;902;13;915
76;Occitanie;81;2;19;273;Saïx;3548;74;3622
76;Occitanie;81;1;02;274;Saliès;824;18;842
76;Occitanie;81;1;06;275;Salles;186;2;188
76;Occitanie;81;1;23;276;Salvagnac;1184;8;1192
76;Occitanie;81;1;05;277;Saussenac;587;9;596
76;Occitanie;81;2;17;278;Sauveterre;167;2;169
76;Occitanie;81;1;23;279;La Sauzière-Saint-Jean;267;7;274
76;Occitanie;81;1;06;280;Le Ségur;258;7;265
76;Occitanie;81;2;20;281;Sémalens;2013;53;2066
76;Occitanie;81;2;14;282;Senaux;33;0;33
76;Occitanie;81;1;10;283;Senouillac;1109;33;1142
76;Occitanie;81;1;02;284;Le Sequestre;1809;28;1837
76;Occitanie;81;1;05;285;Sérénac;487;2;489
76;Occitanie;81;2;20;286;Serviès;637;9;646
76;Occitanie;81;1;13;287;Sieurac;266;2;268
76;Occitanie;81;2;18;288;Sorèze;2836;63;2899
76;Occitanie;81;2;19;289;Soual;2549;40;2589
76;Occitanie;81;1;06;290;Souel;165;2;167
76;Occitanie;81;1;06;291;Taïx;468;6;474
76;Occitanie;81;1;05;292;Tanus;533;17;550
76;Occitanie;81;1;23;293;Tauriac;339;3;342
76;Occitanie;81;1;10;294;Técou;976;17;993
76;Occitanie;81;1;13;295;Teillet;443;5;448
76;Occitanie;81;1;13;233;Terre-de-Bancalié;1710;27;1737
76;Occitanie;81;1;03;297;Terssac;1193;28;1221
76;Occitanie;81;2;15;298;Teulat;496;12;508
76;Occitanie;81;2;20;299;Teyssode;372;15;387
76;Occitanie;81;1;06;300;Tonnac;108;2;110
76;Occitanie;81;1;05;302;Tréban;45;0;45
76;Occitanie;81;1;05;303;Trébas;409;7;416
76;Occitanie;81;1;06;304;Trévien;184;4;188
76;Occitanie;81;2;14;305;Vabre;774;20;794
76;Occitanie;81;1;05;306;Valderiès;852;12;864
76;Occitanie;81;2;16;307;Valdurenque;835;18;853
76;Occitanie;81;1;05;308;Valence-d'Albigeois;1316;28;1344
76;Occitanie;81;1;06;309;Vaour;317;15;332
76;Occitanie;81;2;15;310;Veilhes;144;3;147
76;Occitanie;81;2;20;311;Vénès;813;22;835
76;Occitanie;81;2;18;312;Verdalle;992;175;1167
76;Occitanie;81;1;23;313;Le Verdier;224;6;230
76;Occitanie;81;2;14;314;Viane;534;40;574
76;Occitanie;81;2;20;315;Vielmur-sur-Agout;1464;51;1515
76;Occitanie;81;1;23;316;Vieux;224;5;229
76;Occitanie;81;1;13;317;Villefranche-d'Albigeois;1256;29;1285
76;Occitanie;81;2;15;318;Villeneuve-lès-Lavaur;148;2;150
76;Occitanie;81;1;03;319;Villeneuve-sur-Vère;494;14;508
76;Occitanie;81;1;06;320;Vindrac-Alayrac;150;4;154
76;Occitanie;81;2;17;321;Le Vintrou;85;1;86
76;Occitanie;81;1;06;322;Virac;234;6;240
76;Occitanie;81;2;20;323;Viterbe;361;6;367
76;Occitanie;81;2;15;324;Viviers-lès-Lavaur;221;4;225
76;Occitanie;81;2;19;325;Viviers-lès-Montagnes;1930;36;1966
76;Occitanie;82;1;09;001;Albefeuille-Lagarde;633;18;651
76;Occitanie;82;2;11;002;Albias;3246;55;3301
76;Occitanie;82;1;02;003;Angeville;242;5;247
76;Occitanie;82;1;04;004;Asques;132;2;134
76;Occitanie;82;2;15;005;Aucamville;1446;19;1465
76;Occitanie;82;1;02;006;Auterive;79;3;82
76;Occitanie;82;2;11;007;Auty;145;1;146
76;Occitanie;82;1;04;008;Auvillar;918;42;960
76;Occitanie;82;1;04;009;Balignac;41;2;43
76;Occitanie;82;1;04;010;Bardigues;296;1;297
76;Occitanie;82;1;03;011;Barry-d'Islemade;935;14;949
76;Occitanie;82;1;03;012;Les Barthes;567;8;575
76;Occitanie;82;1;02;013;Beaumont-de-Lomagne;3758;175;3933
76;Occitanie;82;2;15;014;Beaupuy;265;6;271
76;Occitanie;82;1;02;015;Belbèze-en-Lomagne;128;0;128
76;Occitanie;82;1;10;016;Belvèze;209;2;211
76;Occitanie;82;2;09;017;Bessens;1506;7;1513
76;Occitanie;82;2;01;018;Bioule;1113;31;1144
76;Occitanie;82;1;14;019;Boudou;731;16;747
76;Occitanie;82;2;15;020;Bouillac;629;15;644
76;Occitanie;82;1;10;021;Bouloc-en-Quercy;189;3;192
76;Occitanie;82;1;14;022;Bourg-de-Visa;382;10;392
76;Occitanie;82;2;02;023;Bourret;924;11;935
76;Occitanie;82;1;14;024;Brassac;248;3;251
76;Occitanie;82;2;09;025;Bressols;3697;104;3801
76;Occitanie;82;2;13;026;Bruniquel;608;9;617
76;Occitanie;82;2;15;027;Campsas;1368;22;1390
76;Occitanie;82;2;15;028;Canals;764;10;774
76;Occitanie;82;2;12;029;Castanet;289;1;290
76;Occitanie;82;1;02;030;Castelferrus;473;3;476
76;Occitanie;82;1;04;031;Castelmayran;1210;16;1226
76;Occitanie;82;1;14;032;Castelsagrat;569;14;583
76;Occitanie;82;1;03;033;Castelsarrasin;13944;323;14267
76;Occitanie;82;1;04;034;Castéra-Bouzet;109;3;112
76;Occitanie;82;1;04;035;Caumont;318;5;323
76;Occitanie;82;1;02;036;Le Causé;137;2;139
76;Occitanie;82;2;01;037;Caussade;6863;241;7104
76;Occitanie;82;2;12;038;Caylus;1446;12;1458
76;Occitanie;82;2;11;039;Cayrac;549;22;571
76;Occitanie;82;2;12;040;Cayriech;277;9;286
76;Occitanie;82;2;12;041;Cazals;225;3;228
76;Occitanie;82;1;10;042;Cazes-Mondenard;1185;21;1206
76;Occitanie;82;2;02;043;Comberouger;280;10;290
76;Occitanie;82;2;13;044;Corbarieu;1654;52;1706
76;Occitanie;82;1;02;045;Cordes-Tolosannes;353;6;359
76;Occitanie;82;1;02;046;Coutures;107;0;107
76;Occitanie;82;1;02;047;Cumont;52;0;52
76;Occitanie;82;2;15;048;Dieupentale;1700;18;1718
76;Occitanie;82;1;04;049;Donzac;1045;13;1058
76;Occitanie;82;1;04;050;Dunes;1200;24;1224
76;Occitanie;82;1;10;051;Durfort-Lacapelette;847;91;938
76;Occitanie;82;2;02;052;Escatalens;1097;91;1188
76;Occitanie;82;1;02;053;Escazeaux;289;3;292
76;Occitanie;82;1;14;054;Espalais;388;7;395
76;Occitanie;82;1;02;055;Esparsac;250;8;258
76;Occitanie;82;2;12;056;Espinas;174;4;178
76;Occitanie;82;2;15;057;Fabas;621;14;635
76;Occitanie;82;1;02;058;Fajolles;98;2;100
76;Occitanie;82;1;02;059;Faudoas;289;10;299
76;Occitanie;82;1;10;060;Fauroux;225;5;230
76;Occitanie;82;2;12;061;Féneyrols;147;2;149
76;Occitanie;82;2;09;062;Finhan;1525;19;1544
76;Occitanie;82;1;02;063;Garganvillar;677;13;690
76;Occitanie;82;1;02;064;Gariès;114;1;115
76;Occitanie;82;1;14;065;Gasques;412;9;421
76;Occitanie;82;2;13;066;Génébrières;633;13;646
76;Occitanie;82;1;04;067;Gensac;114;1;115
76;Occitanie;82;1;02;068;Gimat;230;8;238
76;Occitanie;82;2;12;069;Ginals;207;6;213
76;Occitanie;82;1;02;070;Glatens;74;2;76
76;Occitanie;82;1;02;071;Goas;37;2;39
76;Occitanie;82;1;14;072;Golfech;985;25;1010
76;Occitanie;82;1;14;073;Goudourville;955;32;987
76;Occitanie;82;1;04;074;Gramont;141;5;146
76;Occitanie;82;2;15;075;Grisolles;4115;54;4169
76;Occitanie;82;2;11;076;L' Honor-de-Cos;1577;35;1612
76;Occitanie;82;2;10;077;Labarthe;394;5;399
76;Occitanie;82;2;12;078;Labastide-de-Penne;129;0;129
76;Occitanie;82;1;03;080;Labastide-du-Temple;1125;27;1152
76;Occitanie;82;2;13;079;Labastide-Saint-Pierre;3742;96;3838
76;Occitanie;82;1;02;081;Labourgade;183;3;186
76;Occitanie;82;2;12;082;Lacapelle-Livron;200;6;206
76;Occitanie;82;1;04;083;Lachapelle;118;1;119
76;Occitanie;82;1;10;084;Lacour;171;5;176
76;Occitanie;82;2;09;085;Lacourt-Saint-Pierre;1201;11;1212
76;Occitanie;82;1;02;086;Lafitte;228;3;231
76;Occitanie;82;2;10;087;Lafrançaise;2850;66;2916
76;Occitanie;82;2;12;088;Laguépie;608;13;621
76;Occitanie;82;1;14;089;Lamagistère;1154;18;1172
76;Occitanie;82;2;11;090;Lamothe-Capdeville;1073;30;1103
76;Occitanie;82;1;02;091;Lamothe-Cumont;123;3;126
76;Occitanie;82;2;12;092;Lapenche;276;3;279
76;Occitanie;82;1;02;093;Larrazet;687;8;695
76;Occitanie;82;1;10;094;Lauzerte;1454;17;1471
76;Occitanie;82;2;12;095;Lavaurette;218;7;225
76;Occitanie;82;1;04;097;Lavit;1589;18;1607
76;Occitanie;82;2;13;098;Léojac;1284;40;1324
76;Occitanie;82;1;05;099;Lizac;510;11;521
76;Occitanie;82;2;12;100;Loze;144;3;147
76;Occitanie;82;1;04;101;Malause;1158;26;1184
76;Occitanie;82;1;04;102;Mansonville;288;4;292
76;Occitanie;82;1;02;103;Marignac;111;6;117
76;Occitanie;82;1;04;104;Marsac;176;5;181
76;Occitanie;82;2;15;105;Mas-Grenier;1322;18;1340
76;Occitanie;82;1;02;106;Maubec;135;1;136
76;Occitanie;82;1;04;107;Maumusson;48;1;49
76;Occitanie;82;1;03;108;Meauzac;1338;27;1365
76;Occitanie;82;1;04;109;Merles;202;13;215
76;Occitanie;82;2;11;110;Mirabel;1036;18;1054
76;Occitanie;82;1;10;111;Miramont-de-Quercy;323;9;332
76;Occitanie;82;1;05;112;Moissac;13039;339;13378
76;Occitanie;82;2;11;113;Molières;1174;24;1198
76;Occitanie;82;2;09;114;Monbéqui;634;7;641
76;Occitanie;82;2;13;115;Monclar-de-Quercy;1993;18;2011
76;Occitanie;82;1;10;116;Montagudet;197;1;198
76;Occitanie;82;1;10;117;Montaigu-de-Quercy;1323;25;1348
76;Occitanie;82;1;02;118;Montaïn;105;1;106
76;Occitanie;82;2;11;119;Montalzat;658;19;677
76;Occitanie;82;2;11;120;Montastruc;311;5;316
76;Occitanie;82;2;99;121;Montauban;60810;1480;62290
76;Occitanie;82;1;10;122;Montbarla;179;3;182
76;Occitanie;82;2;09;123;Montbartier;1331;21;1352
76;Occitanie;82;2;09;124;Montbeton;4279;80;4359
76;Occitanie;82;2;09;125;Montech;6349;120;6469
76;Occitanie;82;2;12;126;Monteils;1361;68;1429
76;Occitanie;82;1;05;127;Montesquieu;759;18;777
76;Occitanie;82;2;11;128;Montfermier;105;3;108
76;Occitanie;82;1;04;129;Montgaillard;144;4;148
76;Occitanie;82;1;14;130;Montjoi;165;1;166
76;Occitanie;82;2;11;131;Montpezat-de-Quercy;1567;35;1602
76;Occitanie;82;2;01;132;Montricoux;1207;11;1218
76;Occitanie;82;2;12;133;Mouillac;98;1;99
76;Occitanie;82;2;01;134;Nègrepelisse;5628;79;5707
76;Occitanie;82;2;13;135;Nohic;1369;28;1397
76;Occitanie;82;2;13;136;Orgueil;1658;32;1690
76;Occitanie;82;2;12;137;Parisot;600;7;607
76;Occitanie;82;1;14;138;Perville;143;1;144
76;Occitanie;82;1;04;139;Le Pin;123;3;126
76;Occitanie;82;2;11;140;Piquecos;434;3;437
76;Occitanie;82;1;14;141;Pommevic;547;4;551
76;Occitanie;82;2;15;142;Pompignan;1465;19;1484
76;Occitanie;82;1;04;143;Poupas;82;0;82
76;Occitanie;82;2;10;144;Puycornet;731;11;742
76;Occitanie;82;1;04;146;Puygaillard-de-Lomagne;69;2;71
76;Occitanie;82;2;13;145;Puygaillard-de-Quercy;391;4;395
76;Occitanie;82;2;12;147;Puylagarde;334;8;342
76;Occitanie;82;2;12;148;Puylaroque;698;25;723
76;Occitanie;82;2;11;149;Réalville;1910;42;1952
76;Occitanie;82;2;13;150;Reyniès;860;28;888
76;Occitanie;82;1;10;151;Roquecor;408;10;418
76;Occitanie;82;1;04;152;Saint-Aignan;405;11;416
76;Occitanie;82;1;10;154;Saint-Amans-de-Pellagal;215;5;220
76;Occitanie;82;1;10;153;Saint-Amans-du-Pech;216;1;217
76;Occitanie;82;2;12;155;Saint-Antonin-Noble-Val;1852;45;1897
76;Occitanie;82;1;02;156;Saint-Arroumex;152;3;155
76;Occitanie;82;1;10;157;Saint-Beauzeil;98;2;100
76;Occitanie;82;1;04;158;Saint-Cirice;155;5;160
76;Occitanie;82;2;12;159;Saint-Cirq;548;17;565
76;Occitanie;82;1;14;160;Saint-Clair;273;8;281
76;Occitanie;82;2;01;161;Saint-Étienne-de-Tulmont;3788;74;3862
76;Occitanie;82;2;12;162;Saint-Georges;261;7;268
76;Occitanie;82;1;04;163;Saint-Jean-du-Bouzet;52;0;52
76;Occitanie;82;1;04;165;Saint-Loup;520;4;524
76;Occitanie;82;1;04;166;Saint-Michel;255;3;258
76;Occitanie;82;2;13;167;Saint-Nauphary;1843;40;1883
76;Occitanie;82;1;14;168;Saint-Nazaire-de-Valentane;351;3;354
76;Occitanie;82;1;04;169;Saint-Nicolas-de-la-Grave;2260;29;2289
76;Occitanie;82;1;14;170;Saint-Paul-d'Espis;578;16;594
76;Occitanie;82;2;02;171;Saint-Porquier;1404;23;1427
76;Occitanie;82;2;12;172;Saint-Projet;283;9;292
76;Occitanie;82;2;15;173;Saint-Sardos;1143;14;1157
76;Occitanie;82;2;11;174;Saint-Vincent-d'Autéjac;285;2;287
76;Occitanie;82;1;14;175;Saint-Vincent-Lespinasse;258;3;261
76;Occitanie;82;1;10;164;Sainte-Juliette;132;3;135
76;Occitanie;82;2;13;176;La Salvetat-Belmontet;818;12;830
76;Occitanie;82;1;10;177;Sauveterre;170;3;173
76;Occitanie;82;2;15;178;Savenès;803;17;820
76;Occitanie;82;2;12;179;Septfonds;2212;49;2261
76;Occitanie;82;1;02;180;Sérignac;539;4;543
76;Occitanie;82;1;04;181;Sistels;211;3;214
76;Occitanie;82;1;10;182;Touffailles;346;3;349
76;Occitanie;82;1;10;183;Tréjouls;242;10;252
76;Occitanie;82;2;01;184;Vaïssac;870;10;880
76;Occitanie;82;1;10;185;Valeilles;248;6;254
76;Occitanie;82;1;14;186;Valence;5221;156;5377
76;Occitanie;82;2;12;187;Varen;654;15;669
76;Occitanie;82;2;13;188;Varennes;591;15;606
76;Occitanie;82;2;10;189;Vazerac;722;13;735
76;Occitanie;82;2;15;190;Verdun-sur-Garonne;4764;65;4829
76;Occitanie;82;2;12;191;Verfeil;395;3;398
76;Occitanie;82;2;13;192;Verlhac-Tescou;519;14;533
76;Occitanie;82;1;02;193;Vigueron;134;3;137
76;Occitanie;82;2;03;096;La Ville-Dieu-du-Temple;3191;43;3234
76;Occitanie;82;2;13;194;Villebrumier;1387;19;1406
76;Occitanie;82;2;11;195;Villemade;744;25;769
93;Provence-Alpes-Côte d'Azur;83;1;14;001;Les Adrets-de-l'Estérel;2750;65;2815
93;Provence-Alpes-Côte d'Azur;83;3;04;002;Aiguines;276;2;278
93;Provence-Alpes-Côte d'Azur;83;1;04;003;Ampus;934;24;958
93;Provence-Alpes-Côte d'Azur;83;1;23;004;Les Arcs;7064;173;7237
93;Provence-Alpes-Côte d'Azur;83;3;04;005;Artignosc-sur-Verdon;314;8;322
93;Provence-Alpes-Côte d'Azur;83;3;13;006;Artigues;260;7;267
93;Provence-Alpes-Côte d'Azur;83;3;04;007;Aups;2228;35;2263
93;Provence-Alpes-Côte d'Azur;83;1;11;008;Bagnols-en-Forêt;2788;56;2844
93;Provence-Alpes-Côte d'Azur;83;2;10;009;Bandol;8409;145;8554
93;Provence-Alpes-Côte d'Azur;83;1;04;010;Bargème;217;1;218
93;Provence-Alpes-Côte d'Azur;83;1;04;011;Bargemon;1365;22;1387
93;Provence-Alpes-Côte d'Azur;83;3;13;012;Barjols;2979;41;3020
93;Provence-Alpes-Côte d'Azur;83;1;04;013;La Bastide;205;1;206
93;Provence-Alpes-Côte d'Azur;83;3;04;014;Baudinard-sur-Verdon;224;4;228
93;Provence-Alpes-Côte d'Azur;83;3;04;015;Bauduen;318;4;322
93;Provence-Alpes-Côte d'Azur;83;2;12;016;Le Beausset;9736;171;9907
93;Provence-Alpes-Côte d'Azur;83;2;18;017;Belgentier;2429;32;2461
93;Provence-Alpes-Côte d'Azur;83;3;09;018;Besse-sur-Issole;3039;46;3085
93;Provence-Alpes-Côte d'Azur;83;2;02;019;Bormes-les-Mimosas;8102;116;8218
93;Provence-Alpes-Côte d'Azur;83;1;04;020;Le Bourguet;35;1;36
93;Provence-Alpes-Côte d'Azur;83;3;13;021;Bras;2698;53;2751
93;Provence-Alpes-Côte d'Azur;83;1;04;022;Brenon;29;0;29
93;Provence-Alpes-Côte d'Azur;83;3;01;023;Brignoles;17179;353;17532
93;Provence-Alpes-Côte d'Azur;83;3;13;025;Brue-Auriac;1376;25;1401
93;Provence-Alpes-Côte d'Azur;83;3;09;026;Cabasse;1947;37;1984
93;Provence-Alpes-Côte d'Azur;83;2;12;027;La Cadière-d'Azur;5550;98;5648
93;Provence-Alpes-Côte d'Azur;83;1;04;028;Callas;1909;36;1945
93;Provence-Alpes-Côte d'Azur;83;1;11;029;Callian;3206;60;3266
93;Provence-Alpes-Côte d'Azur;83;3;07;030;Camps-la-Source;1906;38;1944
93;Provence-Alpes-Côte d'Azur;83;3;09;031;Le Cannet-des-Maures;4300;59;4359
93;Provence-Alpes-Côte d'Azur;83;3;01;032;Carcès;3447;82;3529
93;Provence-Alpes-Côte d'Azur;83;3;07;033;Carnoules;3448;34;3482
93;Provence-Alpes-Côte d'Azur;83;2;06;034;Carqueiranne;9700;168;9868
93;Provence-Alpes-Côte d'Azur;83;2;12;035;Le Castellet;3886;41;3927
93;Provence-Alpes-Côte d'Azur;83;1;15;036;Cavalaire-sur-Mer;7385;84;7469
93;Provence-Alpes-Côte d'Azur;83;3;01;037;La Celle;1477;56;1533
93;Provence-Alpes-Côte d'Azur;83;1;04;038;Châteaudouble;473;12;485
93;Provence-Alpes-Côte d'Azur;83;3;13;039;Châteauvert;145;37;182
93;Provence-Alpes-Côte d'Azur;83;1;04;040;Châteauvieux;83;1;84
93;Provence-Alpes-Côte d'Azur;83;1;04;041;Claviers;692;13;705
93;Provence-Alpes-Côte d'Azur;83;1;15;042;Cogolin;11736;256;11992
93;Provence-Alpes-Côte d'Azur;83;2;09;043;Collobrières;1908;89;1997
93;Provence-Alpes-Côte d'Azur;83;1;04;044;Comps-sur-Artuby;364;5;369
93;Provence-Alpes-Côte d'Azur;83;3;01;045;Correns;903;8;911
93;Provence-Alpes-Côte d'Azur;83;3;01;046;Cotignac;2163;40;2203
93;Provence-Alpes-Côte d'Azur;83;2;02;047;La Crau;18288;418;18706
93;Provence-Alpes-Côte d'Azur;83;1;15;048;La Croix-Valmer;3780;121;3901
93;Provence-Alpes-Côte d'Azur;83;2;18;049;Cuers;11425;132;11557
93;Provence-Alpes-Côte d'Azur;83;1;03;050;Draguignan;39340;894;40234
93;Provence-Alpes-Côte d'Azur;83;3;01;051;Entrecasteaux;1123;25;1148
93;Provence-Alpes-Côte d'Azur;83;3;13;052;Esparron;356;5;361
93;Provence-Alpes-Côte d'Azur;83;2;10;053;Évenos;2405;51;2456
93;Provence-Alpes-Côte d'Azur;83;2;18;054;La Farlède;9083;112;9195
93;Provence-Alpes-Côte d'Azur;83;1;11;055;Fayence;5792;89;5881
93;Provence-Alpes-Côte d'Azur;83;1;04;056;Figanières;2605;54;2659
93;Provence-Alpes-Côte d'Azur;83;3;09;057;Flassans-sur-Issole;3533;66;3599
93;Provence-Alpes-Côte d'Azur;83;1;04;058;Flayosc;4294;102;4396
93;Provence-Alpes-Côte d'Azur;83;3;07;059;Forcalqueiret;2990;47;3037
93;Provence-Alpes-Côte d'Azur;83;3;04;060;Fox-Amphoux;459;4;463
93;Provence-Alpes-Côte d'Azur;83;1;96;061;Fréjus;52672;840;53512
93;Provence-Alpes-Côte d'Azur;83;2;06;062;La Garde;25126;354;25480
93;Provence-Alpes-Côte d'Azur;83;1;09;063;La Garde-Freinet;1887;33;1920
93;Provence-Alpes-Côte d'Azur;83;3;07;064;Garéoult;5330;99;5429
93;Provence-Alpes-Côte d'Azur;83;1;15;065;Gassin;2560;63;2623
93;Provence-Alpes-Côte d'Azur;83;3;13;066;Ginasservis;1799;35;1834
93;Provence-Alpes-Côte d'Azur;83;3;09;067;Gonfaron;4318;62;4380
93;Provence-Alpes-Côte d'Azur;83;1;15;068;Grimaud;4541;60;4601
93;Provence-Alpes-Côte d'Azur;83;2;97;069;Hyères;55588;983;56571
93;Provence-Alpes-Côte d'Azur;83;2;02;070;Le Lavandou;5985;62;6047
93;Provence-Alpes-Côte d'Azur;83;2;02;071;La Londe-les-Maures;10297;132;10429
93;Provence-Alpes-Côte d'Azur;83;1;23;072;Lorgues;8990;288;9278
93;Provence-Alpes-Côte d'Azur;83;3;09;073;Le Luc;11067;109;11176
93;Provence-Alpes-Côte d'Azur;83;1;04;074;La Martre;211;5;216
93;Provence-Alpes-Côte d'Azur;83;3;09;075;Les Mayons;644;12;656
93;Provence-Alpes-Côte d'Azur;83;3;07;076;Mazaugues;889;13;902
93;Provence-Alpes-Côte d'Azur;83;3;07;077;Méounes-lès-Montrieux;2184;20;2204
93;Provence-Alpes-Côte d'Azur;83;3;04;078;Moissac-Bellevue;291;7;298
93;Provence-Alpes-Côte d'Azur;83;1;15;079;La Môle;1432;25;1457
93;Provence-Alpes-Côte d'Azur;83;1;11;080;Mons;817;17;834
93;Provence-Alpes-Côte d'Azur;83;1;11;081;Montauroux;6411;128;6539
93;Provence-Alpes-Côte d'Azur;83;1;04;082;Montferrat;1536;23;1559
93;Provence-Alpes-Côte d'Azur;83;3;01;083;Montfort-sur-Argens;1349;17;1366
93;Provence-Alpes-Côte d'Azur;83;3;04;084;Montmeyan;551;3;554
93;Provence-Alpes-Côte d'Azur;83;1;04;085;La Motte;2845;51;2896
93;Provence-Alpes-Côte d'Azur;83;1;23;086;Le Muy;9134;246;9380
93;Provence-Alpes-Côte d'Azur;83;3;12;087;Nans-les-Pins;4627;82;4709
93;Provence-Alpes-Côte d'Azur;83;3;07;088;Néoules;2712;54;2766
93;Provence-Alpes-Côte d'Azur;83;3;13;089;Ollières;646;22;668
93;Provence-Alpes-Côte d'Azur;83;2;10;090;Ollioules;13702;270;13972
93;Provence-Alpes-Côte d'Azur;83;2;07;091;Pierrefeu-du-Var;6045;104;6149
93;Provence-Alpes-Côte d'Azur;83;3;09;092;Pignans;4201;45;4246
93;Provence-Alpes-Côte d'Azur;83;3;12;093;Plan-d'Aups-Sainte-Baume;2158;26;2184
93;Provence-Alpes-Côte d'Azur;83;1;15;094;Le Plan-de-la-Tour;2827;48;2875
93;Provence-Alpes-Côte d'Azur;83;3;13;095;Pontevès;748;18;766
93;Provence-Alpes-Côte d'Azur;83;3;13;096;Pourcieux;1564;22;1586
93;Provence-Alpes-Côte d'Azur;83;3;13;097;Pourrières;5155;89;5244
93;Provence-Alpes-Côte d'Azur;83;2;06;098;Le Pradet;10249;166;10415
93;Provence-Alpes-Côte d'Azur;83;1;11;099;Puget-sur-Argens;8097;121;8218
93;Provence-Alpes-Côte d'Azur;83;3;07;100;Puget-Ville;4280;50;4330
93;Provence-Alpes-Côte d'Azur;83;1;15;101;Ramatuelle;2070;46;2116
93;Provence-Alpes-Côte d'Azur;83;1;02;152;Rayol-Canadel-sur-Mer;711;12;723
93;Provence-Alpes-Côte d'Azur;83;3;04;102;Régusse;2613;14;2627
93;Provence-Alpes-Côte d'Azur;83;2;21;103;Le Revest-les-Eaux;3865;88;3953
93;Provence-Alpes-Côte d'Azur;83;3;13;104;Rians;4232;62;4294
93;Provence-Alpes-Côte d'Azur;83;2;12;105;Riboux;46;0;46
93;Provence-Alpes-Côte d'Azur;83;3;07;106;Rocbaron;5033;63;5096
93;Provence-Alpes-Côte d'Azur;83;1;04;109;La Roque-Esclapon;267;0;267
93;Provence-Alpes-Côte d'Azur;83;1;11;107;Roquebrune-sur-Argens;14251;208;14459
93;Provence-Alpes-Côte d'Azur;83;3;07;108;La Roquebrussanne;2455;45;2500
93;Provence-Alpes-Côte d'Azur;83;3;01;110;Rougiers;1656;30;1686
93;Provence-Alpes-Côte d'Azur;83;1;01;154;Saint-Antonin-du-Var;741;13;754
93;Provence-Alpes-Côte d'Azur;83;2;12;112;Saint-Cyr-sur-Mer;11761;195;11956
93;Provence-Alpes-Côte d'Azur;83;3;13;113;Saint-Julien;2409;41;2450
93;Provence-Alpes-Côte d'Azur;83;2;17;153;Saint-Mandrier-sur-Mer;5862;69;5931
93;Provence-Alpes-Côte d'Azur;83;3;13;114;Saint-Martin-de-Pallières;244;4;248
93;Provence-Alpes-Côte d'Azur;83;3;13;116;Saint-Maximin-la-Sainte-Baume;16433;455;16888
93;Provence-Alpes-Côte d'Azur;83;1;11;117;Saint-Paul-en-Forêt;1730;43;1773
93;Provence-Alpes-Côte d'Azur;83;1;14;118;Saint-Raphaël;35042;571;35613
93;Provence-Alpes-Côte d'Azur;83;1;15;119;Saint-Tropez;4352;87;4439
93;Provence-Alpes-Côte d'Azur;83;3;12;120;Saint-Zacharie;5604;78;5682
93;Provence-Alpes-Côte d'Azur;83;3;07;111;Sainte-Anastasie-sur-Issole;1973;24;1997
93;Provence-Alpes-Côte d'Azur;83;1;15;115;Sainte-Maxime;13968;215;14183
93;Provence-Alpes-Côte d'Azur;83;1;04;121;Salernes;3840;78;3918
93;Provence-Alpes-Côte d'Azur;83;3;04;122;Les Salles-sur-Verdon;245;4;249
93;Provence-Alpes-Côte d'Azur;83;2;10;123;Sanary-sur-Mer;16605;238;16843
93;Provence-Alpes-Côte d'Azur;83;1;11;124;Seillans;2669;31;2700
93;Provence-Alpes-Côte d'Azur;83;3;13;125;Seillons-Source-d'Argens;2468;37;2505
93;Provence-Alpes-Côte d'Azur;83;2;98;126;La Seyne-sur-Mer;63936;781;64717
93;Provence-Alpes-Côte d'Azur;83;2;12;127;Signes;2844;44;2888
93;Provence-Alpes-Côte d'Azur;83;1;04;128;Sillans-la-Cascade;752;55;807
93;Provence-Alpes-Côte d'Azur;83;2;17;129;Six-Fours-les-Plages;32829;593;33422
93;Provence-Alpes-Côte d'Azur;83;2;18;130;Solliès-Pont;11149;161;11310
93;Provence-Alpes-Côte d'Azur;83;2;18;131;Solliès-Toucas;5719;108;5827
93;Provence-Alpes-Côte d'Azur;83;2;18;132;Solliès-Ville;2450;44;2494
93;Provence-Alpes-Côte d'Azur;83;1;11;133;Tanneron;1666;33;1699
93;Provence-Alpes-Côte d'Azur;83;1;23;134;Taradeau;1803;34;1837
93;Provence-Alpes-Côte d'Azur;83;3;04;135;Tavernes;1399;15;1414
93;Provence-Alpes-Côte d'Azur;83;3;09;136;Le Thoronet;2462;37;2499
93;Provence-Alpes-Côte d'Azur;83;2;99;137;Toulon;171953;1807;173760
93;Provence-Alpes-Côte d'Azur;83;1;11;138;Tourrettes;2884;51;2935
93;Provence-Alpes-Côte d'Azur;83;3;04;139;Tourtour;581;14;595
93;Provence-Alpes-Côte d'Azur;83;3;01;140;Tourves;5025;72;5097
93;Provence-Alpes-Côte d'Azur;83;1;03;141;Trans-en-Provence;5847;136;5983
93;Provence-Alpes-Côte d'Azur;83;1;04;142;Trigance;191;3;194
93;Provence-Alpes-Côte d'Azur;83;3;01;143;Le Val;4295;96;4391
93;Provence-Alpes-Côte d'Azur;83;2;21;144;La Valette-du-Var;23884;247;24131
93;Provence-Alpes-Côte d'Azur;83;3;13;145;Varages;1178;15;1193
93;Provence-Alpes-Côte d'Azur;83;3;13;146;La Verdière;1601;14;1615
93;Provence-Alpes-Côte d'Azur;83;3;04;147;Vérignon;10;1;11
93;Provence-Alpes-Côte d'Azur;83;1;23;148;Vidauban;11907;104;12011
93;Provence-Alpes-Côte d'Azur;83;3;04;149;Villecroze;1463;28;1491
93;Provence-Alpes-Côte d'Azur;83;3;13;150;Vinon-sur-Verdon;4233;88;4321
93;Provence-Alpes-Côte d'Azur;83;3;01;151;Vins-sur-Caramy;1014;18;1032
93;Provence-Alpes-Côte d'Azur;84;3;10;001;Althen-des-Paluds;2823;45;2868
93;Provence-Alpes-Côte d'Azur;84;1;13;002;Ansouis;1023;47;1070
93;Provence-Alpes-Côte d'Azur;84;1;01;003;Apt;11425;237;11662
93;Provence-Alpes-Côte d'Azur;84;3;06;004;Aubignan;5661;91;5752
93;Provence-Alpes-Côte d'Azur;84;3;12;005;Aurel;206;2;208
93;Provence-Alpes-Côte d'Azur;84;1;01;006;Auribeau;71;4;75
93;Provence-Alpes-Côte d'Azur;84;2;99;007;Avignon;91921;1750;93671
93;Provence-Alpes-Côte d'Azur;84;3;16;008;Le Barroux;629;52;681
93;Provence-Alpes-Côte d'Azur;84;1;13;009;La Bastide-des-Jourdans;1566;93;1659
93;Provence-Alpes-Côte d'Azur;84;1;13;010;La Bastidonne;817;21;838
93;Provence-Alpes-Côte d'Azur;84;3;12;011;Le Beaucet;351;9;360
93;Provence-Alpes-Côte d'Azur;84;3;10;012;Beaumes-de-Venise;2409;27;2436
93;Provence-Alpes-Côte d'Azur;84;1;01;013;Beaumettes;255;3;258
93;Provence-Alpes-Côte d'Azur;84;1;13;014;Beaumont-de-Pertuis;1137;15;1152
93;Provence-Alpes-Côte d'Azur;84;3;16;015;Beaumont-du-Ventoux;280;3;283
93;Provence-Alpes-Côte d'Azur;84;2;15;016;Bédarrides;5171;74;5245
93;Provence-Alpes-Côte d'Azur;84;3;12;017;Bédoin;3099;69;3168
93;Provence-Alpes-Côte d'Azur;84;3;12;018;Blauvac;511;8;519
93;Provence-Alpes-Côte d'Azur;84;3;05;019;Bollène;13504;240;13744
93;Provence-Alpes-Côte d'Azur;84;1;01;020;Bonnieux;1315;25;1340
93;Provence-Alpes-Côte d'Azur;84;3;16;021;Brantes;86;3;89
93;Provence-Alpes-Côte d'Azur;84;3;16;022;Buisson;298;9;307
93;Provence-Alpes-Côte d'Azur;84;1;01;023;Buoux;68;5;73
93;Provence-Alpes-Côte d'Azur;84;1;13;024;Cabrières-d'Aigues;955;21;976
93;Provence-Alpes-Côte d'Azur;84;1;08;025;Cabrières-d'Avignon;1816;37;1853
93;Provence-Alpes-Côte d'Azur;84;1;08;026;Cadenet;4190;76;4266
93;Provence-Alpes-Côte d'Azur;84;3;11;027;Caderousse;2667;48;2715
93;Provence-Alpes-Côte d'Azur;84;3;16;028;Cairanne;1072;13;1085
93;Provence-Alpes-Côte d'Azur;84;3;16;029;Camaret-sur-Aigues;4543;112;4655
93;Provence-Alpes-Côte d'Azur;84;3;10;030;Caromb;3348;58;3406
93;Provence-Alpes-Côte d'Azur;84;3;06;031;Carpentras;28309;835;29144
93;Provence-Alpes-Côte d'Azur;84;1;01;032;Caseneuve;489;8;497
93;Provence-Alpes-Côte d'Azur;84;1;01;033;Castellet-en-Luberon;131;4;135
93;Provence-Alpes-Côte d'Azur;84;2;07;034;Caumont-sur-Durance;4885;99;4984
93;Provence-Alpes-Côte d'Azur;84;1;07;035;Cavaillon;26641;434;27075
93;Provence-Alpes-Côte d'Azur;84;2;09;036;Châteauneuf-de-Gadagne;3311;73;3384
93;Provence-Alpes-Côte d'Azur;84;3;15;037;Châteauneuf-du-Pape;2116;31;2147
93;Provence-Alpes-Côte d'Azur;84;1;08;038;Cheval-Blanc;4276;75;4351
93;Provence-Alpes-Côte d'Azur;84;2;15;039;Courthézon;5639;73;5712
93;Provence-Alpes-Côte d'Azur;84;3;16;040;Crestet;412;17;429
93;Provence-Alpes-Côte d'Azur;84;3;12;041;Crillon-le-Brave;470;18;488
93;Provence-Alpes-Côte d'Azur;84;1;08;042;Cucuron;1766;33;1799
93;Provence-Alpes-Côte d'Azur;84;2;10;043;Entraigues-sur-la-Sorgue;8472;120;8592
93;Provence-Alpes-Côte d'Azur;84;3;16;044;Entrechaux;1112;33;1145
93;Provence-Alpes-Côte d'Azur;84;3;16;045;Faucon;433;8;441
93;Provence-Alpes-Côte d'Azur;84;3;12;046;Flassan;465;13;478
93;Provence-Alpes-Côte d'Azur;84;2;09;139;Fontaine-de-Vaucluse;604;16;620
93;Provence-Alpes-Côte d'Azur;84;1;01;047;Gargas;3039;48;3087
93;Provence-Alpes-Côte d'Azur;84;1;01;048;Gignac;68;4;72
93;Provence-Alpes-Côte d'Azur;84;3;16;049;Gigondas;501;12;513
93;Provence-Alpes-Côte d'Azur;84;1;01;050;Gordes;1773;36;1809
93;Provence-Alpes-Côte d'Azur;84;1;01;051;Goult;1099;27;1126
93;Provence-Alpes-Côte d'Azur;84;1;13;052;Grambois;1251;30;1281
93;Provence-Alpes-Côte d'Azur;84;3;17;053;Grillon;1750;31;1781
93;Provence-Alpes-Côte d'Azur;84;2;09;054;L' Isle-sur-la-Sorgue;19421;470;19891
93;Provence-Alpes-Côte d'Azur;84;2;14;055;Jonquerettes;1507;29;1536
93;Provence-Alpes-Côte d'Azur;84;3;15;056;Jonquières;5399;63;5462
93;Provence-Alpes-Côte d'Azur;84;1;01;057;Joucas;338;5;343
93;Provence-Alpes-Côte d'Azur;84;1;01;058;Lacoste;409;7;416
93;Provence-Alpes-Côte d'Azur;84;3;16;059;Lafare;116;1;117
93;Provence-Alpes-Côte d'Azur;84;1;01;060;Lagarde-d'Apt;36;0;36
93;Provence-Alpes-Côte d'Azur;84;3;05;061;Lagarde-Paréol;330;15;345
93;Provence-Alpes-Côte d'Azur;84;1;08;062;Lagnes;1635;32;1667
93;Provence-Alpes-Côte d'Azur;84;3;05;063;Lamotte-du-Rhône;398;1;399
93;Provence-Alpes-Côte d'Azur;84;3;05;064;Lapalud;3805;68;3873
93;Provence-Alpes-Côte d'Azur;84;1;08;065;Lauris;3856;67;3923
93;Provence-Alpes-Côte d'Azur;84;1;01;066;Lioux;288;4;292
93;Provence-Alpes-Côte d'Azur;84;3;06;067;Loriol-du-Comtat;2603;48;2651
93;Provence-Alpes-Côte d'Azur;84;1;08;068;Lourmarin;1076;23;1099
93;Provence-Alpes-Côte d'Azur;84;3;16;069;Malaucène;2903;52;2955
93;Provence-Alpes-Côte d'Azur;84;3;12;070;Malemort-du-Comtat;1782;22;1804
93;Provence-Alpes-Côte d'Azur;84;1;08;071;Maubec;1930;48;1978
93;Provence-Alpes-Côte d'Azur;84;3;12;072;Mazan;6036;153;6189
93;Provence-Alpes-Côte d'Azur;84;1;01;073;Ménerbes;990;17;1007
93;Provence-Alpes-Côte d'Azur;84;1;08;074;Mérindol;2097;23;2120
93;Provence-Alpes-Côte d'Azur;84;3;12;075;Méthamis;436;3;439
93;Provence-Alpes-Côte d'Azur;84;1;13;076;Mirabeau;1288;38;1326
93;Provence-Alpes-Côte d'Azur;84;3;12;077;Modène;453;7;460
93;Provence-Alpes-Côte d'Azur;84;3;05;078;Mondragon;3792;64;3856
93;Provence-Alpes-Côte d'Azur;84;3;12;079;Monieux;317;5;322
93;Provence-Alpes-Côte d'Azur;84;3;10;080;Monteux;12909;222;13131
93;Provence-Alpes-Côte d'Azur;84;2;04;081;Morières-lès-Avignon;8317;123;8440
93;Provence-Alpes-Côte d'Azur;84;3;12;082;Mormoiron;1873;49;1922
93;Provence-Alpes-Côte d'Azur;84;3;05;083;Mornas;2407;46;2453
93;Provence-Alpes-Côte d'Azur;84;1;13;084;La Motte-d'Aigues;1334;40;1374
93;Provence-Alpes-Côte d'Azur;84;1;01;085;Murs;419;6;425
93;Provence-Alpes-Côte d'Azur;84;1;01;086;Oppède;1332;28;1360
93;Provence-Alpes-Côte d'Azur;84;3;11;087;Orange;28919;647;29566
93;Provence-Alpes-Côte d'Azur;84;3;12;088;Pernes-les-Fontaines;9620;263;9883
93;Provence-Alpes-Côte d'Azur;84;1;13;089;Pertuis;20380;350;20730
93;Provence-Alpes-Côte d'Azur;84;1;13;090;Peypin-d'Aigues;674;17;691
93;Provence-Alpes-Côte d'Azur;84;3;11;091;Piolenc;5253;104;5357
93;Provence-Alpes-Côte d'Azur;84;2;14;092;Le Pontet;17530;155;17685
93;Provence-Alpes-Côte d'Azur;84;1;08;093;Puget;769;21;790
93;Provence-Alpes-Côte d'Azur;84;3;16;094;Puyméras;595;12;607
93;Provence-Alpes-Côte d'Azur;84;1;08;095;Puyvert;817;14;831
93;Provence-Alpes-Côte d'Azur;84;3;16;096;Rasteau;846;22;868
93;Provence-Alpes-Côte d'Azur;84;3;17;097;Richerenches;619;82;701
93;Provence-Alpes-Côte d'Azur;84;3;16;098;Roaix;644;9;653
93;Provence-Alpes-Côte d'Azur;84;1;08;099;Robion;4531;72;4603
93;Provence-Alpes-Côte d'Azur;84;3;16;100;La Roque-Alric;51;0;51
93;Provence-Alpes-Côte d'Azur;84;3;12;101;La Roque-sur-Pernes;415;11;426
93;Provence-Alpes-Côte d'Azur;84;1;01;102;Roussillon;1305;31;1336
93;Provence-Alpes-Côte d'Azur;84;1;01;103;Rustrel;688;20;708
93;Provence-Alpes-Côte d'Azur;84;3;16;104;Sablet;1284;31;1315
93;Provence-Alpes-Côte d'Azur;84;1;01;105;Saignon;980;21;1001
93;Provence-Alpes-Côte d'Azur;84;3;12;107;Saint-Christol;1345;4;1349
93;Provence-Alpes-Côte d'Azur;84;3;12;108;Saint-Didier;2144;44;2188
93;Provence-Alpes-Côte d'Azur;84;3;10;109;Saint-Hippolyte-le-Graveyron;178;9;187
93;Provence-Alpes-Côte d'Azur;84;3;16;110;Saint-Léger-du-Ventoux;34;0;34
93;Provence-Alpes-Côte d'Azur;84;3;16;111;Saint-Marcellin-lès-Vaison;312;11;323
93;Provence-Alpes-Côte d'Azur;84;1;01;112;Saint-Martin-de-Castillon;781;16;797
93;Provence-Alpes-Côte d'Azur;84;1;13;113;Saint-Martin-de-la-Brasque;840;17;857
93;Provence-Alpes-Côte d'Azur;84;1;01;114;Saint-Pantaléon;200;3;203
93;Provence-Alpes-Côte d'Azur;84;3;12;115;Saint-Pierre-de-Vassols;525;12;537
93;Provence-Alpes-Côte d'Azur;84;3;16;116;Saint-Romain-en-Viennois;802;19;821
93;Provence-Alpes-Côte d'Azur;84;3;16;117;Saint-Roman-de-Malegarde;325;5;330
93;Provence-Alpes-Côte d'Azur;84;1;01;118;Saint-Saturnin-lès-Apt;2811;67;2878
93;Provence-Alpes-Côte d'Azur;84;2;14;119;Saint-Saturnin-lès-Avignon;4846;110;4956
93;Provence-Alpes-Côte d'Azur;84;3;12;120;Saint-Trinit;121;1;122
93;Provence-Alpes-Côte d'Azur;84;3;05;106;Sainte-Cécile-les-Vignes;2505;54;2559
93;Provence-Alpes-Côte d'Azur;84;1;13;121;Sannes;240;7;247
93;Provence-Alpes-Côte d'Azur;84;3;10;122;Sarrians;6065;74;6139
93;Provence-Alpes-Côte d'Azur;84;3;12;123;Sault;1381;23;1404
93;Provence-Alpes-Côte d'Azur;84;2;09;124;Saumane-de-Vaucluse;948;16;964
93;Provence-Alpes-Côte d'Azur;84;3;16;125;Savoillan;63;0;63
93;Provence-Alpes-Côte d'Azur;84;3;16;126;Séguret;844;24;868
93;Provence-Alpes-Côte d'Azur;84;3;05;127;Sérignan-du-Comtat;2676;75;2751
93;Provence-Alpes-Côte d'Azur;84;1;01;128;Sivergues;43;1;44
93;Provence-Alpes-Côte d'Azur;84;2;15;129;Sorgues;18680;244;18924
93;Provence-Alpes-Côte d'Azur;84;3;16;130;Suzette;119;3;122
93;Provence-Alpes-Côte d'Azur;84;1;08;131;Taillades;1909;40;1949
93;Provence-Alpes-Côte d'Azur;84;2;09;132;Le Thor;9071;151;9222
93;Provence-Alpes-Côte d'Azur;84;1;13;133;La Tour-d'Aigues;4287;142;4429
93;Provence-Alpes-Côte d'Azur;84;3;16;134;Travaillan;722;14;736
93;Provence-Alpes-Côte d'Azur;84;3;05;135;Uchaux;1649;55;1704
93;Provence-Alpes-Côte d'Azur;84;3;16;136;Vacqueyras;1308;30;1338
93;Provence-Alpes-Côte d'Azur;84;3;16;137;Vaison-la-Romaine;5999;138;6137
93;Provence-Alpes-Côte d'Azur;84;3;17;138;Valréas;9422;230;9652
93;Provence-Alpes-Côte d'Azur;84;1;08;140;Vaugines;568;20;588
93;Provence-Alpes-Côte d'Azur;84;2;14;141;Vedène;11259;370;11629
93;Provence-Alpes-Côte d'Azur;84;2;14;142;Velleron;2960;53;3013
93;Provence-Alpes-Côte d'Azur;84;3;12;143;Venasque;1012;17;1029
93;Provence-Alpes-Côte d'Azur;84;1;01;144;Viens;636;18;654
93;Provence-Alpes-Côte d'Azur;84;1;01;145;Villars;776;15;791
93;Provence-Alpes-Côte d'Azur;84;3;16;146;Villedieu;504;16;520
93;Provence-Alpes-Côte d'Azur;84;1;13;147;Villelaure;3477;71;3548
93;Provence-Alpes-Côte d'Azur;84;3;12;148;Villes-sur-Auzon;1287;34;1321
93;Provence-Alpes-Côte d'Azur;84;3;16;149;Violès;1677;33;1710
93;Provence-Alpes-Côte d'Azur;84;3;17;150;Visan;1983;57;2040
93;Provence-Alpes-Côte d'Azur;84;1;13;151;Vitrolles-en-Lubéron;164;4;168
52;Pays de la Loire;85;3;17;152;Les Achards;5063;103;5166
52;Pays de la Loire;85;1;09;001;L' Aiguillon-sur-Mer;2081;35;2116
52;Pays de la Loire;85;3;15;002;L' Aiguillon-sur-Vie;1965;23;1988
52;Pays de la Loire;85;2;01;003;Aizenay;9510;155;9665
52;Pays de la Loire;85;3;09;004;Angles;2816;36;2852
52;Pays de la Loire;85;1;04;005;Antigny;1059;20;1079
52;Pays de la Loire;85;2;02;006;Apremont;1814;18;1832
52;Pays de la Loire;85;2;13;008;Aubigny-Les Clouzeaux;6571;100;6671
52;Pays de la Loire;85;1;05;009;Auchay-sur-Vendée;1151;24;1175
52;Pays de la Loire;85;3;17;010;Avrillé;1420;8;1428
52;Pays de la Loire;85;3;16;011;Barbâtre;1724;48;1772
52;Pays de la Loire;85;3;16;012;La Barre-de-Monts;2199;48;2247
52;Pays de la Loire;85;2;10;013;Bazoges-en-Paillers;1419;17;1436
52;Pays de la Loire;85;1;04;014;Bazoges-en-Pareds;1153;27;1180
52;Pays de la Loire;85;2;01;015;Beaufou;1508;20;1528
52;Pays de la Loire;85;3;17;016;Beaulieu-sous-la-Roche;2212;29;2241
52;Pays de la Loire;85;2;11;017;Beaurepaire;2401;48;2449
52;Pays de la Loire;85;3;16;018;Beauvoir-sur-Mer;3904;60;3964
52;Pays de la Loire;85;2;01;019;Bellevigny;6005;119;6124
52;Pays de la Loire;85;1;05;020;Benet;4011;75;4086
52;Pays de la Loire;85;3;17;022;Le Bernard;1216;17;1233
52;Pays de la Loire;85;2;11;021;La Bernardière;1815;33;1848
52;Pays de la Loire;85;1;09;023;Bessay;426;9;435
52;Pays de la Loire;85;3;02;024;Bois-de-Céné;2001;34;2035
52;Pays de la Loire;85;2;10;025;La Boissière-de-Montaigu;2251;51;2302
52;Pays de la Loire;85;3;09;026;La Boissière-des-Landes;1388;18;1406
52;Pays de la Loire;85;1;05;028;Bouillé-Courdault;599;8;607
52;Pays de la Loire;85;3;16;029;Bouin;2156;35;2191
52;Pays de la Loire;85;1;03;031;Le Boupère;3150;42;3192
52;Pays de la Loire;85;1;04;033;Bourneau;734;19;753
52;Pays de la Loire;85;2;03;034;Bournezeau;3373;99;3472
52;Pays de la Loire;85;3;15;243;Brem-sur-Mer;2720;47;2767
52;Pays de la Loire;85;3;15;035;Bretignolles-sur-Mer;4669;81;4750
52;Pays de la Loire;85;1;09;036;La Bretonnière-la-Claye;575;8;583
52;Pays de la Loire;85;1;04;037;Breuil-Barret;630;17;647
52;Pays de la Loire;85;2;10;038;Les Brouzils;2799;43;2842
52;Pays de la Loire;85;2;11;039;La Bruffière;3943;60;4003
52;Pays de la Loire;85;1;04;040;La Caillère-Saint-Hilaire;1111;23;1134
52;Pays de la Loire;85;1;04;041;Cezais;300;11;311
52;Pays de la Loire;85;1;08;042;Chaillé-les-Marais;1896;25;1921
52;Pays de la Loire;85;3;15;045;La Chaize-Giraud;1068;14;1082
52;Pays de la Loire;85;2;13;046;La Chaize-le-Vicomte;3770;58;3828
52;Pays de la Loire;85;3;02;047;Challans;20622;696;21318
52;Pays de la Loire;85;3;09;050;Le Champ-Saint-Père;1837;23;1860
52;Pays de la Loire;85;1;08;049;Champagné-les-Marais;1772;16;1788
52;Pays de la Loire;85;2;03;051;Chantonnay;8318;414;8732
52;Pays de la Loire;85;2;11;302;Chanverrie;5517;133;5650
52;Pays de la Loire;85;1;04;053;La Chapelle-aux-Lys;253;3;256
52;Pays de la Loire;85;3;17;054;La Chapelle-Hermier;898;9;907
52;Pays de la Loire;85;2;02;055;La Chapelle-Palluau;946;18;964
52;Pays de la Loire;85;1;04;056;La Chapelle-Thémer;385;9;394
52;Pays de la Loire;85;1;08;058;Chasnais;728;20;748
52;Pays de la Loire;85;1;04;059;La Châtaigneraie;2544;35;2579
52;Pays de la Loire;85;1;09;061;Château-Guibert;1521;32;1553
52;Pays de la Loire;85;3;02;062;Châteauneuf;1056;19;1075
52;Pays de la Loire;85;2;10;064;Chauché;2470;33;2503
52;Pays de la Loire;85;2;10;065;Chavagnes-en-Paillers;3536;102;3638
52;Pays de la Loire;85;1;06;066;Chavagnes-les-Redoux;828;18;846
52;Pays de la Loire;85;1;04;067;Cheffois;977;17;994
52;Pays de la Loire;85;3;15;070;Coëx;3176;53;3229
52;Pays de la Loire;85;3;15;071;Commequiers;3505;48;3553
52;Pays de la Loire;85;2;10;072;La Copechagnière;999;11;1010
52;Pays de la Loire;85;1;09;073;Corpe;1033;16;1049
52;Pays de la Loire;85;1;09;074;La Couture;218;3;221
52;Pays de la Loire;85;2;11;076;Cugand;3498;92;3590
52;Pays de la Loire;85;3;09;077;Curzon;513;8;521
52;Pays de la Loire;85;1;05;078;Damvix;747;16;763
52;Pays de la Loire;85;1;05;080;Doix lès Fontaines;1714;33;1747
52;Pays de la Loire;85;2;12;081;Dompierre-sur-Yon;4244;79;4323
52;Pays de la Loire;85;2;06;082;Les Epesses;2853;54;2907
52;Pays de la Loire;85;3;16;083;L' Épine;1641;31;1672
52;Pays de la Loire;85;2;03;084;Essarts en Bocage;8931;161;9092
52;Pays de la Loire;85;2;02;086;Falleron;1598;15;1613
52;Pays de la Loire;85;3;09;307;La Faute-sur-Mer;660;9;669
52;Pays de la Loire;85;1;05;087;Faymoreau;202;4;206
52;Pays de la Loire;85;3;15;088;Le Fenouiller;4711;127;4838
52;Pays de la Loire;85;2;03;089;La Ferrière;5255;153;5408
52;Pays de la Loire;85;1;05;092;Fontenay-le-Comte;13226;680;13906
52;Pays de la Loire;85;2;03;093;Fougeré;1204;20;1224
52;Pays de la Loire;85;1;05;094;Foussais-Payré;1130;30;1160
52;Pays de la Loire;85;3;02;095;Froidfond;1876;21;1897
52;Pays de la Loire;85;3;02;096;La Garnache;4995;98;5093
52;Pays de la Loire;85;2;11;097;La Gaubretière;3060;67;3127
52;Pays de la Loire;85;2;01;098;La Genétouze;1931;37;1968
52;Pays de la Loire;85;3;17;099;Le Girouard;1050;19;1069
52;Pays de la Loire;85;3;15;100;Givrand;2176;52;2228
52;Pays de la Loire;85;3;09;101;Le Givre;508;5;513
52;Pays de la Loire;85;2;02;102;Grand'Landes;670;9;679
52;Pays de la Loire;85;3;17;103;Grosbreuil;2177;31;2208
52;Pays de la Loire;85;1;08;104;Grues;851;14;865
52;Pays de la Loire;85;1;08;105;Le Gué-de-Velluire;544;12;556
52;Pays de la Loire;85;3;16;106;La Guérinière;1347;32;1379
52;Pays de la Loire;85;2;01;108;L' Herbergement;3175;108;3283
52;Pays de la Loire;85;2;06;109;Les Herbiers;15958;463;16421
52;Pays de la Loire;85;1;04;110;L' Hermenault;913;15;928
52;Pays de la Loire;85;1;08;111;L' Île-d'Elle;1520;19;1539
52;Pays de la Loire;85;3;17;112;L' Île-d'Olonne;2694;57;2751
52;Pays de la Loire;85;3;07;113;L' Île-d'Yeu;4809;100;4909
52;Pays de la Loire;85;3;17;114;Jard-sur-Mer;2653;30;2683
52;Pays de la Loire;85;1;04;115;La Jaudonnière;606;10;616
52;Pays de la Loire;85;3;09;116;La Jonchère;450;6;456
52;Pays de la Loire;85;1;08;117;Lairoux;619;19;638
52;Pays de la Loire;85;2;12;118;Landeronde;2279;47;2326
52;Pays de la Loire;85;2;11;119;Les Landes-Genusson;2387;42;2429
52;Pays de la Loire;85;3;15;120;Landevieille;1389;30;1419
52;Pays de la Loire;85;1;05;121;Le Langon;1028;32;1060
52;Pays de la Loire;85;1;05;123;Liez;278;4;282
52;Pays de la Loire;85;1;04;125;Loge-Fougereuse;387;4;391
52;Pays de la Loire;85;1;05;126;Longèves;1323;49;1372
52;Pays de la Loire;85;3;17;127;Longeville-sur-Mer;2466;26;2492
52;Pays de la Loire;85;2;01;129;Les Lucs-sur-Boulogne;3463;71;3534
52;Pays de la Loire;85;1;08;128;Luçon;9540;388;9928
52;Pays de la Loire;85;2;02;130;Maché;1545;20;1565
52;Pays de la Loire;85;1;08;131;Les Magnils-Reigniers;1576;42;1618
52;Pays de la Loire;85;1;05;132;Maillé;760;14;774
52;Pays de la Loire;85;1;05;133;Maillezais;939;24;963
52;Pays de la Loire;85;2;11;134;Mallièvre;252;10;262
52;Pays de la Loire;85;1;09;135;Mareuil-sur-Lay-Dissais;2813;125;2938
52;Pays de la Loire;85;1;04;136;Marillet;115;1;116
52;Pays de la Loire;85;1;04;137;Marsais-Sainte-Radégonde;489;14;503
52;Pays de la Loire;85;3;17;138;Martinet;1136;12;1148
52;Pays de la Loire;85;1;05;139;Le Mazeau;452;14;466
52;Pays de la Loire;85;1;06;140;La Meilleraie-Tillay;1515;43;1558
52;Pays de la Loire;85;1;04;141;Menomblet;664;11;675
52;Pays de la Loire;85;2;03;142;La Merlatière;1000;23;1023
52;Pays de la Loire;85;1;05;143;Mervent;1050;20;1070
52;Pays de la Loire;85;2;10;144;Mesnard-la-Barotière;1440;25;1465
52;Pays de la Loire;85;1;06;145;Monsireigne;972;16;988
52;Pays de la Loire;85;2;10;146;Montaigu-Vendée;20126;618;20744
52;Pays de la Loire;85;1;06;147;Montournais;1663;54;1717
52;Pays de la Loire;85;1;05;148;Montreuil;798;25;823
52;Pays de la Loire;85;2;01;197;Montréverd;3700;36;3736
52;Pays de la Loire;85;1;08;149;Moreilles;422;5;427
52;Pays de la Loire;85;2;11;151;Mortagne-sur-Sèvre;5930;167;6097
52;Pays de la Loire;85;2;06;153;Mouchamps;2886;44;2930
52;Pays de la Loire;85;2;12;155;Mouilleron-le-Captif;4928;104;5032
52;Pays de la Loire;85;1;04;154;Mouilleron-Saint-Germain;1845;90;1935
52;Pays de la Loire;85;3;09;156;Moutiers-les-Mauxfaits;2128;32;2160
52;Pays de la Loire;85;1;09;157;Moutiers-sur-le-Lay;753;12;765
52;Pays de la Loire;85;1;08;158;Mouzeuil-Saint-Martin;1216;25;1241
52;Pays de la Loire;85;1;08;159;Nalliers;2315;47;2362
52;Pays de la Loire;85;2;13;160;Nesmy;2883;44;2927
52;Pays de la Loire;85;3;17;161;Nieul-le-Dolent;2487;25;2512
52;Pays de la Loire;85;3;16;163;Noirmoutier-en-l'Île;4668;88;4756
52;Pays de la Loire;85;3;16;164;Notre-Dame-de-Monts;2105;45;2150
52;Pays de la Loire;85;3;16;189;Notre-Dame-de-Riez;2099;45;2144
52;Pays de la Loire;85;1;05;167;L' Orbrie;797;18;815
52;Pays de la Loire;85;2;02;169;Palluau;1102;8;1110
52;Pays de la Loire;85;1;09;171;Péault;610;23;633
52;Pays de la Loire;85;3;16;172;Le Perrier;2023;32;2055
52;Pays de la Loire;85;1;04;174;Petosse;706;17;723
52;Pays de la Loire;85;1;09;175;Les Pineaux;632;3;635
52;Pays de la Loire;85;1;05;176;Pissotte;1143;35;1178
52;Pays de la Loire;85;2;01;178;Le Poiré-sur-Vie;8509;217;8726
52;Pays de la Loire;85;3;17;179;Poiroux;1090;16;1106
52;Pays de la Loire;85;1;08;181;Pouillé;629;17;646
52;Pays de la Loire;85;1;06;182;Pouzauges;5514;181;5695
52;Pays de la Loire;85;1;05;184;Puy-de-Serre;318;7;325
52;Pays de la Loire;85;1;08;185;Puyravault;663;6;669
52;Pays de la Loire;85;2;10;186;La Rabatelière;989;15;1004
52;Pays de la Loire;85;1;06;187;Réaumur;864;8;872
52;Pays de la Loire;85;1;04;188;La Réorthe;1093;22;1115
52;Pays de la Loire;85;1;05;162;Rives-d'Autise;2118;50;2168
52;Pays de la Loire;85;2;09;213;Rives de l'Yon;4160;175;4335
52;Pays de la Loire;85;2;99;191;La Roche-sur-Yon;54372;2994;57366
52;Pays de la Loire;85;2;01;190;Rocheservière;3322;47;3369
52;Pays de la Loire;85;2;03;192;Rochetrejoux;950;9;959
52;Pays de la Loire;85;1;09;193;Rosnay;627;15;642
52;Pays de la Loire;85;3;14;194;Les Sables-d'Olonne;44017;1428;45445
52;Pays de la Loire;85;2;10;196;Saint-André-Goule-d'Oie;1832;15;1847
52;Pays de la Loire;85;2;11;198;Saint-Aubin-des-Ormeaux;1335;16;1351
52;Pays de la Loire;85;1;04;199;Saint-Aubin-la-Plaine;535;6;541
52;Pays de la Loire;85;3;09;200;Saint-Avaugourd-des-Landes;1067;21;1088
52;Pays de la Loire;85;3;09;201;Saint-Benoist-sur-Mer;474;6;480
52;Pays de la Loire;85;3;02;204;Saint-Christophe-du-Ligneron;2554;42;2596
52;Pays de la Loire;85;1;04;205;Saint-Cyr-des-Gâts;534;8;542
52;Pays de la Loire;85;3;09;206;Saint-Cyr-en-Talmondais;379;4;383
52;Pays de la Loire;85;1;08;207;Saint-Denis-du-Payré;385;9;394
52;Pays de la Loire;85;2;01;208;Saint-Denis-la-Chevasse;2290;36;2326
52;Pays de la Loire;85;1;04;209;Saint-Étienne-de-Brillouet;615;8;623
52;Pays de la Loire;85;2;02;210;Saint-Étienne-du-Bois;2101;25;2126
52;Pays de la Loire;85;2;10;215;Saint-Fulgent;3792;131;3923
52;Pays de la Loire;85;3;17;218;Saint-Georges-de-Pointindoux;1668;15;1683
52;Pays de la Loire;85;2;03;220;Saint-Germain-de-Prinçay;1535;26;1561
52;Pays de la Loire;85;3;16;221;Saint-Gervais;2669;37;2706
52;Pays de la Loire;85;3;15;222;Saint-Gilles-Croix-de-Vie;7655;224;7879
52;Pays de la Loire;85;3;15;226;Saint-Hilaire-de-Riez;11169;212;11381
52;Pays de la Loire;85;1;04;229;Saint-Hilaire-de-Voust;594;13;607
52;Pays de la Loire;85;1;05;227;Saint-Hilaire-des-Loges;1950;54;2004
52;Pays de la Loire;85;3;17;231;Saint-Hilaire-la-Forêt;802;14;816
52;Pays de la Loire;85;2;03;232;Saint-Hilaire-le-Vouhis;1060;21;1081
52;Pays de la Loire;85;1;04;233;Saint-Jean-de-Beugné;594;9;603
52;Pays de la Loire;85;3;16;234;Saint-Jean-de-Monts;8634;209;8843
52;Pays de la Loire;85;1;04;235;Saint-Juire-Champgillon;408;13;421
52;Pays de la Loire;85;3;17;236;Saint-Julien-des-Landes;1773;20;1793
52;Pays de la Loire;85;1;04;237;Saint-Laurent-de-la-Salle;357;11;368
52;Pays de la Loire;85;2;11;238;Saint-Laurent-sur-Sèvre;3617;439;4056
52;Pays de la Loire;85;3;15;239;Saint-Maixent-sur-Vie;1078;6;1084
52;Pays de la Loire;85;2;11;240;Saint-Malô-du-Bois;1603;48;1651
52;Pays de la Loire;85;2;06;242;Saint-Mars-la-Réorthe;978;13;991
52;Pays de la Loire;85;1;05;244;Saint-Martin-de-Fraigneau;820;59;879
52;Pays de la Loire;85;1;04;245;Saint-Martin-des-Fontaines;172;2;174
52;Pays de la Loire;85;2;03;246;Saint-Martin-des-Noyers;2372;38;2410
52;Pays de la Loire;85;2;11;247;Saint-Martin-des-Tilleuls;1069;18;1087
52;Pays de la Loire;85;1;04;248;Saint-Martin-Lars-en-Sainte-Hermine;408;9;417
52;Pays de la Loire;85;3;17;250;Saint-Mathurin;2270;35;2305
52;Pays de la Loire;85;1;04;251;Saint-Maurice-des-Noues;648;18;666
52;Pays de la Loire;85;1;04;252;Saint-Maurice-le-Girard;588;14;602
52;Pays de la Loire;85;1;06;254;Saint-Mesmin;1766;26;1792
52;Pays de la Loire;85;1;08;255;Saint-Michel-en-l'Herm;2352;78;2430
52;Pays de la Loire;85;1;05;256;Saint-Michel-le-Cloucq;1289;32;1321
52;Pays de la Loire;85;2;06;259;Saint-Paul-en-Pareds;1336;28;1364
52;Pays de la Loire;85;2;02;260;Saint-Paul-Mont-Penit;811;11;822
52;Pays de la Loire;85;2;01;262;Saint-Philbert-de-Bouaine;3424;37;3461
52;Pays de la Loire;85;1;04;264;Saint-Pierre-du-Chemin;1336;20;1356
52;Pays de la Loire;85;1;05;265;Saint-Pierre-le-Vieux;961;23;984
52;Pays de la Loire;85;2;03;266;Saint-Prouant;1618;28;1646
52;Pays de la Loire;85;3;15;268;Saint-Révérend;1430;17;1447
52;Pays de la Loire;85;1;05;269;Saint-Sigismond;406;7;413
52;Pays de la Loire;85;1;04;271;Saint-Sulpice-en-Pareds;430;12;442
52;Pays de la Loire;85;3;16;273;Saint-Urbain;1818;35;1853
52;Pays de la Loire;85;1;04;274;Saint-Valérien;526;13;539
52;Pays de la Loire;85;2;03;276;Saint-Vincent-Sterlanges;789;13;802
52;Pays de la Loire;85;3;09;277;Saint-Vincent-sur-Graon;1485;23;1508
52;Pays de la Loire;85;3;17;278;Saint-Vincent-sur-Jard;1298;21;1319
52;Pays de la Loire;85;2;03;202;Sainte-Cécile;1621;106;1727
52;Pays de la Loire;85;3;17;211;Sainte-Flaive-des-Loups;2395;24;2419
52;Pays de la Loire;85;3;17;214;Sainte-Foy;2215;43;2258
52;Pays de la Loire;85;1;08;216;Sainte-Gemme-la-Plaine;2044;213;2257
52;Pays de la Loire;85;1;04;223;Sainte-Hermine;2925;39;2964
52;Pays de la Loire;85;1;09;261;Sainte-Pexine;257;11;268
52;Pays de la Loire;85;1;08;267;Sainte-Radégonde-des-Noyers;916;18;934
52;Pays de la Loire;85;3;02;280;Sallertaine;3099;70;3169
52;Pays de la Loire;85;1;04;281;Sérigné;974;29;1003
52;Pays de la Loire;85;1;06;090;Sèvremont;6486;217;6703
52;Pays de la Loire;85;2;03;282;Sigournais;896;15;911
52;Pays de la Loire;85;3;16;284;Soullans;4221;91;4312
52;Pays de la Loire;85;2;09;285;Le Tablier;746;13;759
52;Pays de la Loire;85;1;08;286;La Taillée;581;9;590
52;Pays de la Loire;85;1;06;287;Tallud-Sainte-Gemme;470;4;474
52;Pays de la Loire;85;3;17;288;Talmont-Saint-Hilaire;7657;179;7836
52;Pays de la Loire;85;1;04;289;La Tardière;1312;26;1338
52;Pays de la Loire;85;1;04;290;Thiré;570;12;582
52;Pays de la Loire;85;2;03;291;Thorigny;1230;20;1250
52;Pays de la Loire;85;1;04;292;Thouarsais-Bouildroux;770;10;780
52;Pays de la Loire;85;2;11;293;Tiffauges;1588;40;1628
52;Pays de la Loire;85;3;09;294;La Tranche-sur-Mer;2905;64;2969
52;Pays de la Loire;85;2;10;295;Treize-Septiers;3209;81;3290
52;Pays de la Loire;85;2;11;296;Treize-Vents;1259;25;1284
52;Pays de la Loire;85;1;08;297;Triaize;1010;15;1025
52;Pays de la Loire;85;3;17;298;Vairé;1665;29;1694
52;Pays de la Loire;85;1;05;177;Les Velluire-sur-Vendée;1381;18;1399
52;Pays de la Loire;85;2;12;300;Venansault;4644;163;4807
52;Pays de la Loire;85;2;10;301;Vendrennes;1721;20;1741
52;Pays de la Loire;85;1;05;303;Vix;1788;20;1808
52;Pays de la Loire;85;1;08;304;Vouillé-les-Marais;755;10;765
52;Pays de la Loire;85;1;04;305;Vouvant;867;48;915
52;Pays de la Loire;85;1;05;306;Xanton-Chassenon;729;13;742
75;Nouvelle-Aquitaine;86;2;10;001;Adriers;719;8;727
75;Nouvelle-Aquitaine;86;3;11;002;Amberre;576;21;597
75;Nouvelle-Aquitaine;86;2;09;003;Anché;340;7;347
75;Nouvelle-Aquitaine;86;1;12;004;Angles-sur-l'Anglin;357;14;371
75;Nouvelle-Aquitaine;86;1;08;005;Angliers;629;22;651
75;Nouvelle-Aquitaine;86;2;12;006;Antigny;549;20;569
75;Nouvelle-Aquitaine;86;1;03;007;Antran;1192;32;1224
75;Nouvelle-Aquitaine;86;1;05;009;Archigny;1092;17;1109
75;Nouvelle-Aquitaine;86;1;08;008;Arçay;355;7;362
75;Nouvelle-Aquitaine;86;3;18;010;Aslonnes;1109;19;1128
75;Nouvelle-Aquitaine;86;2;10;011;Asnières-sur-Blour;182;4;186
75;Nouvelle-Aquitaine;86;2;06;012;Asnois;163;7;170
75;Nouvelle-Aquitaine;86;1;08;013;Aulnay;98;3;101
75;Nouvelle-Aquitaine;86;1;05;014;Availles-en-Châtellerault;1757;40;1797
75;Nouvelle-Aquitaine;86;2;06;015;Availles-Limouzine;1272;26;1298
75;Nouvelle-Aquitaine;86;3;11;016;Avanton;2175;29;2204
75;Nouvelle-Aquitaine;86;3;19;017;Ayron;1138;19;1157
75;Nouvelle-Aquitaine;86;1;08;018;Basses;323;2;325
75;Nouvelle-Aquitaine;86;3;07;019;Beaumont Saint-Cyr;3035;41;3076
75;Nouvelle-Aquitaine;86;1;05;020;Bellefonds;254;4;258
75;Nouvelle-Aquitaine;86;1;08;022;Berrie;263;4;267
75;Nouvelle-Aquitaine;86;1;08;023;Berthegon;306;4;310
75;Nouvelle-Aquitaine;86;3;19;024;Béruges;1469;25;1494
75;Nouvelle-Aquitaine;86;2;12;025;Béthines;473;5;478
75;Nouvelle-Aquitaine;86;1;08;026;Beuxes;553;4;557
75;Nouvelle-Aquitaine;86;3;13;027;Biard;1751;59;1810
75;Nouvelle-Aquitaine;86;3;01;028;Bignoux;1054;18;1072
75;Nouvelle-Aquitaine;86;2;06;029;Blanzay;787;26;813
75;Nouvelle-Aquitaine;86;3;19;123;Boivre-la-Vallée;3083;46;3129
75;Nouvelle-Aquitaine;86;3;01;031;Bonnes;1729;21;1750
75;Nouvelle-Aquitaine;86;1;05;032;Bonneuil-Matours;2104;60;2164
75;Nouvelle-Aquitaine;86;2;10;034;Bouresse;584;17;601
75;Nouvelle-Aquitaine;86;2;12;035;Bourg-Archambault;188;7;195
75;Nouvelle-Aquitaine;86;1;08;036;Bournand;878;19;897
75;Nouvelle-Aquitaine;86;2;12;037;Brigueil-le-Chantre;513;7;520
75;Nouvelle-Aquitaine;86;2;10;038;Brion;226;8;234
75;Nouvelle-Aquitaine;86;2;09;039;Brux;716;10;726
75;Nouvelle-Aquitaine;86;2;12;040;La Bussière;323;10;333
75;Nouvelle-Aquitaine;86;3;14;041;Buxerolles;10023;142;10165
75;Nouvelle-Aquitaine;86;1;03;042;Buxeuil;939;14;953
75;Nouvelle-Aquitaine;86;1;08;044;Ceaux-en-Loudun;553;12;565
75;Nouvelle-Aquitaine;86;3;09;045;Celle-Lévescault;1356;17;1373
75;Nouvelle-Aquitaine;86;1;05;046;Cenon-sur-Vienne;1778;30;1808
75;Nouvelle-Aquitaine;86;1;08;047;Cernay;477;13;490
75;Nouvelle-Aquitaine;86;3;07;048;Chabournay;1073;10;1083
75;Nouvelle-Aquitaine;86;1;08;049;Chalais;513;16;529
75;Nouvelle-Aquitaine;86;3;19;050;Chalandray;841;11;852
75;Nouvelle-Aquitaine;86;2;06;051;Champagné-le-Sec;200;4;204
75;Nouvelle-Aquitaine;86;2;06;052;Champagné-Saint-Hilaire;1010;20;1030
75;Nouvelle-Aquitaine;86;3;89;053;Champigny en Rochereau;1925;35;1960
75;Nouvelle-Aquitaine;86;2;06;054;Champniers;351;5;356
75;Nouvelle-Aquitaine;86;2;06;055;La Chapelle-Bâton;357;9;366
75;Nouvelle-Aquitaine;86;3;01;058;La Chapelle-Moulière;705;20;725
75;Nouvelle-Aquitaine;86;2;05;059;Chapelle-Viviers;561;4;565
75;Nouvelle-Aquitaine;86;2;06;061;Charroux;1136;29;1165
75;Nouvelle-Aquitaine;86;3;01;062;Chasseneuil-du-Poitou;4704;49;4753
75;Nouvelle-Aquitaine;86;2;06;063;Chatain;250;3;253
75;Nouvelle-Aquitaine;86;2;06;064;Château-Garnier;614;10;624
75;Nouvelle-Aquitaine;86;3;18;065;Château-Larcher;1025;17;1042
75;Nouvelle-Aquitaine;86;1;98;066;Châtellerault;31840;764;32604
75;Nouvelle-Aquitaine;86;2;09;068;Chaunay;1212;20;1232
75;Nouvelle-Aquitaine;86;1;08;069;La Chaussée;182;4;186
75;Nouvelle-Aquitaine;86;3;05;070;Chauvigny;7049;115;7164
75;Nouvelle-Aquitaine;86;1;04;072;Chenevelles;469;7;476
75;Nouvelle-Aquitaine;86;3;11;073;Cherves;572;10;582
75;Nouvelle-Aquitaine;86;3;19;074;Chiré-en-Montreuil;912;14;926
75;Nouvelle-Aquitaine;86;3;08;075;Chouppes;750;16;766
75;Nouvelle-Aquitaine;86;3;11;076;Cissé;2785;49;2834
75;Nouvelle-Aquitaine;86;2;10;077;Civaux;1203;16;1219
75;Nouvelle-Aquitaine;86;2;06;078;Civray;2658;130;2788
75;Nouvelle-Aquitaine;86;3;09;080;Cloué;496;5;501
75;Nouvelle-Aquitaine;86;1;02;081;Colombiers;1501;31;1532
75;Nouvelle-Aquitaine;86;3;09;083;Coulombiers;1164;12;1176
75;Nouvelle-Aquitaine;86;2;12;084;Coulonges;236;6;242
75;Nouvelle-Aquitaine;86;3;08;085;Coussay;251;4;255
75;Nouvelle-Aquitaine;86;1;04;086;Coussay-les-Bois;1003;14;1017
75;Nouvelle-Aquitaine;86;1;08;087;Craon;186;3;189
75;Nouvelle-Aquitaine;86;3;13;088;Croutelle;851;23;874
75;Nouvelle-Aquitaine;86;3;11;089;Cuhon;398;7;405
75;Nouvelle-Aquitaine;86;3;09;091;Curzay-sur-Vonne;410;5;415
75;Nouvelle-Aquitaine;86;1;08;090;Curçay-sur-Dive;213;1;214
75;Nouvelle-Aquitaine;86;1;03;092;Dangé-Saint-Romain;2981;41;3022
75;Nouvelle-Aquitaine;86;1;08;093;Dercé;155;3;158
75;Nouvelle-Aquitaine;86;3;18;094;Dienné;561;12;573
75;Nouvelle-Aquitaine;86;3;07;095;Dissay;3233;49;3282
75;Nouvelle-Aquitaine;86;1;08;096;Doussay;653;8;661
75;Nouvelle-Aquitaine;86;2;06;097;La Ferrière-Airoux;321;13;334
75;Nouvelle-Aquitaine;86;2;05;098;Fleix;136;1;137
75;Nouvelle-Aquitaine;86;3;18;099;Fleuré;1050;8;1058
75;Nouvelle-Aquitaine;86;3;13;100;Fontaine-le-Comte;3853;73;3926
75;Nouvelle-Aquitaine;86;3;19;102;Frozes;559;9;568
75;Nouvelle-Aquitaine;86;2;06;104;Genouillé;512;4;516
75;Nouvelle-Aquitaine;86;2;10;103;Gençay;1737;63;1800
75;Nouvelle-Aquitaine;86;3;18;105;Gizay;377;1;378
75;Nouvelle-Aquitaine;86;1;08;106;Glénouze;105;2;107
75;Nouvelle-Aquitaine;86;2;10;107;Gouex;491;8;499
75;Nouvelle-Aquitaine;86;1;08;108;La Grimaudière;397;12;409
75;Nouvelle-Aquitaine;86;1;08;109;Guesnes;222;7;229
75;Nouvelle-Aquitaine;86;2;12;110;Haims;225;4;229
75;Nouvelle-Aquitaine;86;1;03;111;Ingrandes;1750;37;1787
75;Nouvelle-Aquitaine;86;2;10;112;L' Isle-Jourdain;1163;14;1177
75;Nouvelle-Aquitaine;86;3;18;113;Iteuil;2940;47;2987
75;Nouvelle-Aquitaine;86;3;01;114;Jardres;1273;24;1297
75;Nouvelle-Aquitaine;86;3;07;115;Jaunay-Marigny;7530;236;7766
75;Nouvelle-Aquitaine;86;3;09;116;Jazeneuil;804;17;821
75;Nouvelle-Aquitaine;86;2;12;117;Jouhet;527;7;534
75;Nouvelle-Aquitaine;86;2;12;118;Journet;369;8;377
75;Nouvelle-Aquitaine;86;2;06;119;Joussé;303;4;307
75;Nouvelle-Aquitaine;86;2;12;120;Lathus-Saint-Rémy;1217;21;1238
75;Nouvelle-Aquitaine;86;3;19;121;Latillé;1440;26;1466
75;Nouvelle-Aquitaine;86;2;05;122;Lauthiers;68;3;71
75;Nouvelle-Aquitaine;86;3;01;124;Lavoux;1180;19;1199
75;Nouvelle-Aquitaine;86;1;04;125;Leigné-les-Bois;592;12;604
75;Nouvelle-Aquitaine;86;1;03;127;Leigné-sur-Usseau;475;3;478
75;Nouvelle-Aquitaine;86;2;05;126;Leignes-sur-Fontaine;637;13;650
75;Nouvelle-Aquitaine;86;1;02;128;Lencloître;2456;30;2486
75;Nouvelle-Aquitaine;86;1;04;129;Lésigny;537;2;539
75;Nouvelle-Aquitaine;86;1;03;130;Leugny;407;4;411
75;Nouvelle-Aquitaine;86;2;10;131;Lhommaizé;859;23;882
75;Nouvelle-Aquitaine;86;2;12;132;Liglet;312;3;315
75;Nouvelle-Aquitaine;86;3;17;133;Ligugé;3349;61;3410
75;Nouvelle-Aquitaine;86;2;06;134;Linazay;225;5;230
75;Nouvelle-Aquitaine;86;3;01;135;Liniers;561;11;572
75;Nouvelle-Aquitaine;86;2;06;136;Lizant;404;8;412
75;Nouvelle-Aquitaine;86;1;08;137;Loudun;6747;344;7091
75;Nouvelle-Aquitaine;86;2;10;138;Luchapt;249;2;251
75;Nouvelle-Aquitaine;86;3;09;139;Lusignan;2649;37;2686
75;Nouvelle-Aquitaine;86;2;10;140;Lussac-les-Châteaux;2318;45;2363
75;Nouvelle-Aquitaine;86;2;06;141;Magné;675;15;690
75;Nouvelle-Aquitaine;86;3;19;142;Maillé;668;9;677
75;Nouvelle-Aquitaine;86;1;04;143;Mairé;158;7;165
75;Nouvelle-Aquitaine;86;3;11;144;Maisonneuve;339;8;347
75;Nouvelle-Aquitaine;86;3;18;147;Marigny-Chemereau;601;12;613
75;Nouvelle-Aquitaine;86;3;18;148;Marnay;700;12;712
75;Nouvelle-Aquitaine;86;1;08;149;Martaizé;380;9;389
75;Nouvelle-Aquitaine;86;3;18;145;Marçay;1185;15;1200
75;Nouvelle-Aquitaine;86;3;11;150;Massognes;287;5;292
75;Nouvelle-Aquitaine;86;1;08;151;Maulay;182;7;189
75;Nouvelle-Aquitaine;86;2;06;152;Mauprévoir;603;15;618
75;Nouvelle-Aquitaine;86;2;10;153;Mazerolles;851;13;864
75;Nouvelle-Aquitaine;86;1;08;154;Mazeuil;253;5;258
75;Nouvelle-Aquitaine;86;1;08;156;Messemé;239;6;245
75;Nouvelle-Aquitaine;86;3;16;157;Mignaloux-Beauvoir;4577;174;4751
75;Nouvelle-Aquitaine;86;3;11;158;Migné-Auxances;6071;112;6183
75;Nouvelle-Aquitaine;86;2;10;159;Millac;553;15;568
75;Nouvelle-Aquitaine;86;3;11;160;Mirebeau;2218;33;2251
75;Nouvelle-Aquitaine;86;1;08;161;Moncontour;986;20;1006
75;Nouvelle-Aquitaine;86;1;03;162;Mondion;106;3;109
75;Nouvelle-Aquitaine;86;3;01;163;Montamisé;3630;58;3688
75;Nouvelle-Aquitaine;86;1;05;164;Monthoiron;662;9;671
75;Nouvelle-Aquitaine;86;2;12;165;Montmorillon;5954;462;6416
75;Nouvelle-Aquitaine;86;1;08;167;Monts-sur-Guesnes;895;5;900
75;Nouvelle-Aquitaine;86;1;08;169;Morton;346;5;351
75;Nouvelle-Aquitaine;86;2;12;170;Moulismes;373;11;384
75;Nouvelle-Aquitaine;86;2;10;171;Moussac;442;14;456
75;Nouvelle-Aquitaine;86;1;08;173;Mouterre-Silly;663;12;675
75;Nouvelle-Aquitaine;86;2;10;172;Mouterre-sur-Blourde;166;4;170
75;Nouvelle-Aquitaine;86;1;02;174;Naintré;5911;120;6031
75;Nouvelle-Aquitaine;86;2;12;175;Nalliers;320;10;330
75;Nouvelle-Aquitaine;86;2;10;176;Nérignac;123;4;127
75;Nouvelle-Aquitaine;86;3;11;177;Neuville-de-Poitou;5324;85;5409
75;Nouvelle-Aquitaine;86;3;18;178;Nieuil-l'Espoir;2718;37;2755
75;Nouvelle-Aquitaine;86;3;18;180;Nouaillé-Maupertuis;2751;73;2824
75;Nouvelle-Aquitaine;86;1;08;181;Nueil-sous-Faye;213;5;218
75;Nouvelle-Aquitaine;86;1;03;182;Orches;410;4;414
75;Nouvelle-Aquitaine;86;1;03;183;Les Ormes;1631;22;1653
75;Nouvelle-Aquitaine;86;1;02;184;Ouzilly;919;12;931
75;Nouvelle-Aquitaine;86;1;03;186;Oyré;973;25;998
75;Nouvelle-Aquitaine;86;2;05;187;Paizay-le-Sec;463;14;477
75;Nouvelle-Aquitaine;86;2;06;189;Payroux;490;12;502
75;Nouvelle-Aquitaine;86;2;10;190;Persac;770;19;789
75;Nouvelle-Aquitaine;86;2;12;191;Pindray;254;7;261
75;Nouvelle-Aquitaine;86;2;12;192;Plaisance;166;3;169
75;Nouvelle-Aquitaine;86;1;04;193;Pleumartin;1246;18;1264
75;Nouvelle-Aquitaine;86;3;99;194;Poitiers;88291;2412;90703
75;Nouvelle-Aquitaine;86;1;03;195;Port-de-Piles;566;12;578
75;Nouvelle-Aquitaine;86;1;08;197;Pouant;413;8;421
75;Nouvelle-Aquitaine;86;1;08;196;Pouançay;234;4;238
75;Nouvelle-Aquitaine;86;3;01;198;Pouillé;657;10;667
75;Nouvelle-Aquitaine;86;2;06;200;Pressac;576;4;580
75;Nouvelle-Aquitaine;86;1;08;201;Prinçay;217;2;219
75;Nouvelle-Aquitaine;86;3;12;202;La Puye;606;10;616
75;Nouvelle-Aquitaine;86;2;10;203;Queaux;524;13;537
75;Nouvelle-Aquitaine;86;3;19;204;Quinçay;2215;44;2259
75;Nouvelle-Aquitaine;86;1;08;205;Ranton;193;3;196
75;Nouvelle-Aquitaine;86;1;08;206;Raslay;132;5;137
75;Nouvelle-Aquitaine;86;1;04;207;La Roche-Posay;1561;30;1591
75;Nouvelle-Aquitaine;86;1;08;079;La Roche-Rigault;556;36;592
75;Nouvelle-Aquitaine;86;3;18;209;Roches-Prémarie-Andillé;2021;33;2054
75;Nouvelle-Aquitaine;86;1;08;210;Roiffé;759;11;770
75;Nouvelle-Aquitaine;86;2;09;211;Romagne;887;92;979
75;Nouvelle-Aquitaine;86;3;09;213;Rouillé;2468;203;2671
75;Nouvelle-Aquitaine;86;3;17;214;Saint-Benoît;7233;243;7476
75;Nouvelle-Aquitaine;86;1;03;217;Saint-Christophe;302;12;314
75;Nouvelle-Aquitaine;86;1;08;218;Saint-Clair;196;7;203
75;Nouvelle-Aquitaine;86;2;06;220;Saint-Gaudent;310;7;317
75;Nouvelle-Aquitaine;86;1;02;221;Saint-Genest-d'Ambière;1248;23;1271
75;Nouvelle-Aquitaine;86;3;07;222;Saint-Georges-lès-Baillargeaux;4168;65;4233
75;Nouvelle-Aquitaine;86;2;12;223;Saint-Germain;928;25;953
75;Nouvelle-Aquitaine;86;1;03;224;Saint-Gervais-les-Trois-Clochers;1314;25;1339
75;Nouvelle-Aquitaine;86;1;08;225;Saint-Jean-de-Sauves;1389;28;1417
75;Nouvelle-Aquitaine;86;3;01;226;Saint-Julien-l'Ars;2660;47;2707
75;Nouvelle-Aquitaine;86;1;08;227;Saint-Laon;126;4;130
75;Nouvelle-Aquitaine;86;2;10;228;Saint-Laurent-de-Jourdes;200;3;203
75;Nouvelle-Aquitaine;86;1;08;229;Saint-Léger-de-Montbrillais;349;5;354
75;Nouvelle-Aquitaine;86;2;12;230;Saint-Léomer;183;3;186
75;Nouvelle-Aquitaine;86;2;06;231;Saint-Macoux;474;17;491
75;Nouvelle-Aquitaine;86;2;06;234;Saint-Martin-l'Ars;386;4;390
75;Nouvelle-Aquitaine;86;3;88;281;Saint-Martin-la-Pallu;5546;96;5642
75;Nouvelle-Aquitaine;86;2;10;235;Saint-Maurice-la-Clouère;1312;35;1347
75;Nouvelle-Aquitaine;86;2;06;237;Saint-Pierre-d'Exideuil;754;18;772
75;Nouvelle-Aquitaine;86;2;12;236;Saint-Pierre-de-Maillé;881;16;897
75;Nouvelle-Aquitaine;86;1;03;241;Saint-Rémy-sur-Creuse;392;6;398
75;Nouvelle-Aquitaine;86;2;06;242;Saint-Romain;396;9;405
75;Nouvelle-Aquitaine;86;3;09;244;Saint-Sauvant;1258;25;1283
75;Nouvelle-Aquitaine;86;2;12;246;Saint-Savin;846;16;862
75;Nouvelle-Aquitaine;86;2;06;247;Saint-Saviol;532;8;540
75;Nouvelle-Aquitaine;86;2;10;248;Saint-Secondin;546;15;561
75;Nouvelle-Aquitaine;86;3;05;239;Sainte-Radégonde;169;0;169
75;Nouvelle-Aquitaine;86;1;08;249;Saires;132;6;138
75;Nouvelle-Aquitaine;86;1;08;250;Saix;290;5;295
75;Nouvelle-Aquitaine;86;1;08;252;Sammarçolles;642;13;655
75;Nouvelle-Aquitaine;86;3;09;253;Sanxay;548;11;559
75;Nouvelle-Aquitaine;86;2;12;254;Saulgé;1013;12;1025
75;Nouvelle-Aquitaine;86;2;06;255;Savigné;1336;29;1365
75;Nouvelle-Aquitaine;86;3;01;256;Savigny-Lévescault;1168;26;1194
75;Nouvelle-Aquitaine;86;1;03;257;Savigny-sous-Faye;383;5;388
75;Nouvelle-Aquitaine;86;1;02;258;Scorbé-Clairvaux;2259;31;2290
75;Nouvelle-Aquitaine;86;1;04;245;Senillé-Saint-Sauveur;1877;42;1919
75;Nouvelle-Aquitaine;86;1;03;260;Sérigny;312;1;313
75;Nouvelle-Aquitaine;86;3;01;261;Sèvres-Anxaumont;2181;79;2260
75;Nouvelle-Aquitaine;86;2;10;262;Sillars;611;14;625
75;Nouvelle-Aquitaine;86;3;18;263;Smarves;2810;41;2851
75;Nouvelle-Aquitaine;86;2;06;264;Sommières-du-Clain;788;17;805
75;Nouvelle-Aquitaine;86;1;03;265;Sossais;438;3;441
75;Nouvelle-Aquitaine;86;2;06;266;Surin;133;2;135
75;Nouvelle-Aquitaine;86;3;01;268;Tercé;1116;16;1132
75;Nouvelle-Aquitaine;86;1;08;269;Ternay;184;3;187
75;Nouvelle-Aquitaine;86;2;12;270;Thollet;156;3;159
75;Nouvelle-Aquitaine;86;3;11;271;Thurageau;814;14;828
75;Nouvelle-Aquitaine;86;1;02;272;Thuré;2878;152;3030
75;Nouvelle-Aquitaine;86;2;12;273;La Trimouille;889;23;912
75;Nouvelle-Aquitaine;86;1;08;274;Les Trois-Moutiers;1074;22;1096
75;Nouvelle-Aquitaine;86;1;03;275;Usseau;607;9;616
75;Nouvelle-Aquitaine;86;2;10;276;Usson-du-Poitou;1260;21;1281
75;Nouvelle-Aquitaine;86;2;05;233;Valdivienne;2747;42;2789
75;Nouvelle-Aquitaine;86;2;09;082;Valence-en-Poitou;4474;117;4591
75;Nouvelle-Aquitaine;86;1;03;279;Vaux-sur-Vienne;546;6;552
75;Nouvelle-Aquitaine;86;1;03;280;Vellèches;363;5;368
75;Nouvelle-Aquitaine;86;3;18;284;Vernon;704;20;724
75;Nouvelle-Aquitaine;86;2;10;285;Verrières;1004;30;1034
75;Nouvelle-Aquitaine;86;1;08;286;Verrue;391;2;393
75;Nouvelle-Aquitaine;86;1;08;287;Vézières;357;6;363
75;Nouvelle-Aquitaine;86;1;04;288;Vicq-sur-Gartempe;615;7;622
75;Nouvelle-Aquitaine;86;2;10;289;Le Vigeant;699;27;726
75;Nouvelle-Aquitaine;86;3;18;290;La Villedieu-du-Clain;1592;30;1622
75;Nouvelle-Aquitaine;86;2;12;291;Villemort;103;7;110
75;Nouvelle-Aquitaine;86;3;11;292;Villiers;893;17;910
75;Nouvelle-Aquitaine;86;3;18;293;Vivonne;4345;78;4423
75;Nouvelle-Aquitaine;86;3;19;294;Vouillé;3701;54;3755
75;Nouvelle-Aquitaine;86;2;06;295;Voulême;378;4;382
75;Nouvelle-Aquitaine;86;2;09;296;Voulon;467;7;474
75;Nouvelle-Aquitaine;86;3;19;297;Vouneuil-sous-Biard;5896;132;6028
75;Nouvelle-Aquitaine;86;1;05;298;Vouneuil-sur-Vienne;2198;31;2229
75;Nouvelle-Aquitaine;86;3;11;299;Vouzailles;600;7;607
75;Nouvelle-Aquitaine;86;3;11;300;Yversay;529;4;533
75;Nouvelle-Aquitaine;87;2;01;001;Aixe-sur-Vienne;5836;80;5916
75;Nouvelle-Aquitaine;87;2;02;002;Ambazac;5667;74;5741
75;Nouvelle-Aquitaine;87;1;04;003;Arnac-la-Poste;951;26;977
75;Nouvelle-Aquitaine;87;2;07;004;Augne;108;2;110
75;Nouvelle-Aquitaine;87;2;20;005;Aureil;1004;20;1024
75;Nouvelle-Aquitaine;87;1;04;006;Azat-le-Ris;257;2;259
75;Nouvelle-Aquitaine;87;1;04;007;Balledent;197;6;203
75;Nouvelle-Aquitaine;87;1;04;008;La Bazeuge;140;2;142
75;Nouvelle-Aquitaine;87;2;07;009;Beaumont-du-Lac;143;5;148
75;Nouvelle-Aquitaine;87;1;03;011;Bellac;3808;147;3955
75;Nouvelle-Aquitaine;87;1;03;012;Berneuil;426;5;431
75;Nouvelle-Aquitaine;87;2;02;013;Bersac-sur-Rivalier;631;18;649
75;Nouvelle-Aquitaine;87;1;02;014;Bessines-sur-Gartempe;2836;45;2881
75;Nouvelle-Aquitaine;87;2;01;015;Beynac;693;73;766
75;Nouvelle-Aquitaine;87;2;02;016;Les Billanges;288;6;294
75;Nouvelle-Aquitaine;87;1;03;017;Blanzac;495;12;507
75;Nouvelle-Aquitaine;87;1;03;018;Blond;693;24;717
75;Nouvelle-Aquitaine;87;2;05;019;Boisseuil;2928;54;2982
75;Nouvelle-Aquitaine;87;2;02;020;Bonnac-la-Côte;1701;29;1730
75;Nouvelle-Aquitaine;87;2;01;021;Bosmie-l'Aiguille;2579;35;2614
75;Nouvelle-Aquitaine;87;1;03;022;Breuilaufa;129;1;130
75;Nouvelle-Aquitaine;87;1;03;023;Le Buis;189;4;193
75;Nouvelle-Aquitaine;87;2;07;024;Bujaleuf;833;9;842
75;Nouvelle-Aquitaine;87;2;01;025;Burgnac;841;11;852
75;Nouvelle-Aquitaine;87;2;21;027;Bussière-Galant;1308;17;1325
75;Nouvelle-Aquitaine;87;2;21;029;Les Cars;632;11;643
75;Nouvelle-Aquitaine;87;3;19;030;Chaillac-sur-Vienne;1235;22;1257
75;Nouvelle-Aquitaine;87;2;21;031;Le Chalard;312;4;316
75;Nouvelle-Aquitaine;87;2;21;032;Châlus;1621;28;1649
75;Nouvelle-Aquitaine;87;1;03;033;Chamboret;789;10;799
75;Nouvelle-Aquitaine;87;3;18;034;Champagnac-la-Rivière;577;8;585
75;Nouvelle-Aquitaine;87;2;20;035;Champnétery;550;1;551
75;Nouvelle-Aquitaine;87;3;18;036;Champsac;671;11;682
75;Nouvelle-Aquitaine;87;3;18;037;La Chapelle-Montbrandeix;256;2;258
75;Nouvelle-Aquitaine;87;2;06;038;Chaptelat;2121;18;2139
75;Nouvelle-Aquitaine;87;2;07;039;Château-Chervix;799;13;812
75;Nouvelle-Aquitaine;87;2;07;040;Châteauneuf-la-Forêt;1524;20;1544
75;Nouvelle-Aquitaine;87;1;04;041;Châteauponsac;2035;24;2059
75;Nouvelle-Aquitaine;87;2;20;042;Le Châtenet-en-Dognon;393;7;400
75;Nouvelle-Aquitaine;87;2;07;043;Cheissoux;177;2;179
75;Nouvelle-Aquitaine;87;3;18;044;Chéronnac;336;4;340
75;Nouvelle-Aquitaine;87;1;03;045;Cieux;989;13;1002
75;Nouvelle-Aquitaine;87;3;18;046;Cognac-la-Forêt;1185;9;1194
75;Nouvelle-Aquitaine;87;1;03;047;Compreignac;1838;16;1854
75;Nouvelle-Aquitaine;87;2;05;048;Condat-sur-Vienne;5150;79;5229
75;Nouvelle-Aquitaine;87;2;07;049;Coussac-Bonneval;1317;34;1351
75;Nouvelle-Aquitaine;87;2;06;050;Couzeix;9268;158;9426
75;Nouvelle-Aquitaine;87;2;07;051;La Croisille-sur-Briance;641;13;654
75;Nouvelle-Aquitaine;87;1;04;052;La Croix-sur-Gartempe;188;1;189
75;Nouvelle-Aquitaine;87;1;04;053;Cromac;246;2;248
75;Nouvelle-Aquitaine;87;3;18;054;Cussac;1235;24;1259
75;Nouvelle-Aquitaine;87;1;04;056;Dinsac;271;6;277
75;Nouvelle-Aquitaine;87;1;04;057;Dompierre-les-Églises;367;5;372
75;Nouvelle-Aquitaine;87;2;07;058;Domps;118;1;119
75;Nouvelle-Aquitaine;87;1;04;059;Le Dorat;1683;68;1751
75;Nouvelle-Aquitaine;87;3;18;060;Dournazac;657;9;666
75;Nouvelle-Aquitaine;87;1;04;061;Droux;350;6;356
75;Nouvelle-Aquitaine;87;2;20;062;Eybouleuf;436;8;444
75;Nouvelle-Aquitaine;87;2;05;063;Eyjeaux;1321;28;1349
75;Nouvelle-Aquitaine;87;2;07;064;Eymoutiers;2062;22;2084
75;Nouvelle-Aquitaine;87;2;17;065;Feytiat;6123;85;6208
75;Nouvelle-Aquitaine;87;2;21;066;Flavignac;1061;12;1073
75;Nouvelle-Aquitaine;87;1;02;067;Folles;486;9;495
75;Nouvelle-Aquitaine;87;1;02;068;Fromental;540;17;557
75;Nouvelle-Aquitaine;87;1;03;069;Gajoubert;145;1;146
75;Nouvelle-Aquitaine;87;2;20;070;La Geneytouse;958;15;973
75;Nouvelle-Aquitaine;87;2;21;071;Glandon;781;18;799
75;Nouvelle-Aquitaine;87;2;07;072;Glanges;512;10;522
75;Nouvelle-Aquitaine;87;3;18;073;Gorre;401;9;410
75;Nouvelle-Aquitaine;87;1;04;074;Les Grands-Chézeaux;246;2;248
75;Nouvelle-Aquitaine;87;2;16;075;Isle;7696;146;7842
75;Nouvelle-Aquitaine;87;2;02;076;Jabreilles-les-Bordes;239;2;241
75;Nouvelle-Aquitaine;87;2;21;077;Janailhac;536;9;545
75;Nouvelle-Aquitaine;87;3;19;078;Javerdat;717;5;722
75;Nouvelle-Aquitaine;87;2;02;079;La Jonchère-Saint-Maurice;824;11;835
75;Nouvelle-Aquitaine;87;1;04;080;Jouac;181;4;185
75;Nouvelle-Aquitaine;87;2;01;081;Jourgnac;1110;20;1130
75;Nouvelle-Aquitaine;87;2;21;082;Ladignac-le-Long;1168;12;1180
75;Nouvelle-Aquitaine;87;2;02;083;Laurière;568;4;572
75;Nouvelle-Aquitaine;87;2;21;084;Lavignac;153;4;157
75;Nouvelle-Aquitaine;87;2;99;085;Limoges;132175;2285;134460
75;Nouvelle-Aquitaine;87;2;07;086;Linards;1057;17;1074
75;Nouvelle-Aquitaine;87;1;04;087;Lussac-les-Églises;532;11;543
75;Nouvelle-Aquitaine;87;2;07;088;Magnac-Bourg;1089;12;1101
75;Nouvelle-Aquitaine;87;1;04;089;Magnac-Laval;1744;150;1894
75;Nouvelle-Aquitaine;87;1;04;090;Mailhac-sur-Benaize;270;5;275
75;Nouvelle-Aquitaine;87;3;18;091;Maisonnais-sur-Tardoire;390;7;397
75;Nouvelle-Aquitaine;87;3;18;092;Marval;540;6;546
75;Nouvelle-Aquitaine;87;2;07;093;Masléon;284;2;286
75;Nouvelle-Aquitaine;87;2;21;094;Meilhac;529;5;534
75;Nouvelle-Aquitaine;87;2;07;095;Meuzac;731;14;745
75;Nouvelle-Aquitaine;87;2;21;096;La Meyze;828;20;848
75;Nouvelle-Aquitaine;87;2;20;099;Moissannes;360;16;376
75;Nouvelle-Aquitaine;87;1;03;100;Montrol-Sénard;278;7;285
75;Nouvelle-Aquitaine;87;1;03;101;Mortemart;112;1;113
75;Nouvelle-Aquitaine;87;1;03;103;Nantiat;1598;24;1622
75;Nouvelle-Aquitaine;87;2;07;104;Nedde;464;5;469
75;Nouvelle-Aquitaine;87;2;07;105;Neuvic-Entier;929;17;946
75;Nouvelle-Aquitaine;87;2;21;106;Nexon;2539;46;2585
75;Nouvelle-Aquitaine;87;2;06;107;Nieul;1647;18;1665
75;Nouvelle-Aquitaine;87;1;03;108;Nouic;467;6;473
75;Nouvelle-Aquitaine;87;1;04;109;Oradour-Saint-Genest;333;35;368
75;Nouvelle-Aquitaine;87;3;19;110;Oradour-sur-Glane;2473;22;2495
75;Nouvelle-Aquitaine;87;3;18;111;Oradour-sur-Vayres;1500;20;1520
75;Nouvelle-Aquitaine;87;2;21;112;Pageas;580;13;593
75;Nouvelle-Aquitaine;87;2;12;113;Le Palais-sur-Vienne;6042;65;6107
75;Nouvelle-Aquitaine;87;2;17;114;Panazol;10972;208;11180
75;Nouvelle-Aquitaine;87;3;18;115;Pensol;180;2;182
75;Nouvelle-Aquitaine;87;1;03;116;Peyrat-de-Bellac;1065;24;1089
75;Nouvelle-Aquitaine;87;2;07;117;Peyrat-le-Château;1013;17;1030
75;Nouvelle-Aquitaine;87;2;06;118;Peyrilhac;1270;13;1283
75;Nouvelle-Aquitaine;87;2;05;119;Pierre-Buffière;1157;11;1168
75;Nouvelle-Aquitaine;87;2;07;120;La Porcherie;514;11;525
75;Nouvelle-Aquitaine;87;1;04;121;Rancon;494;11;505
75;Nouvelle-Aquitaine;87;1;02;122;Razès;1173;13;1186
75;Nouvelle-Aquitaine;87;2;07;123;Rempnat;149;4;153
75;Nouvelle-Aquitaine;87;2;21;124;Rilhac-Lastours;371;3;374
75;Nouvelle-Aquitaine;87;2;12;125;Rilhac-Rancon;4573;69;4642
75;Nouvelle-Aquitaine;87;2;21;127;La Roche-l'Abeille;618;10;628
75;Nouvelle-Aquitaine;87;3;18;126;Rochechouart;3778;49;3827
75;Nouvelle-Aquitaine;87;2;20;129;Royères;915;6;921
75;Nouvelle-Aquitaine;87;2;07;130;Roziers-Saint-Georges;180;1;181
75;Nouvelle-Aquitaine;87;3;19;131;Saillat-sur-Vienne;832;12;844
75;Nouvelle-Aquitaine;87;2;07;132;Saint-Amand-le-Petit;108;4;112
75;Nouvelle-Aquitaine;87;1;04;133;Saint-Amand-Magnazeix;523;8;531
75;Nouvelle-Aquitaine;87;3;18;135;Saint-Auvent;962;18;980
75;Nouvelle-Aquitaine;87;3;18;137;Saint-Bazile;112;1;113
75;Nouvelle-Aquitaine;87;2;05;138;Saint-Bonnet-Briance;574;14;588
75;Nouvelle-Aquitaine;87;1;03;139;Saint-Bonnet-de-Bellac;484;8;492
75;Nouvelle-Aquitaine;87;3;19;140;Saint-Brice-sur-Vienne;1669;17;1686
75;Nouvelle-Aquitaine;87;3;18;141;Saint-Cyr;693;8;701
75;Nouvelle-Aquitaine;87;2;20;142;Saint-Denis-des-Murs;529;7;536
75;Nouvelle-Aquitaine;87;2;06;143;Saint-Gence;2134;27;2161
75;Nouvelle-Aquitaine;87;2;05;144;Saint-Genest-sur-Roselle;520;5;525
75;Nouvelle-Aquitaine;87;1;04;145;Saint-Georges-les-Landes;239;1;240
75;Nouvelle-Aquitaine;87;2;07;146;Saint-Germain-les-Belles;1169;13;1182
75;Nouvelle-Aquitaine;87;2;07;147;Saint-Gilles-les-Forêts;43;2;45
75;Nouvelle-Aquitaine;87;2;05;148;Saint-Hilaire-Bonneval;988;12;1000
75;Nouvelle-Aquitaine;87;1;04;149;Saint-Hilaire-la-Treille;381;9;390
75;Nouvelle-Aquitaine;87;2;21;150;Saint-Hilaire-les-Places;870;14;884
75;Nouvelle-Aquitaine;87;2;05;151;Saint-Jean-Ligoure;515;9;524
75;Nouvelle-Aquitaine;87;2;06;152;Saint-Jouvent;1659;23;1682
75;Nouvelle-Aquitaine;87;2;07;153;Saint-Julien-le-Petit;288;0;288
75;Nouvelle-Aquitaine;87;3;19;154;Saint-Junien;11202;273;11475
75;Nouvelle-Aquitaine;87;1;03;155;Saint-Junien-les-Combes;174;7;181
75;Nouvelle-Aquitaine;87;2;20;156;Saint-Just-le-Martel;2677;46;2723
75;Nouvelle-Aquitaine;87;2;02;157;Saint-Laurent-les-Églises;865;37;902
75;Nouvelle-Aquitaine;87;3;18;158;Saint-Laurent-sur-Gorre;1500;20;1520
75;Nouvelle-Aquitaine;87;2;02;159;Saint-Léger-la-Montagne;348;5;353
75;Nouvelle-Aquitaine;87;1;04;160;Saint-Léger-Magnazeix;490;7;497
75;Nouvelle-Aquitaine;87;2;20;161;Saint-Léonard-de-Noblat;4554;112;4666
75;Nouvelle-Aquitaine;87;1;03;163;Saint-Martial-sur-Isop;136;4;140
75;Nouvelle-Aquitaine;87;3;19;164;Saint-Martin-de-Jussac;565;9;574
75;Nouvelle-Aquitaine;87;1;04;165;Saint-Martin-le-Mault;130;0;130
75;Nouvelle-Aquitaine;87;2;01;166;Saint-Martin-le-Vieux;922;16;938
75;Nouvelle-Aquitaine;87;2;20;167;Saint-Martin-Terressus;557;5;562
75;Nouvelle-Aquitaine;87;3;18;168;Saint-Mathieu;1080;15;1095
75;Nouvelle-Aquitaine;87;2;05;169;Saint-Maurice-les-Brousses;1060;7;1067
75;Nouvelle-Aquitaine;87;2;07;170;Saint-Méard;357;7;364
75;Nouvelle-Aquitaine;87;1;04;172;Saint-Ouen-sur-Gartempe;214;4;218
75;Nouvelle-Aquitaine;87;1;89;128;Saint-Pardoux-le-Lac;1322;16;1338
75;Nouvelle-Aquitaine;87;2;05;174;Saint-Paul;1236;23;1259
75;Nouvelle-Aquitaine;87;2;07;176;Saint-Priest-Ligoure;668;12;680
75;Nouvelle-Aquitaine;87;2;01;177;Saint-Priest-sous-Aixe;1746;20;1766
75;Nouvelle-Aquitaine;87;2;20;178;Saint-Priest-Taurion;2881;33;2914
75;Nouvelle-Aquitaine;87;1;04;179;Saint-Sornin-la-Marche;258;2;260
75;Nouvelle-Aquitaine;87;1;04;180;Saint-Sornin-Leulac;634;8;642
75;Nouvelle-Aquitaine;87;2;02;181;Saint-Sulpice-Laurière;837;20;857
75;Nouvelle-Aquitaine;87;1;04;182;Saint-Sulpice-les-Feuilles;1240;22;1262
75;Nouvelle-Aquitaine;87;2;02;183;Saint-Sylvestre;924;10;934
75;Nouvelle-Aquitaine;87;3;19;185;Saint-Victurnien;1755;29;1784
75;Nouvelle-Aquitaine;87;2;07;186;Saint-Vitte-sur-Briance;330;4;334
75;Nouvelle-Aquitaine;87;2;21;187;Saint-Yrieix-la-Perche;6766;433;7199
75;Nouvelle-Aquitaine;87;2;01;188;Saint-Yrieix-sous-Aixe;421;3;424
75;Nouvelle-Aquitaine;87;2;07;134;Sainte-Anne-Saint-Priest;168;2;170
75;Nouvelle-Aquitaine;87;3;18;162;Sainte-Marie-de-Vaux;209;3;212
75;Nouvelle-Aquitaine;87;3;18;189;Les Salles-Lavauguyon;144;1;145
75;Nouvelle-Aquitaine;87;2;20;190;Sauviat-sur-Vige;889;7;896
75;Nouvelle-Aquitaine;87;2;01;191;Séreilhac;1992;22;2014
75;Nouvelle-Aquitaine;87;2;05;192;Solignac;1579;23;1602
75;Nouvelle-Aquitaine;87;2;07;193;Surdoux;44;3;47
75;Nouvelle-Aquitaine;87;2;07;194;Sussac;351;3;354
75;Nouvelle-Aquitaine;87;1;04;195;Tersannes;138;2;140
75;Nouvelle-Aquitaine;87;1;03;197;Thouron;532;9;541
75;Nouvelle-Aquitaine;87;1;03;097;Val d'Issoire;1068;12;1080
75;Nouvelle-Aquitaine;87;1;88;028;Val-d'Oire-et-Gartempe;1671;35;1706
75;Nouvelle-Aquitaine;87;1;03;198;Vaulry;409;5;414
75;Nouvelle-Aquitaine;87;3;18;199;Vayres;750;16;766
75;Nouvelle-Aquitaine;87;1;04;200;Verneuil-Moustiers;128;0;128
75;Nouvelle-Aquitaine;87;2;01;201;Verneuil-sur-Vienne;4889;215;5104
75;Nouvelle-Aquitaine;87;2;06;202;Veyrac;2071;34;2105
75;Nouvelle-Aquitaine;87;2;07;203;Vicq-sur-Breuilh;1324;25;1349
75;Nouvelle-Aquitaine;87;3;18;204;Videix;211;3;214
75;Nouvelle-Aquitaine;87;2;05;205;Le Vigen;2171;41;2212
75;Nouvelle-Aquitaine;87;1;04;206;Villefavard;158;1;159
44;Grand Est;88;1;04;001;Les Ableuvenettes;62;0;62
44;Grand Est;88;1;04;002;Ahéville;69;0;69
44;Grand Est;88;2;17;003;Aingeville;61;2;63
44;Grand Est;88;2;04;004;Ainvelle;142;6;148
44;Grand Est;88;3;11;005;Allarmont;211;4;215
44;Grand Est;88;1;09;006;Ambacourt;297;8;305
44;Grand Est;88;2;04;007;Ameuvelle;49;0;49
44;Grand Est;88;1;11;008;Anglemont;167;3;170
44;Grand Est;88;3;07;009;Anould;3369;68;3437
44;Grand Est;88;2;09;010;Aouze;191;1;192
44;Grand Est;88;1;05;011;Arches;1638;53;1691
44;Grand Est;88;1;06;012;Archettes;1085;13;1098
44;Grand Est;88;2;09;013;Aroffe;80;0;80
44;Grand Est;88;3;07;014;Arrentès-de-Corcieux;179;5;184
44;Grand Est;88;2;10;015;Attignéville;217;3;220
44;Grand Est;88;2;04;016;Attigny;230;6;236
44;Grand Est;88;2;17;017;Aulnois;161;6;167
44;Grand Est;88;2;10;019;Autigny-la-Tour;159;3;162
44;Grand Est;88;2;10;020;Autreville;183;5;188
44;Grand Est;88;1;13;021;Autrey;286;10;296
44;Grand Est;88;2;17;022;Auzainvilliers;228;6;234
44;Grand Est;88;1;03;023;Avillers;84;2;86
44;Grand Est;88;1;03;024;Avrainville;111;0;111
44;Grand Est;88;2;10;025;Avranville;70;4;74
44;Grand Est;88;1;02;026;Aydoilles;1028;49;1077
44;Grand Est;88;1;02;027;Badménil-aux-Bois;154;6;160
44;Grand Est;88;1;06;028;La Baffe;634;95;729
44;Grand Est;88;1;04;030;Bainville-aux-Saules;137;0;137
44;Grand Est;88;2;09;031;Balléville;102;4;106
44;Grand Est;88;3;14;032;Ban-de-Laveline;1211;33;1244
44;Grand Est;88;3;11;033;Ban-de-Sapt;348;11;359
44;Grand Est;88;3;07;106;Ban-sur-Meurthe-Clefcy;949;28;977
44;Grand Est;88;3;07;035;Barbey-Seroux;148;4;152
44;Grand Est;88;2;10;036;Barville;91;1;92
44;Grand Est;88;3;01;037;Basse-sur-le-Rupt;864;27;891
44;Grand Est;88;1;03;038;Battexey;34;0;34
44;Grand Est;88;1;09;039;Baudricourt;328;6;334
44;Grand Est;88;1;02;040;Bayecourt;255;5;260
44;Grand Est;88;1;04;041;Bazegney;113;2;115
44;Grand Est;88;1;11;042;Bazien;78;1;79
44;Grand Est;88;2;17;043;Bazoilles-et-Ménil;114;4;118
44;Grand Est;88;2;10;044;Bazoilles-sur-Meuse;598;16;614
44;Grand Est;88;2;10;045;Beaufremont;90;0;90
44;Grand Est;88;1;02;046;Beauménil;125;4;129
44;Grand Est;88;1;04;047;Begnécourt;157;7;164
44;Grand Est;88;1;16;048;Bellefontaine;992;10;1002
44;Grand Est;88;2;04;049;Belmont-lès-Darney;112;2;114
44;Grand Est;88;1;02;050;Belmont-sur-Buttant;302;5;307
44;Grand Est;88;2;17;051;Belmont-sur-Vair;128;1;129
44;Grand Est;88;2;04;052;Belrupt;102;5;107
44;Grand Est;88;3;11;053;Belval;156;2;158
44;Grand Est;88;3;14;054;Bertrimoutier;310;10;320
44;Grand Est;88;1;03;055;Bettegney-Saint-Brice;169;2;171
44;Grand Est;88;1;03;056;Bettoncourt;96;1;97
44;Grand Est;88;3;14;057;Le Beulay;97;6;103
44;Grand Est;88;1;09;058;Biécourt;103;2;105
44;Grand Est;88;3;02;059;Biffontaine;408;12;420
44;Grand Est;88;1;09;060;Blémerey;28;1;29
44;Grand Est;88;2;04;061;Bleurville;308;12;320
44;Grand Est;88;2;04;062;Blevaincourt;108;1;109
44;Grand Est;88;1;04;063;Bocquegney;134;4;138
44;Grand Est;88;3;02;064;Bois-de-Champ;111;1;112
44;Grand Est;88;2;04;065;Bonvillet;300;5;305
44;Grand Est;88;1;09;066;Boulaincourt;71;3;74
44;Grand Est;88;3;13;068;La Bourgonce;896;21;917
44;Grand Est;88;1;03;069;Bouxières-aux-Bois;139;6;145
44;Grand Est;88;1;03;070;Bouxurulles;170;1;171
44;Grand Est;88;1;04;071;Bouzemont;52;1;53
44;Grand Est;88;1;03;073;Brantigny;211;4;215
44;Grand Est;88;2;10;074;Brechainville;61;0;61
44;Grand Est;88;3;01;075;La Bresse;4154;150;4304
44;Grand Est;88;1;02;076;Brouvelieures;446;8;454
44;Grand Est;88;1;11;077;Brû;562;13;575
44;Grand Est;88;1;02;078;Bruyères;3064;53;3117
44;Grand Est;88;2;17;079;Bulgnéville;1549;87;1636
44;Grand Est;88;1;03;080;Bult;308;2;310
44;Grand Est;88;1;15;081;Bussang;1383;23;1406
44;Grand Est;88;1;08;465;Capavenir Vosges;8862;239;9101
44;Grand Est;88;3;11;082;Celles-sur-Plaine;821;16;837
44;Grand Est;88;2;10;083;Certilleux;208;12;220
44;Grand Est;88;1;03;084;Chamagne;465;8;473
44;Grand Est;88;1;02;086;Champ-le-Duc;544;18;562
44;Grand Est;88;3;02;085;Champdray;179;0;179
44;Grand Est;88;1;05;087;Chantraine;3212;81;3293
44;Grand Est;88;1;16;088;La Chapelle-aux-Bois;668;8;676
44;Grand Est;88;3;07;089;La Chapelle-devant-Bruyères;576;13;589
44;Grand Est;88;1;03;090;Charmes;4689;53;4742
44;Grand Est;88;1;02;091;Charmois-devant-Bruyères;393;7;400
44;Grand Est;88;1;16;092;Charmois-l'Orgueilleux;587;8;595
44;Grand Est;88;3;11;093;Châtas;50;2;52
44;Grand Est;88;1;03;094;Châtel-sur-Moselle;1702;50;1752
44;Grand Est;88;2;09;095;Châtenois;1706;43;1749
44;Grand Est;88;2;04;096;Châtillon-sur-Saône;131;9;140
44;Grand Est;88;1;09;097;Chauffecourt;42;1;43
44;Grand Est;88;1;05;098;Chaumousey;908;26;934
44;Grand Est;88;1;08;099;Chavelot;1391;31;1422
44;Grand Est;88;1;09;100;Chef-Haut;46;2;48
44;Grand Est;88;1;02;101;Cheniménil;1219;23;1242
44;Grand Est;88;2;10;102;Chermisey;96;1;97
44;Grand Est;88;1;04;103;Circourt;88;2;90
44;Grand Est;88;2;10;104;Circourt-sur-Mouzon;189;10;199
44;Grand Est;88;2;04;105;Claudon;216;4;220
44;Grand Est;88;2;10;107;Clérey-la-Côte;32;0;32
44;Grand Est;88;1;16;108;Le Clerjus;568;16;584
44;Grand Est;88;3;12;109;Cleurie;651;13;664
44;Grand Est;88;1;03;110;Clézentaine;214;5;219
44;Grand Est;88;3;14;111;Coinches;360;3;363
44;Grand Est;88;3;14;113;Combrimont;134;5;139
44;Grand Est;88;2;17;114;Contrexéville;3202;222;3424
44;Grand Est;88;3;07;115;Corcieux;1538;14;1552
44;Grand Est;88;3;01;116;Cornimont;3208;62;3270
44;Grand Est;88;2;09;117;Courcelles-sous-Châtenois;79;1;80
44;Grand Est;88;2;10;118;Coussey;723;20;743
44;Grand Est;88;2;17;119;Crainvilliers;171;2;173
44;Grand Est;88;3;14;120;La Croix-aux-Mines;503;9;512
44;Grand Est;88;1;03;121;Damas-aux-Bois;268;6;274
44;Grand Est;88;1;04;122;Damas-et-Bettegney;366;7;373
44;Grand Est;88;2;04;123;Damblain;254;7;261
44;Grand Est;88;2;04;124;Darney;1092;54;1146
44;Grand Est;88;2;09;125;Darney-aux-Chênes;63;1;64
44;Grand Est;88;1;08;126;Darnieulles;1407;30;1437
44;Grand Est;88;1;03;127;Deinvillers;61;2;63
44;Grand Est;88;3;11;128;Denipaire;247;5;252
44;Grand Est;88;1;03;129;Derbamont;111;3;114
44;Grand Est;88;1;02;130;Destord;256;5;261
44;Grand Est;88;1;02;131;Deycimont;309;8;317
44;Grand Est;88;1;06;132;Deyvillers;1418;39;1457
44;Grand Est;88;1;06;133;Dignonville;190;9;199
44;Grand Est;88;1;05;134;Dinozé;604;13;617
44;Grand Est;88;1;02;135;Docelles;879;18;897
44;Grand Est;88;1;06;136;Dogneville;1486;27;1513
44;Grand Est;88;2;09;137;Dolaincourt;99;0;99
44;Grand Est;88;2;04;138;Dombasle-devant-Darney;81;2;83
44;Grand Est;88;1;09;139;Dombasle-en-Xaintois;124;2;126
44;Grand Est;88;2;17;140;Dombrot-le-Sec;376;14;390
44;Grand Est;88;2;17;141;Dombrot-sur-Vair;245;3;248
44;Grand Est;88;2;17;144;Domèvre-sous-Montfort;57;0;57
44;Grand Est;88;1;08;142;Domèvre-sur-Avière;402;8;410
44;Grand Est;88;1;02;143;Domèvre-sur-Durbion;267;14;281
44;Grand Est;88;1;02;145;Domfaing;216;3;219
44;Grand Est;88;2;17;146;Domjulien;177;2;179
44;Grand Est;88;1;04;147;Dommartin-aux-Bois;394;5;399
44;Grand Est;88;1;15;148;Dommartin-lès-Remiremont;1894;52;1946
44;Grand Est;88;2;04;149;Dommartin-lès-Vallois;55;0;55
44;Grand Est;88;2;09;150;Dommartin-sur-Vraine;307;8;315
44;Grand Est;88;1;04;151;Dompaire;1148;28;1176
44;Grand Est;88;1;02;152;Dompierre;257;13;270
44;Grand Est;88;1;11;153;Domptail;357;1;358
44;Grand Est;88;2;10;154;Domrémy-la-Pucelle;104;2;106
44;Grand Est;88;1;09;155;Domvallier;105;7;112
44;Grand Est;88;1;11;156;Doncières;137;2;139
44;Grand Est;88;1;16;157;Dounoux;855;18;873
44;Grand Est;88;1;12;158;Éloyes;3180;61;3241
44;Grand Est;88;3;14;159;Entre-deux-Eaux;503;8;511
44;Grand Est;88;1;98;160;Épinal;31740;1408;33148
44;Grand Est;88;2;04;161;Escles;436;12;448
44;Grand Est;88;2;04;162;Esley;190;5;195
44;Grand Est;88;1;03;163;Essegney;754;9;763
44;Grand Est;88;2;17;164;Estrennes;89;2;91
44;Grand Est;88;3;11;165;Étival-Clairefontaine;2616;52;2668
44;Grand Est;88;1;03;166;Évaux-et-Ménil;357;3;360
44;Grand Est;88;1;01;167;Faucompierre;240;5;245
44;Grand Est;88;1;03;168;Fauconcourt;132;2;134
44;Grand Est;88;1;02;169;Fays;223;9;232
44;Grand Est;88;1;15;170;Ferdrupt;721;17;738
44;Grand Est;88;2;04;171;Fignévelle;45;1;46
44;Grand Est;88;1;02;172;Fiménil;227;4;231
44;Grand Est;88;1;03;173;Florémont;449;11;460
44;Grand Est;88;1;08;174;Fomerey;158;6;164
44;Grand Est;88;1;02;175;Fontenay;468;21;489
44;Grand Est;88;1;16;176;Fontenoy-le-Château;532;36;568
44;Grand Est;88;3;01;177;La Forge;529;11;540
44;Grand Est;88;1;05;178;Les Forges;1868;70;1938
44;Grand Est;88;2;04;179;Fouchécourt;45;1;46
44;Grand Est;88;2;04;180;Frain;129;7;136
44;Grand Est;88;3;07;181;Fraize;2871;47;2918
44;Grand Est;88;3;14;182;Frapelle;190;5;195
44;Grand Est;88;2;10;183;Frebécourt;313;7;320
44;Grand Est;88;1;02;184;Fremifontaine;469;11;480
44;Grand Est;88;1;09;185;Frenelle-la-Grande;108;4;112
44;Grand Est;88;1;09;186;Frenelle-la-Petite;45;3;48
44;Grand Est;88;2;04;187;Frénois;51;0;51
44;Grand Est;88;1;15;188;Fresse-sur-Moselle;1738;48;1786
44;Grand Est;88;2;10;189;Fréville;145;4;149
44;Grand Est;88;1;08;190;Frizon;515;7;522
44;Grand Est;88;1;04;192;Gelvécourt-et-Adompt;110;1;111
44;Grand Est;88;3;14;193;Gemaingoutte;139;1;140
44;Grand Est;88;2;17;194;Gemmelaincourt;149;12;161
44;Grand Est;88;2;17;195;Gendreville;106;1;107
44;Grand Est;88;3;07;196;Gérardmer;7967;631;8598
44;Grand Est;88;3;01;197;Gerbamont;362;11;373
44;Grand Est;88;3;07;198;Gerbépal;589;12;601
44;Grand Est;88;2;04;199;Gignéville;79;3;82
44;Grand Est;88;1;08;200;Gigney;46;2;48
44;Grand Est;88;1;04;201;Girancourt;896;15;911
44;Grand Est;88;1;03;202;Gircourt-lès-Viéville;184;3;187
44;Grand Est;88;1;02;203;Girecourt-sur-Durbion;342;11;353
44;Grand Est;88;1;16;205;Girmont-Val-d'Ajol;251;16;267
44;Grand Est;88;2;09;206;Gironcourt-sur-Vraine;927;18;945
44;Grand Est;88;2;04;208;Godoncourt;124;4;128
44;Grand Est;88;1;08;209;Golbey;8623;134;8757
44;Grand Est;88;1;04;210;Gorhey;178;6;184
44;Grand Est;88;2;10;212;Grand;360;10;370
44;Grand Est;88;3;14;213;La Grande-Fosse;129;0;129
44;Grand Est;88;3;11;215;Grandrupt;77;2;79
44;Grand Est;88;2;16;214;Grandrupt-de-Bains;81;4;85
44;Grand Est;88;1;02;216;Grandvillers;753;12;765
44;Grand Est;88;3;07;218;Granges-Aumontzey;2665;59;2724
44;Grand Est;88;2;10;219;Greux;157;6;163
44;Grand Est;88;2;04;220;Grignoncourt;40;1;41
44;Grand Est;88;1;16;221;Gruey-lès-Surance;262;8;270
44;Grand Est;88;1;02;222;Gugnécourt;238;19;257
44;Grand Est;88;1;03;223;Gugney-aux-Aulx;161;7;168
44;Grand Est;88;1;03;224;Hadigny-les-Verrières;405;5;410
44;Grand Est;88;1;16;225;Hadol;2368;106;2474
44;Grand Est;88;1;04;226;Hagécourt;120;4;124
44;Grand Est;88;2;17;227;Hagnéville-et-Roncourt;87;1;88
44;Grand Est;88;1;03;228;Haillainville;167;4;171
44;Grand Est;88;2;10;229;Harchéchamp;74;4;78
44;Grand Est;88;1;03;230;Hardancourt;41;0;41
44;Grand Est;88;2;17;231;Haréville;480;18;498
44;Grand Est;88;2;10;232;Harmonville;229;4;233
44;Grand Est;88;1;04;233;Harol;628;57;685
44;Grand Est;88;1;16;236;La Haye;115;0;115
44;Grand Est;88;1;04;237;Hennecourt;361;7;368
44;Grand Est;88;2;04;238;Hennezel;402;7;409
44;Grand Est;88;1;03;239;Hergugney;135;3;138
44;Grand Est;88;1;02;240;Herpelmont;282;2;284
44;Grand Est;88;2;09;241;Houécourt;440;12;452
44;Grand Est;88;2;10;242;Houéville;50;1;51
44;Grand Est;88;1;13;243;Housseras;489;7;496
44;Grand Est;88;3;07;244;La Houssière;587;17;604
44;Grand Est;88;3;11;245;Hurbache;320;14;334
44;Grand Est;88;1;09;246;Hymont;476;14;490
44;Grand Est;88;1;08;247;Igney;1168;25;1193
44;Grand Est;88;2;04;248;Isches;164;4;168
44;Grand Est;88;2;10;249;Jainvillotte;79;3;82
44;Grand Est;88;1;12;250;Jarménil;474;4;478
44;Grand Est;88;1;13;251;Jeanménil;1113;34;1147
44;Grand Est;88;2;04;252;Jésonville;127;7;134
44;Grand Est;88;1;06;253;Jeuxey;687;16;703
44;Grand Est;88;1;03;254;Jorxey;83;1;84
44;Grand Est;88;2;10;255;Jubainville;91;1;92
44;Grand Est;88;1;02;256;Jussarupt;274;4;278
44;Grand Est;88;1;09;257;Juvaincourt;184;3;187
44;Grand Est;88;2;04;258;Lamarche;901;16;917
44;Grand Est;88;2;10;259;Landaville;298;9;307
44;Grand Est;88;1;03;260;Langley;161;2;163
44;Grand Est;88;1;02;261;Laval-sur-Vologne;631;11;642
44;Grand Est;88;1;02;262;Laveline-devant-Bruyères;610;12;622
44;Grand Est;88;1;02;263;Laveline-du-Houx;214;6;220
44;Grand Est;88;1;04;264;Légéville-et-Bonfays;49;3;52
44;Grand Est;88;2;10;265;Lemmecourt;30;0;30
44;Grand Est;88;1;02;266;Lépanges-sur-Vologne;850;19;869
44;Grand Est;88;2;04;267;Lerrain;460;16;476
44;Grand Est;88;3;14;268;Lesseux;151;8;159
44;Grand Est;88;3;07;269;Liézey;286;7;293
44;Grand Est;88;2;10;270;Liffol-le-Grand;2144;56;2200
44;Grand Est;88;2;17;271;Lignéville;315;6;321
44;Grand Est;88;2;04;272;Lironcourt;71;0;71
44;Grand Est;88;1;06;273;Longchamp;456;11;467
44;Grand Est;88;2;09;274;Longchamp-sous-Châtenois;66;5;71
44;Grand Est;88;3;14;275;Lubine;228;2;230
44;Grand Est;88;3;14;276;Lusse;434;3;437
44;Grand Est;88;3;11;277;Luvigny;112;3;115
44;Grand Est;88;2;09;278;Maconcourt;75;1;76
44;Grand Est;88;1;09;279;Madecourt;52;1;53
44;Grand Est;88;1;03;280;Madegney;128;0;128
44;Grand Est;88;1;04;281;Madonne-et-Lamerey;401;12;413
44;Grand Est;88;2;17;283;Malaincourt;85;1;86
44;Grand Est;88;3;14;284;Mandray;589;12;601
44;Grand Est;88;2;17;285;Mandres-sur-Vair;458;121;579
44;Grand Est;88;1;03;286;Marainville-sur-Madon;95;0;95
44;Grand Est;88;2;04;287;Marey;69;1;70
44;Grand Est;88;1;04;288;Maroncourt;9;0;9
44;Grand Est;88;2;04;289;Martigny-les-Bains;803;73;876
44;Grand Est;88;2;10;290;Martigny-les-Gerbonvaux;108;2;110
44;Grand Est;88;2;04;291;Martinvelle;122;3;125
44;Grand Est;88;1;09;292;Mattaincourt;821;19;840
44;Grand Est;88;2;10;293;Maxey-sur-Meuse;227;4;231
44;Grand Est;88;1;08;294;Mazeley;267;3;270
44;Grand Est;88;1;09;295;Mazirot;224;7;231
44;Grand Est;88;2;17;296;Médonville;100;0;100
44;Grand Est;88;1;02;297;Méménil;151;5;156
44;Grand Est;88;1;11;298;Ménarmont;76;0;76
44;Grand Est;88;1;15;302;Le Ménil;1069;24;1093
44;Grand Est;88;3;11;300;Ménil-de-Senones;138;2;140
44;Grand Est;88;2;09;299;Ménil-en-Xaintois;150;1;151
44;Grand Est;88;1;11;301;Ménil-sur-Belvitte;294;11;305
44;Grand Est;88;2;10;303;Midrevaux;222;5;227
44;Grand Est;88;1;09;304;Mirecourt;5246;482;5728
44;Grand Est;88;2;10;305;Moncel-sur-Vair;201;5;206
44;Grand Est;88;3;11;306;Le Mont;51;0;51
44;Grand Est;88;2;04;307;Mont-lès-Lamarche;98;2;100
44;Grand Est;88;2;10;308;Mont-lès-Neufchâteau;300;5;305
44;Grand Est;88;2;17;309;Monthureux-le-Sec;159;9;168
44;Grand Est;88;2;04;310;Monthureux-sur-Saône;879;18;897
44;Grand Est;88;1;16;311;Montmotier;45;1;46
44;Grand Est;88;2;09;312;Morelmaison;207;5;212
44;Grand Est;88;1;03;313;Moriville;433;8;441
44;Grand Est;88;2;04;314;Morizécourt;107;4;111
44;Grand Est;88;3;02;315;Mortagne;170;2;172
44;Grand Est;88;2;17;316;Morville;49;2;51
44;Grand Est;88;3;11;317;Moussey;614;5;619
44;Grand Est;88;1;03;318;Moyemont;223;5;228
44;Grand Est;88;3;11;319;Moyenmoutier;3186;66;3252
44;Grand Est;88;3;14;320;Nayemont-les-Fosses;798;39;837
44;Grand Est;88;2;10;321;Neufchâteau;6664;287;6951
44;Grand Est;88;1;02;322;La Neuveville-devant-Lépanges;499;12;511
44;Grand Est;88;2;09;324;La Neuveville-sous-Châtenois;377;10;387
44;Grand Est;88;2;17;325;La Neuveville-sous-Montfort;180;7;187
44;Grand Est;88;3;14;326;Neuvillers-sur-Fave;339;8;347
44;Grand Est;88;1;03;327;Nomexy;2097;29;2126
44;Grand Est;88;3;11;328;Nompatelize;541;23;564
44;Grand Est;88;2;04;330;Nonville;200;2;202
44;Grand Est;88;1;02;331;Nonzeville;51;2;53
44;Grand Est;88;2;17;332;Norroy;222;6;228
44;Grand Est;88;1;11;333;Nossoncourt;117;1;118
44;Grand Est;88;1;09;334;Oëlleville;306;5;311
44;Grand Est;88;2;17;335;Offroicourt;152;4;156
44;Grand Est;88;2;09;336;Ollainville;67;1;68
44;Grand Est;88;1;03;338;Ortoncourt;89;0;89
44;Grand Est;88;1;02;340;Padoux;514;7;521
44;Grand Est;88;3;14;341;Pair-et-Grandrupt;511;10;521
44;Grand Est;88;1;02;342;Pallegney;170;3;173
44;Grand Est;88;2;17;343;Parey-sous-Montfort;149;4;153
44;Grand Est;88;2;10;344;Pargny-sous-Mureau;182;5;187
44;Grand Est;88;3;14;345;La Petite-Fosse;78;3;81
44;Grand Est;88;3;11;346;La Petite-Raon;751;10;761
44;Grand Est;88;1;04;347;Pierrefitte;123;1;124
44;Grand Est;88;1;02;348;Pierrepont-sur-l'Arentèle;136;2;138
44;Grand Est;88;3;07;349;Plainfaing;1676;27;1703
44;Grand Est;88;2;09;350;Pleuvezain;76;3;79
44;Grand Est;88;1;16;351;Plombières-les-Bains;1678;26;1704
44;Grand Est;88;2;10;352;Pompierre;219;5;224
44;Grand Est;88;2;04;353;Pont-lès-Bonfays;102;3;105
44;Grand Est;88;1;03;354;Pont-sur-Madon;178;0;178
44;Grand Est;88;1;03;355;Portieux;1258;21;1279
44;Grand Est;88;3;02;356;Les Poulières;241;1;242
44;Grand Est;88;1;09;357;Poussay;689;20;709
44;Grand Est;88;1;12;358;Pouxeux;1992;37;2029
44;Grand Est;88;1;02;359;Prey;93;3;96
44;Grand Est;88;3;14;361;Provenchères-et-Colroy;1372;86;1458
44;Grand Est;88;2;04;360;Provenchères-lès-Darney;159;8;167
44;Grand Est;88;3;11;362;Le Puid;102;1;103
44;Grand Est;88;2;10;363;Punerot;157;5;162
44;Grand Est;88;1;09;364;Puzieux;148;3;151
44;Grand Est;88;1;04;365;Racécourt;171;3;174
44;Grand Est;88;2;09;366;Rainville;278;12;290
44;Grand Est;88;1;13;367;Rambervillers;5170;134;5304
44;Grand Est;88;1;09;368;Ramecourt;189;4;193
44;Grand Est;88;1;15;369;Ramonchamp;1978;139;2117
44;Grand Est;88;1;17;370;Rancourt;60;1;61
44;Grand Est;88;1;12;371;Raon-aux-Bois;1237;19;1256
44;Grand Est;88;3;11;372;Raon-l'Étape;6388;146;6534
44;Grand Est;88;3;11;373;Raon-sur-Plaine;146;2;148
44;Grand Est;88;1;03;374;Rapey;23;0;23
44;Grand Est;88;3;14;375;Raves;468;7;475
44;Grand Est;88;2;10;376;Rebeuville;283;7;290
44;Grand Est;88;2;04;377;Regnévelle;125;2;127
44;Grand Est;88;1;03;378;Regney;88;2;90
44;Grand Est;88;1;03;379;Rehaincourt;363;6;369
44;Grand Est;88;3;02;380;Rehaupal;211;6;217
44;Grand Est;88;2;04;381;Relanges;209;12;221
44;Grand Est;88;1;09;382;Remicourt;66;1;67
44;Grand Est;88;1;12;383;Remiremont;7714;299;8013
44;Grand Est;88;3;14;386;Remomeix;479;3;482
44;Grand Est;88;2;17;385;Remoncourt;594;10;604
44;Grand Est;88;2;09;387;Removille;214;4;218
44;Grand Est;88;1;05;388;Renauvoid;118;3;121
44;Grand Est;88;1;09;389;Repel;84;0;84
44;Grand Est;88;2;04;390;Robécourt;108;3;111
44;Grand Est;88;3;01;391;Rochesson;699;17;716
44;Grand Est;88;2;10;393;Rollainville;306;9;315
44;Grand Est;88;2;04;394;Romain-aux-Bois;48;0;48
44;Grand Est;88;1;03;395;Romont;391;9;400
44;Grand Est;88;3;02;398;Les Rouges-Eaux;88;3;91
44;Grand Est;88;1;02;399;Le Roulier;195;2;197
44;Grand Est;88;1;09;400;Rouvres-en-Xaintois;277;3;280
44;Grand Est;88;2;10;401;Rouvres-la-Chétive;450;9;459
44;Grand Est;88;1;11;402;Roville-aux-Chênes;369;161;530
44;Grand Est;88;2;17;403;Rozerotte;192;2;194
44;Grand Est;88;2;04;404;Rozières-sur-Mouzon;63;1;64
44;Grand Est;88;1;03;406;Rugney;141;3;144
44;Grand Est;88;2;10;407;Ruppes;140;2;142
44;Grand Est;88;1;15;408;Rupt-sur-Moselle;3525;67;3592
44;Grand Est;88;1;12;409;Saint-Amé;2154;40;2194
44;Grand Est;88;2;04;411;Saint-Baslemont;80;1;81
44;Grand Est;88;1;11;412;Saint-Benoît-la-Chipotte;417;9;426
44;Grand Est;88;3;99;413;Saint-Dié-des-Vosges;19607;530;20137
44;Grand Est;88;1;12;415;Saint-Étienne-lès-Remiremont;3840;82;3922
44;Grand Est;88;1;03;416;Saint-Genest;136;2;138
44;Grand Est;88;1;13;417;Saint-Gorgon;391;9;400
44;Grand Est;88;3;11;419;Saint-Jean-d'Ormont;122;0;122
44;Grand Est;88;2;04;421;Saint-Julien;110;2;112
44;Grand Est;88;3;14;423;Saint-Léonard;1355;22;1377
44;Grand Est;88;1;03;425;Saint-Maurice-sur-Mortagne;181;5;186
44;Grand Est;88;1;15;426;Saint-Maurice-sur-Moselle;1404;37;1441
44;Grand Est;88;2;09;427;Saint-Menge;126;1;127
44;Grand Est;88;3;13;428;Saint-Michel-sur-Meurthe;1864;58;1922
44;Grand Est;88;1;12;429;Saint-Nabord;4052;245;4297
44;Grand Est;88;2;17;430;Saint-Ouen-lès-Parey;495;13;508
44;Grand Est;88;2;09;431;Saint-Paul;156;3;159
44;Grand Est;88;1;11;432;Saint-Pierremont;153;3;156
44;Grand Est;88;1;09;433;Saint-Prancher;83;1;84
44;Grand Est;88;2;17;434;Saint-Remimont;224;6;230
44;Grand Est;88;3;11;435;Saint-Remy;519;12;531
44;Grand Est;88;3;11;436;Saint-Stail;73;1;74
44;Grand Est;88;1;03;437;Saint-Vallier;98;1;99
44;Grand Est;88;1;11;410;Sainte-Barbe;278;4;282
44;Grand Est;88;1;02;418;Sainte-Hélène;466;4;470
44;Grand Est;88;3;14;424;Sainte-Marguerite;2319;71;2390
44;Grand Est;88;3;13;438;La Salle;394;5;399
44;Grand Est;88;1;05;439;Sanchey;939;36;975
44;Grand Est;88;2;09;440;Sandaucourt;174;4;178
44;Grand Est;88;2;04;441;Sans-Vallois;133;2;135
44;Grand Est;88;3;01;442;Sapois;641;17;658
44;Grand Est;88;2;10;443;Sartes;99;2;101
44;Grand Est;88;3;11;444;Le Saulcy;327;11;338
44;Grand Est;88;3;14;445;Saulcy-sur-Meurthe;2330;55;2385
44;Grand Est;88;2;17;446;Saulxures-lès-Bulgnéville;252;2;254
44;Grand Est;88;3;01;447;Saulxures-sur-Moselotte;2588;86;2674
44;Grand Est;88;2;17;448;Sauville;183;7;190
44;Grand Est;88;1;03;449;Savigny;184;0;184
44;Grand Est;88;2;04;450;Senaide;181;1;182
44;Grand Est;88;3;11;451;Senones;2464;40;2504
44;Grand Est;88;2;04;452;Senonges;128;0;128
44;Grand Est;88;2;10;453;Seraumont;43;1;44
44;Grand Est;88;1;02;454;Sercœur;240;6;246
44;Grand Est;88;2;04;455;Serécourt;100;6;106
44;Grand Est;88;2;04;456;Serocourt;90;3;93
44;Grand Est;88;2;10;457;Sionne;140;1;141
44;Grand Est;88;1;03;458;Socourt;270;3;273
44;Grand Est;88;2;09;459;Soncourt;44;1;45
44;Grand Est;88;2;10;460;Soulosse-sous-Saint-Élophe;646;12;658
44;Grand Est;88;2;17;461;Suriauville;214;0;214
44;Grand Est;88;3;01;462;Le Syndicat;1898;41;1939
44;Grand Est;88;3;13;463;Taintrux;1543;42;1585
44;Grand Est;88;3;01;464;Tendon;516;8;524
44;Grand Est;88;2;17;466;They-sous-Montfort;127;5;132
44;Grand Est;88;3;01;467;Thiéfosse;593;15;608
44;Grand Est;88;1;15;468;Le Thillot;3438;56;3494
44;Grand Est;88;1;09;469;Thiraucourt;99;4;103
44;Grand Est;88;3;01;470;Le Tholy;1573;44;1617
44;Grand Est;88;2;04;471;Les Thons;105;1;106
44;Grand Est;88;2;17;472;Thuillières;120;3;123
44;Grand Est;88;2;04;473;Tignécourt;105;4;109
44;Grand Est;88;2;10;474;Tilleux;58;0;58
44;Grand Est;88;2;04;475;Tollaincourt;127;0;127
44;Grand Est;88;1;09;476;Totainville;121;1;122
44;Grand Est;88;2;10;477;Trampot;92;2;94
44;Grand Est;88;2;10;478;Tranqueville-Graux;103;1;104
44;Grand Est;88;1;16;479;Trémonzey;255;4;259
44;Grand Est;88;1;03;480;Ubexy;175;0;175
44;Grand Est;88;1;16;481;Uriménil;1355;23;1378
44;Grand Est;88;2;17;482;Urville;57;0;57
44;Grand Est;88;1;08;483;Uxegney;2294;66;2360
44;Grand Est;88;1;16;484;Uzemain;1055;30;1085
44;Grand Est;88;2;17;485;La Vacheresse-et-la-Rouillie;125;0;125
44;Grand Est;88;3;01;486;Vagney;3925;110;4035
44;Grand Est;88;1;16;487;Le Val-d'Ajol;3871;100;3971
44;Grand Est;88;2;17;488;Valfroicourt;241;5;246
44;Grand Est;88;1;09;489;Valleroy-aux-Saules;260;8;268
44;Grand Est;88;2;17;490;Valleroy-le-Sec;167;6;173
44;Grand Est;88;2;04;491;Les Vallois;118;4;122
44;Grand Est;88;3;07;492;Le Valtin;74;2;76
44;Grand Est;88;1;03;493;Varmonzey;28;1;29
44;Grand Est;88;1;04;494;Vaubexy;126;2;128
44;Grand Est;88;1;06;495;Vaudéville;162;6;168
44;Grand Est;88;2;17;496;Vaudoncourt;157;3;160
44;Grand Est;88;1;08;497;Vaxoncourt;452;8;460
44;Grand Est;88;1;15;498;Vecoux;870;21;891
44;Grand Est;88;1;04;499;Velotte-et-Tatignécourt;158;3;161
44;Grand Est;88;3;01;500;Ventron;838;14;852
44;Grand Est;88;3;11;501;Le Vermont;70;0;70
44;Grand Est;88;1;02;502;Vervezelle;132;5;137
44;Grand Est;88;3;11;503;Vexaincourt;157;3;160
44;Grand Est;88;2;09;504;Vicherey;195;4;199
44;Grand Est;88;3;07;505;Vienville;125;2;127
44;Grand Est;88;3;11;506;Vieux-Moulin;320;6;326
44;Grand Est;88;1;04;508;Ville-sur-Illon;558;12;570
44;Grand Est;88;1;09;507;Villers;209;7;216
44;Grand Est;88;1;02;509;Villoncourt;110;2;112
44;Grand Est;88;2;04;510;Villotte;153;0;153
44;Grand Est;88;2;10;511;Villouxel;82;2;84
44;Grand Est;88;1;02;512;Viménil;245;3;248
44;Grand Est;88;1;03;513;Vincey;2181;26;2207
44;Grand Est;88;2;09;514;Viocourt;156;5;161
44;Grand Est;88;2;16;515;Vioménil;145;2;147
44;Grand Est;88;2;17;516;Vittel;5071;145;5216
44;Grand Est;88;2;04;517;Viviers-le-Gras;199;3;202
44;Grand Est;88;2;17;518;Viviers-lès-Offroicourt;36;0;36
44;Grand Est;88;1;16;029;La Vôge-les-Bains;1624;123;1747
44;Grand Est;88;3;13;519;La Voivre;686;22;708
44;Grand Est;88;1;16;520;Les Voivres;310;9;319
44;Grand Est;88;1;03;521;Vomécourt;275;4;279
44;Grand Est;88;1;03;522;Vomécourt-sur-Madon;70;3;73
44;Grand Est;88;2;09;523;Vouxey;138;8;146
44;Grand Est;88;2;17;524;Vrécourt;370;4;374
44;Grand Est;88;1;09;525;Vroville;133;3;136
44;Grand Est;88;3;14;526;Wisembach;409;10;419
44;Grand Est;88;1;11;527;Xaffévillers;153;3;156
44;Grand Est;88;1;02;528;Xamontarupt;155;3;158
44;Grand Est;88;1;03;529;Xaronval;106;4;110
44;Grand Est;88;1;16;530;Xertigny;2611;49;2660
44;Grand Est;88;3;07;531;Xonrupt-Longemer;1522;49;1571
44;Grand Est;88;1;02;532;Zincourt;83;4;87
27;Bourgogne-Franche-Comté;89;1;07;002;Aigremont;78;3;81
27;Bourgogne-Franche-Comté;89;2;19;004;Aisy-sur-Armançon;245;11;256
27;Bourgogne-Franche-Comté;89;2;19;005;Ancy-le-Franc;908;24;932
27;Bourgogne-Franche-Comté;89;2;19;006;Ancy-le-Libre;183;5;188
27;Bourgogne-Franche-Comté;89;1;21;007;Andryes;399;12;411
27;Bourgogne-Franche-Comté;89;2;07;008;Angely;158;7;165
27;Bourgogne-Franche-Comté;89;2;05;009;Annay-la-Côte;348;16;364
27;Bourgogne-Franche-Comté;89;2;07;010;Annay-sur-Serein;219;3;222
27;Bourgogne-Franche-Comté;89;2;05;011;Annéot;128;10;138
27;Bourgogne-Franche-Comté;89;2;07;012;Annoux;86;3;89
27;Bourgogne-Franche-Comté;89;1;02;013;Appoigny;3167;52;3219
27;Bourgogne-Franche-Comté;89;3;06;014;Arces-Dilo;605;8;613
27;Bourgogne-Franche-Comté;89;2;12;015;Arcy-sur-Cure;484;12;496
27;Bourgogne-Franche-Comté;89;2;19;016;Argentenay;81;3;84
27;Bourgogne-Franche-Comté;89;2;19;017;Argenteuil-sur-Armançon;213;2;215
27;Bourgogne-Franche-Comté;89;3;20;018;Armeau;770;8;778
27;Bourgogne-Franche-Comté;89;2;19;019;Arthonnay;152;1;153
27;Bourgogne-Franche-Comté;89;2;12;020;Asnières-sous-Bois;126;2;128
27;Bourgogne-Franche-Comté;89;2;12;021;Asquins;294;13;307
27;Bourgogne-Franche-Comté;89;2;05;022;Athie;137;2;139
27;Bourgogne-Franche-Comté;89;1;03;023;Augy;1059;41;1100
27;Bourgogne-Franche-Comté;89;1;98;024;Auxerre;34634;1282;35916
27;Bourgogne-Franche-Comté;89;2;05;025;Avallon;6572;219;6791
27;Bourgogne-Franche-Comté;89;3;06;027;Bagneaux;209;5;214
27;Bourgogne-Franche-Comté;89;2;19;028;Baon;75;6;81
27;Bourgogne-Franche-Comté;89;1;13;029;Bassou;873;20;893
27;Bourgogne-Franche-Comté;89;1;12;030;Bazarnes;424;9;433
27;Bourgogne-Franche-Comté;89;1;15;031;Beaumont;630;12;642
27;Bourgogne-Franche-Comté;89;2;05;032;Beauvilliers;76;3;79
27;Bourgogne-Franche-Comté;89;1;09;033;Beauvoir;392;8;400
27;Bourgogne-Franche-Comté;89;1;07;034;Beine;482;12;494
27;Bourgogne-Franche-Comté;89;1;06;035;Bellechaume;441;14;455
27;Bourgogne-Franche-Comté;89;3;10;036;La Belliole;252;5;257
27;Bourgogne-Franche-Comté;89;3;11;037;Béon;510;5;515
27;Bourgogne-Franche-Comté;89;2;19;038;Bernouil;108;0;108
27;Bourgogne-Franche-Comté;89;1;07;039;Béru;76;1;77
27;Bourgogne-Franche-Comté;89;1;12;040;Bessy-sur-Cure;190;3;193
27;Bourgogne-Franche-Comté;89;1;15;041;Beugnon;307;14;321
27;Bourgogne-Franche-Comté;89;2;07;042;Bierry-les-Belles-Fontaines;190;5;195
27;Bourgogne-Franche-Comté;89;2;07;043;Blacy;103;1;104
27;Bourgogne-Franche-Comté;89;2;12;044;Blannay;114;1;115
27;Bourgogne-Franche-Comté;89;1;03;045;Bleigny-le-Carreau;295;7;302
27;Bourgogne-Franche-Comté;89;1;09;046;Bléneau;1289;18;1307
27;Bourgogne-Franche-Comté;89;2;12;049;Bois-d'Arcy;24;2;26
27;Bourgogne-Franche-Comté;89;1;13;050;Bonnard;881;11;892
27;Bourgogne-Franche-Comté;89;3;20;051;Les Bordes;551;8;559
27;Bourgogne-Franche-Comté;89;1;02;053;Branches;451;10;461
27;Bourgogne-Franche-Comté;89;3;10;054;Brannay;786;8;794
27;Bourgogne-Franche-Comté;89;1;06;055;Brienon-sur-Armançon;3176;71;3247
27;Bourgogne-Franche-Comté;89;3;13;056;Brion;629;14;643
27;Bourgogne-Franche-Comté;89;2;12;057;Brosses;302;4;306
27;Bourgogne-Franche-Comté;89;2;05;058;Bussières;125;2;127
27;Bourgogne-Franche-Comté;89;3;13;059;Bussy-en-Othe;730;11;741
27;Bourgogne-Franche-Comté;89;3;20;060;Bussy-le-Repos;452;11;463
27;Bourgogne-Franche-Comté;89;1;15;061;Butteaux;255;4;259
27;Bourgogne-Franche-Comté;89;3;06;048;Bœurs-en-Othe;343;7;350
27;Bourgogne-Franche-Comté;89;1;07;062;Carisey;355;5;360
27;Bourgogne-Franche-Comté;89;3;11;063;La Celle-Saint-Cyr;810;20;830
27;Bourgogne-Franche-Comté;89;2;07;064;Censy;56;1;57
27;Bourgogne-Franche-Comté;89;3;06;065;Cérilly;40;1;41
27;Bourgogne-Franche-Comté;89;3;06;066;Cerisiers;984;25;1009
27;Bourgogne-Franche-Comté;89;3;11;067;Cézy;1118;17;1135
27;Bourgogne-Franche-Comté;89;1;07;068;Chablis;2274;44;2318
27;Bourgogne-Franche-Comté;89;1;15;069;Chailley;540;13;553
27;Bourgogne-Franche-Comté;89;2;12;071;Chamoux;101;0;101
27;Bourgogne-Franche-Comté;89;1;09;072;Champcevrais;310;3;313
27;Bourgogne-Franche-Comté;89;1;09;073;Champignelles;994;42;1036
27;Bourgogne-Franche-Comté;89;3;14;074;Champigny;2204;40;2244
27;Bourgogne-Franche-Comté;89;3;11;075;Champlay;721;11;732
27;Bourgogne-Franche-Comté;89;1;06;076;Champlost;790;11;801
27;Bourgogne-Franche-Comté;89;1;03;077;Champs-sur-Yonne;1574;92;1666
27;Bourgogne-Franche-Comté;89;3;08;079;Chamvres;657;23;680
27;Bourgogne-Franche-Comté;89;3;18;080;La Chapelle-sur-Oreuse;624;5;629
27;Bourgogne-Franche-Comté;89;1;07;081;La Chapelle-Vaupelteigne;89;0;89
27;Bourgogne-Franche-Comté;89;1;02;083;Charbuy;1865;47;1912
27;Bourgogne-Franche-Comté;89;1;21;084;Charentenay;297;5;302
27;Bourgogne-Franche-Comté;89;1;13;085;Charmoy;1150;22;1172
27;Bourgogne-Franche-Comté;89;1;08;086;Charny Orée de Puisaye;4877;74;4951
27;Bourgogne-Franche-Comté;89;2;19;087;Chassignelles;313;9;322
27;Bourgogne-Franche-Comté;89;1;08;088;Chassy;460;12;472
27;Bourgogne-Franche-Comté;89;2;05;089;Chastellux-sur-Cure;136;6;142
27;Bourgogne-Franche-Comté;89;2;12;091;Châtel-Censoir;643;13;656
27;Bourgogne-Franche-Comté;89;2;07;092;Châtel-Gérard;215;11;226
27;Bourgogne-Franche-Comté;89;3;14;093;Chaumont;656;10;666
27;Bourgogne-Franche-Comté;89;3;20;094;Chaumot;760;15;775
27;Bourgogne-Franche-Comté;89;1;07;095;Chemilly-sur-Serein;148;7;155
27;Bourgogne-Franche-Comté;89;1;15;096;Chemilly-sur-Yonne;910;21;931
27;Bourgogne-Franche-Comté;89;2;19;098;Cheney;232;5;237
27;Bourgogne-Franche-Comté;89;1;13;099;Cheny;2487;47;2534
27;Bourgogne-Franche-Comté;89;3;10;100;Chéroy;1655;15;1670
27;Bourgogne-Franche-Comté;89;1;15;101;Chéu;558;11;569
27;Bourgogne-Franche-Comté;89;1;04;102;Chevannes;2178;62;2240
27;Bourgogne-Franche-Comté;89;1;07;104;Chichée;311;11;322
27;Bourgogne-Franche-Comté;89;1;13;105;Chichery;481;16;497
27;Bourgogne-Franche-Comté;89;1;07;108;Chitry;353;9;362
27;Bourgogne-Franche-Comté;89;3;06;111;Les Clérimois;297;7;304
27;Bourgogne-Franche-Comté;89;2;19;112;Collan;172;6;178
27;Bourgogne-Franche-Comté;89;3;10;113;Collemiers;660;16;676
27;Bourgogne-Franche-Comté;89;3;18;115;Compigny;194;2;196
27;Bourgogne-Franche-Comté;89;3;10;116;Cornant;357;5;362
27;Bourgogne-Franche-Comté;89;1;21;117;Coulangeron;214;1;215
27;Bourgogne-Franche-Comté;89;1;21;118;Coulanges-la-Vineuse;826;18;844
27;Bourgogne-Franche-Comté;89;1;12;119;Coulanges-sur-Yonne;551;10;561
27;Bourgogne-Franche-Comté;89;3;06;120;Coulours;133;3;136
27;Bourgogne-Franche-Comté;89;3;06;122;Courgenay;565;8;573
27;Bourgogne-Franche-Comté;89;1;07;123;Courgis;257;6;263
27;Bourgogne-Franche-Comté;89;3;18;124;Courlon-sur-Yonne;1192;23;1215
27;Bourgogne-Franche-Comté;89;1;21;125;Courson-les-Carrières;942;20;962
27;Bourgogne-Franche-Comté;89;3;10;126;Courtoin;38;1;39
27;Bourgogne-Franche-Comté;89;3;14;127;Courtois-sur-Yonne;769;24;793
27;Bourgogne-Franche-Comté;89;2;12;128;Coutarnoux;141;4;145
27;Bourgogne-Franche-Comté;89;1;12;129;Crain;399;9;408
27;Bourgogne-Franche-Comté;89;2;19;131;Cruzy-le-Châtel;242;4;246
27;Bourgogne-Franche-Comté;89;2;19;132;Cry;170;6;176
27;Bourgogne-Franche-Comté;89;3;11;133;Cudot;345;4;349
27;Bourgogne-Franche-Comté;89;2;05;134;Cussy-les-Forges;338;7;345
27;Bourgogne-Franche-Comté;89;3;18;136;Cuy;862;13;875
27;Bourgogne-Franche-Comté;89;2;19;137;Dannemoine;474;10;484
27;Bourgogne-Franche-Comté;89;1;12;130;Deux Rivières;1260;29;1289
27;Bourgogne-Franche-Comté;89;1;09;139;Diges;1141;37;1178
27;Bourgogne-Franche-Comté;89;2;12;141;Dissangis;120;7;127
27;Bourgogne-Franche-Comté;89;3;20;142;Dixmont;914;26;940
27;Bourgogne-Franche-Comté;89;3;10;143;Dollot;322;2;324
27;Bourgogne-Franche-Comté;89;3;10;144;Domats;819;15;834
27;Bourgogne-Franche-Comté;89;2;12;145;Domecy-sur-Cure;388;12;400
27;Bourgogne-Franche-Comté;89;2;05;146;Domecy-sur-le-Vault;88;3;91
27;Bourgogne-Franche-Comté;89;1;09;147;Dracy;216;5;221
27;Bourgogne-Franche-Comté;89;1;21;148;Druyes-les-Belles-Fontaines;279;5;284
27;Bourgogne-Franche-Comté;89;2;19;149;Dyé;210;6;216
27;Bourgogne-Franche-Comté;89;1;09;150;Égleny;448;9;457
27;Bourgogne-Franche-Comté;89;3;10;151;Égriselles-le-Bocage;1295;39;1334
27;Bourgogne-Franche-Comté;89;1;13;152;Épineau-les-Voves;742;15;757
27;Bourgogne-Franche-Comté;89;2;19;153;Épineuil;597;15;612
27;Bourgogne-Franche-Comté;89;1;21;154;Escamps;888;22;910
27;Bourgogne-Franche-Comté;89;1;21;155;Escolives-Sainte-Camille;702;12;714
27;Bourgogne-Franche-Comté;89;1;06;156;Esnon;392;7;399
27;Bourgogne-Franche-Comté;89;1;21;158;Étais-la-Sauvin;629;26;655
27;Bourgogne-Franche-Comté;89;2;05;159;Étaule;369;10;379
27;Bourgogne-Franche-Comté;89;3;20;160;Étigny;752;24;776
27;Bourgogne-Franche-Comté;89;2;07;161;Étivey;197;5;202
27;Bourgogne-Franche-Comté;89;3;18;162;Évry;386;4;390
27;Bourgogne-Franche-Comté;89;1;08;163;La Ferté-Loupière;532;9;541
27;Bourgogne-Franche-Comté;89;1;12;164;Festigny;89;0;89
27;Bourgogne-Franche-Comté;89;3;06;165;Flacy;111;2;113
27;Bourgogne-Franche-Comté;89;1;08;167;Fleury-la-Vallée;1102;35;1137
27;Bourgogne-Franche-Comté;89;1;07;168;Fleys;180;3;183
27;Bourgogne-Franche-Comté;89;2;19;169;Flogny-la-Chapelle;1029;20;1049
27;Bourgogne-Franche-Comté;89;2;12;170;Foissy-lès-Vézelay;128;2;130
27;Bourgogne-Franche-Comté;89;3;06;171;Foissy-sur-Vanne;325;3;328
27;Bourgogne-Franche-Comté;89;3;06;172;Fontaine-la-Gaillarde;509;25;534
27;Bourgogne-Franche-Comté;89;1;09;173;Fontaines;475;4;479
27;Bourgogne-Franche-Comté;89;1;07;175;Fontenay-près-Chablis;143;7;150
27;Bourgogne-Franche-Comté;89;2;12;176;Fontenay-près-Vézelay;136;3;139
27;Bourgogne-Franche-Comté;89;1;12;177;Fontenay-sous-Fouronnes;73;0;73
27;Bourgogne-Franche-Comté;89;1;21;179;Fontenoy;296;8;304
27;Bourgogne-Franche-Comté;89;3;10;180;Fouchères;469;9;478
27;Bourgogne-Franche-Comté;89;3;06;181;Fournaudin;121;2;123
27;Bourgogne-Franche-Comté;89;1;21;182;Fouronnes;164;2;166
27;Bourgogne-Franche-Comté;89;2;07;183;Fresnes;66;0;66
27;Bourgogne-Franche-Comté;89;2;19;184;Fulvy;131;3;134
27;Bourgogne-Franche-Comté;89;1;15;186;Germigny;547;19;566
27;Bourgogne-Franche-Comté;89;2;19;187;Gigny;99;2;101
27;Bourgogne-Franche-Comté;89;2;05;188;Girolles;169;7;176
27;Bourgogne-Franche-Comté;89;3;18;189;Gisy-les-Nobles;575;19;594
27;Bourgogne-Franche-Comté;89;2;12;190;Givry;174;8;182
27;Bourgogne-Franche-Comté;89;2;19;191;Gland;42;2;44
27;Bourgogne-Franche-Comté;89;2;07;194;Grimault;120;5;125
27;Bourgogne-Franche-Comté;89;3;17;195;Gron;1238;75;1313
27;Bourgogne-Franche-Comté;89;2;07;197;Guillon-Terre-Plaine;760;8;768
27;Bourgogne-Franche-Comté;89;1;02;198;Gurgy;1716;38;1754
27;Bourgogne-Franche-Comté;89;1;21;199;Gy-l'Évêque;454;10;464
27;Bourgogne-Franche-Comté;89;1;15;200;Hauterive;390;16;406
27;Bourgogne-Franche-Comté;89;1;21;405;Les Hauts de Forterre;509;7;516
27;Bourgogne-Franche-Comté;89;1;15;201;Héry;1809;54;1863
27;Bourgogne-Franche-Comté;89;1;21;202;Irancy;279;6;285
27;Bourgogne-Franche-Comté;89;2;05;203;Island;182;11;193
27;Bourgogne-Franche-Comté;89;2;07;204;L' Isle-sur-Serein;662;13;675
27;Bourgogne-Franche-Comté;89;1;15;205;Jaulges;550;5;555
27;Bourgogne-Franche-Comté;89;3;11;206;Joigny;9580;346;9926
27;Bourgogne-Franche-Comté;89;2;07;207;Jouancy;24;0;24
27;Bourgogne-Franche-Comté;89;2;12;208;Joux-la-Ville;1181;19;1200
27;Bourgogne-Franche-Comté;89;3;10;209;Jouy;524;15;539
27;Bourgogne-Franche-Comté;89;2;19;210;Jully;147;7;154
27;Bourgogne-Franche-Comté;89;2;19;211;Junay;76;0;76
27;Bourgogne-Franche-Comté;89;1;21;212;Jussy;384;15;399
27;Bourgogne-Franche-Comté;89;3;06;214;Lailly;192;5;197
27;Bourgogne-Franche-Comté;89;1;21;215;Lain;182;4;186
27;Bourgogne-Franche-Comté;89;1;21;216;Lainsecq;326;10;336
27;Bourgogne-Franche-Comté;89;1;09;217;Lalande;136;2;138
27;Bourgogne-Franche-Comté;89;1;13;218;Laroche-Saint-Cydroine;1252;23;1275
27;Bourgogne-Franche-Comté;89;1;15;219;Lasson;146;1;147
27;Bourgogne-Franche-Comté;89;1;09;220;Lavau;464;8;472
27;Bourgogne-Franche-Comté;89;1;09;221;Leugny;341;12;353
27;Bourgogne-Franche-Comté;89;1;21;222;Levis;225;6;231
27;Bourgogne-Franche-Comté;89;2;19;223;Lézinnes;669;18;687
27;Bourgogne-Franche-Comté;89;1;07;224;Lichères-près-Aigremont;161;4;165
27;Bourgogne-Franche-Comté;89;2;12;225;Lichères-sur-Yonne;51;0;51
27;Bourgogne-Franche-Comté;89;1;07;226;Lignorelles;192;9;201
27;Bourgogne-Franche-Comté;89;1;07;227;Ligny-le-Châtel;1280;16;1296
27;Bourgogne-Franche-Comté;89;1;01;228;Lindry;1387;42;1429
27;Bourgogne-Franche-Comté;89;3;10;229;Lixy;450;10;460
27;Bourgogne-Franche-Comté;89;3;11;230;Looze;446;17;463
27;Bourgogne-Franche-Comté;89;2;05;232;Lucy-le-Bois;298;15;313
27;Bourgogne-Franche-Comté;89;1;12;233;Lucy-sur-Cure;203;5;208
27;Bourgogne-Franche-Comté;89;1;12;234;Lucy-sur-Yonne;134;2;136
27;Bourgogne-Franche-Comté;89;2;05;235;Magny;866;22;888
27;Bourgogne-Franche-Comté;89;3;17;236;Maillot;1166;31;1197
27;Bourgogne-Franche-Comté;89;1;12;237;Mailly-la-Ville;511;12;523
27;Bourgogne-Franche-Comté;89;1;12;238;Mailly-le-Château;554;6;560
27;Bourgogne-Franche-Comté;89;3;17;239;Malay-le-Grand;1533;43;1576
27;Bourgogne-Franche-Comté;89;3;06;240;Malay-le-Petit;339;11;350
27;Bourgogne-Franche-Comté;89;1;07;242;Maligny;802;20;822
27;Bourgogne-Franche-Comté;89;2;07;244;Marmeaux;93;2;95
27;Bourgogne-Franche-Comté;89;3;20;245;Marsangy;849;19;868
27;Bourgogne-Franche-Comté;89;2;07;246;Massangis;360;4;364
27;Bourgogne-Franche-Comté;89;2;19;247;Mélisey;254;2;256
27;Bourgogne-Franche-Comté;89;2;05;248;Menades;55;2;57
27;Bourgogne-Franche-Comté;89;1;06;249;Mercy;81;1;82
27;Bourgogne-Franche-Comté;89;1;07;250;Méré;197;2;199
27;Bourgogne-Franche-Comté;89;1;08;251;Merry-la-Vallée;376;9;385
27;Bourgogne-Franche-Comté;89;1;21;252;Merry-Sec;175;4;179
27;Bourgogne-Franche-Comté;89;2;12;253;Merry-sur-Yonne;200;1;201
27;Bourgogne-Franche-Comté;89;1;09;254;Mézilles;547;7;554
27;Bourgogne-Franche-Comté;89;3;18;255;Michery;1048;21;1069
27;Bourgogne-Franche-Comté;89;1;21;256;Migé;423;3;426
27;Bourgogne-Franche-Comté;89;1;13;257;Migennes;7240;114;7354
27;Bourgogne-Franche-Comté;89;2;07;259;Môlay;91;2;93
27;Bourgogne-Franche-Comté;89;3;06;261;Molinons;277;7;284
27;Bourgogne-Franche-Comté;89;2;19;262;Molosmes;175;8;183
27;Bourgogne-Franche-Comté;89;1;02;263;Monéteau;3985;79;4064
27;Bourgogne-Franche-Comté;89;1;15;268;Mont-Saint-Sulpice;795;15;810
27;Bourgogne-Franche-Comté;89;3;10;264;Montacher-Villegardin;766;12;778
27;Bourgogne-Franche-Comté;89;1;08;003;Montholon;2866;60;2926
27;Bourgogne-Franche-Comté;89;1;07;265;Montigny-la-Resle;588;21;609
27;Bourgogne-Franche-Comté;89;2;12;266;Montillot;274;6;280
27;Bourgogne-Franche-Comté;89;2;07;267;Montréal;182;7;189
27;Bourgogne-Franche-Comté;89;1;21;270;Mouffy;128;2;130
27;Bourgogne-Franche-Comté;89;2;07;271;Moulins-en-Tonnerrois;103;2;105
27;Bourgogne-Franche-Comté;89;1;09;272;Moulins-sur-Ouanne;298;3;301
27;Bourgogne-Franche-Comté;89;1;21;273;Moutiers-en-Puisaye;289;3;292
27;Bourgogne-Franche-Comté;89;3;10;274;Nailly;1299;36;1335
27;Bourgogne-Franche-Comté;89;1;15;276;Neuvy-Sautour;914;34;948
27;Bourgogne-Franche-Comté;89;1;07;277;Nitry;369;6;375
27;Bourgogne-Franche-Comté;89;3;06;278;Noé;555;7;562
27;Bourgogne-Franche-Comté;89;2;07;279;Noyers;580;14;594
27;Bourgogne-Franche-Comté;89;2;19;280;Nuits;399;9;408
27;Bourgogne-Franche-Comté;89;1;08;281;Les Ormes;346;2;348
27;Bourgogne-Franche-Comté;89;1;15;282;Ormoy;681;12;693
27;Bourgogne-Franche-Comté;89;1;21;283;Ouanne;606;16;622
27;Bourgogne-Franche-Comté;89;2;19;284;Pacy-sur-Armançon;191;4;195
27;Bourgogne-Franche-Comté;89;3;18;285;Pailly;306;3;309
27;Bourgogne-Franche-Comté;89;1;09;286;Parly;819;14;833
27;Bourgogne-Franche-Comté;89;3;17;287;Paron;4853;122;4975
27;Bourgogne-Franche-Comté;89;1;06;288;Paroy-en-Othe;185;3;188
27;Bourgogne-Franche-Comté;89;3;08;289;Paroy-sur-Tholon;284;12;296
27;Bourgogne-Franche-Comté;89;2;07;290;Pasilly;46;2;48
27;Bourgogne-Franche-Comté;89;3;20;291;Passy;342;10;352
27;Bourgogne-Franche-Comté;89;3;18;469;Perceneige;950;22;972
27;Bourgogne-Franche-Comté;89;1;15;292;Percey;252;4;256
27;Bourgogne-Franche-Comté;89;1;02;295;Perrigny;1272;32;1304
27;Bourgogne-Franche-Comté;89;2;19;296;Perrigny-sur-Armançon;131;1;132
27;Bourgogne-Franche-Comté;89;2;12;297;Pierre-Perthuis;122;0;122
27;Bourgogne-Franche-Comté;89;3;20;298;Piffonds;639;18;657
27;Bourgogne-Franche-Comté;89;2;19;299;Pimelles;62;1;63
27;Bourgogne-Franche-Comté;89;2;07;300;Pisy;76;1;77
27;Bourgogne-Franche-Comté;89;3;18;302;Plessis-Saint-Jean;216;5;221
27;Bourgogne-Franche-Comté;89;1;07;303;Poilly-sur-Serein;272;5;277
27;Bourgogne-Franche-Comté;89;1;08;304;Poilly-sur-Tholon;688;17;705
27;Bourgogne-Franche-Comté;89;3;06;308;Pont-sur-Vanne;194;8;202
27;Bourgogne-Franche-Comté;89;3;14;309;Pont-sur-Yonne;3334;61;3395
27;Bourgogne-Franche-Comté;89;2;05;306;Pontaubert;385;12;397
27;Bourgogne-Franche-Comté;89;1;07;307;Pontigny;752;10;762
27;Bourgogne-Franche-Comté;89;3;06;310;La Postolle;143;3;146
27;Bourgogne-Franche-Comté;89;1;09;311;Pourrain;1403;34;1437
27;Bourgogne-Franche-Comté;89;2;12;312;Précy-le-Sec;253;10;263
27;Bourgogne-Franche-Comté;89;3;11;313;Précy-sur-Vrin;438;14;452
27;Bourgogne-Franche-Comté;89;1;12;314;Prégilbert;181;1;182
27;Bourgogne-Franche-Comté;89;1;07;315;Préhy;150;1;151
27;Bourgogne-Franche-Comté;89;2;05;316;Provency;243;8;251
27;Bourgogne-Franche-Comté;89;2;05;318;Quarré-les-Tombes;645;12;657
27;Bourgogne-Franche-Comté;89;1;03;319;Quenne;472;15;487
27;Bourgogne-Franche-Comté;89;2;19;320;Quincerot;60;2;62
27;Bourgogne-Franche-Comté;89;2;19;321;Ravières;736;16;752
27;Bourgogne-Franche-Comté;89;2;19;323;Roffey;141;4;145
27;Bourgogne-Franche-Comté;89;1;09;324;Rogny-les-Sept-Écluses;675;19;694
27;Bourgogne-Franche-Comté;89;1;09;325;Ronchères;96;1;97
27;Bourgogne-Franche-Comté;89;3;17;326;Rosoy;1122;28;1150
27;Bourgogne-Franche-Comté;89;3;20;327;Rousson;407;9;416
27;Bourgogne-Franche-Comté;89;1;07;328;Rouvray;381;10;391
27;Bourgogne-Franche-Comté;89;2;19;329;Rugny;78;1;79
27;Bourgogne-Franche-Comté;89;1;21;331;Sainpuits;315;12;327
27;Bourgogne-Franche-Comté;89;3;10;332;Saint-Agnan;951;25;976
27;Bourgogne-Franche-Comté;89;2;07;333;Saint-André-en-Terre-Plaine;159;4;163
27;Bourgogne-Franche-Comté;89;3;11;335;Saint-Aubin-sur-Yonne;411;6;417
27;Bourgogne-Franche-Comté;89;2;05;336;Saint-Brancher;290;8;298
27;Bourgogne-Franche-Comté;89;1;03;337;Saint-Bris-le-Vineux;1024;25;1049
27;Bourgogne-Franche-Comté;89;3;16;338;Saint-Clément;2756;74;2830
27;Bourgogne-Franche-Comté;89;1;07;341;Saint-Cyr-les-Colons;447;4;451
27;Bourgogne-Franche-Comté;89;3;18;342;Saint-Denis-lès-Sens;723;30;753
27;Bourgogne-Franche-Comté;89;1;09;344;Saint-Fargeau;1589;16;1605
27;Bourgogne-Franche-Comté;89;1;15;345;Saint-Florentin;4362;65;4427
27;Bourgogne-Franche-Comté;89;1;01;346;Saint-Georges-sur-Baulche;3230;144;3374
27;Bourgogne-Franche-Comté;89;2;05;347;Saint-Germain-des-Champs;360;10;370
27;Bourgogne-Franche-Comté;89;3;11;348;Saint-Julien-du-Sault;2348;55;2403
27;Bourgogne-Franche-Comté;89;2;05;349;Saint-Léger-Vauban;360;8;368
27;Bourgogne-Franche-Comté;89;3;11;350;Saint-Loup-d'Ordon;256;5;261
27;Bourgogne-Franche-Comté;89;3;11;353;Saint-Martin-d'Ordon;413;4;417
27;Bourgogne-Franche-Comté;89;1;09;352;Saint-Martin-des-Champs;282;7;289
27;Bourgogne-Franche-Comté;89;3;16;354;Saint-Martin-du-Tertre;1567;45;1612
27;Bourgogne-Franche-Comté;89;2;19;355;Saint-Martin-sur-Armançon;141;6;147
27;Bourgogne-Franche-Comté;89;3;06;359;Saint-Maurice-aux-Riches-Hommes;420;5;425
27;Bourgogne-Franche-Comté;89;1;08;360;Saint-Maurice-le-Vieil;373;6;379
27;Bourgogne-Franche-Comté;89;1;08;361;Saint-Maurice-Thizouaille;263;2;265
27;Bourgogne-Franche-Comté;89;2;12;362;Saint-Moré;178;5;183
27;Bourgogne-Franche-Comté;89;2;12;364;Saint-Père;310;4;314
27;Bourgogne-Franche-Comté;89;1;09;365;Saint-Privé;521;15;536
27;Bourgogne-Franche-Comté;89;1;21;368;Saint-Sauveur-en-Puisaye;885;17;902
27;Bourgogne-Franche-Comté;89;3;14;369;Saint-Sérotin;557;8;565
27;Bourgogne-Franche-Comté;89;3;10;370;Saint-Valérien;1681;30;1711
27;Bourgogne-Franche-Comté;89;2;12;339;Sainte-Colombe;200;6;206
27;Bourgogne-Franche-Comté;89;2;05;351;Sainte-Magnance;477;7;484
27;Bourgogne-Franche-Comté;89;1;12;363;Sainte-Pallaye;109;0;109
27;Bourgogne-Franche-Comté;89;2;07;371;Sainte-Vertu;90;0;90
27;Bourgogne-Franche-Comté;89;1;21;367;Saints-en-Puisaye;561;10;571
27;Bourgogne-Franche-Comté;89;3;06;373;Saligny;668;10;678
27;Bourgogne-Franche-Comté;89;2;19;374;Sambourg;78;3;81
27;Bourgogne-Franche-Comté;89;2;07;375;Santigny;97;3;100
27;Bourgogne-Franche-Comté;89;2;07;376;Sarry;161;4;165
27;Bourgogne-Franche-Comté;89;2;07;377;Sauvigny-le-Beuréal;73;0;73
27;Bourgogne-Franche-Comté;89;2;05;378;Sauvigny-le-Bois;708;25;733
27;Bourgogne-Franche-Comté;89;2;07;379;Savigny-en-Terre-Plaine;153;3;156
27;Bourgogne-Franche-Comté;89;3;10;380;Savigny-sur-Clairis;459;7;466
27;Bourgogne-Franche-Comté;89;1;15;382;Seignelay;1522;38;1560
27;Bourgogne-Franche-Comté;89;1;21;383;Sementron;110;3;113
27;Bourgogne-Franche-Comté;89;1;08;384;Senan;700;24;724
27;Bourgogne-Franche-Comté;89;2;19;385;Sennevoy-le-Bas;86;3;89
27;Bourgogne-Franche-Comté;89;2;19;386;Sennevoy-le-Haut;118;1;119
27;Bourgogne-Franche-Comté;89;3;99;387;Sens;25935;584;26519
27;Bourgogne-Franche-Comté;89;3;08;388;Sépeaux-Saint Romain;559;15;574
27;Bourgogne-Franche-Comté;89;3;18;390;Serbonnes;626;10;636
27;Bourgogne-Franche-Comté;89;3;18;391;Sergines;1287;27;1314
27;Bourgogne-Franche-Comté;89;2;05;392;Sermizelles;256;8;264
27;Bourgogne-Franche-Comté;89;2;19;393;Serrigny;113;2;115
27;Bourgogne-Franche-Comté;89;1;12;394;Sery;91;1;92
27;Bourgogne-Franche-Comté;89;3;06;395;Les Sièges;414;8;422
27;Bourgogne-Franche-Comté;89;1;08;397;Sommecaise;369;6;375
27;Bourgogne-Franche-Comté;89;1;15;398;Sormery;349;5;354
27;Bourgogne-Franche-Comté;89;3;18;399;Soucy;1589;45;1634
27;Bourgogne-Franche-Comté;89;1;21;400;Sougères-en-Puisaye;318;5;323
27;Bourgogne-Franche-Comté;89;1;15;402;Soumaintrain;218;4;222
27;Bourgogne-Franche-Comté;89;2;19;403;Stigny;94;10;104
27;Bourgogne-Franche-Comté;89;3;10;404;Subligny;510;8;518
27;Bourgogne-Franche-Comté;89;2;07;406;Talcy;74;2;76
27;Bourgogne-Franche-Comté;89;2;19;407;Tanlay;998;33;1031
27;Bourgogne-Franche-Comté;89;1;09;408;Tannerre-en-Puisaye;283;8;291
27;Bourgogne-Franche-Comté;89;2;12;409;Tharoiseau;62;1;63
27;Bourgogne-Franche-Comté;89;2;05;410;Tharot;93;5;98
27;Bourgogne-Franche-Comté;89;2;07;412;Thizy;197;9;206
27;Bourgogne-Franche-Comté;89;2;19;413;Thorey;29;0;29
27;Bourgogne-Franche-Comté;89;3;18;414;Thorigny-sur-Oreuse;1456;31;1487
27;Bourgogne-Franche-Comté;89;2;05;415;Thory;203;3;206
27;Bourgogne-Franche-Comté;89;1;21;416;Thury;439;8;447
27;Bourgogne-Franche-Comté;89;2;19;417;Tissey;102;2;104
27;Bourgogne-Franche-Comté;89;2;19;418;Tonnerre;4575;186;4761
27;Bourgogne-Franche-Comté;89;1;09;419;Toucy;2662;140;2802
27;Bourgogne-Franche-Comté;89;1;21;420;Treigny-Perreuse-Sainte-Colombe;994;20;1014
27;Bourgogne-Franche-Comté;89;2;19;422;Trichey;42;2;44
27;Bourgogne-Franche-Comté;89;2;19;423;Tronchoy;127;0;127
27;Bourgogne-Franche-Comté;89;1;12;424;Trucy-sur-Yonne;139;6;145
27;Bourgogne-Franche-Comté;89;1;15;425;Turny;681;20;701
27;Bourgogne-Franche-Comté;89;1;08;334;Le Val d'Ocre;566;7;573
27;Bourgogne-Franche-Comté;89;1;21;426;Val-de-Mercy;391;12;403
27;Bourgogne-Franche-Comté;89;1;04;427;Vallan;680;19;699
27;Bourgogne-Franche-Comté;89;3;06;411;Les Vallées de la Vanne;1078;25;1103
27;Bourgogne-Franche-Comté;89;3;10;428;Vallery;556;3;559
27;Bourgogne-Franche-Comté;89;1;08;196;Valravillon;1762;45;1807
27;Bourgogne-Franche-Comté;89;1;07;430;Varennes;323;8;331
27;Bourgogne-Franche-Comté;89;2;07;431;Vassy-sous-Pisy;71;1;72
27;Bourgogne-Franche-Comté;89;3;06;432;Vaudeurs;476;9;485
27;Bourgogne-Franche-Comté;89;2;05;433;Vault-de-Lugny;292;5;297
27;Bourgogne-Franche-Comté;89;3;06;434;Vaumort;364;4;368
27;Bourgogne-Franche-Comté;89;1;06;436;Venizy;902;15;917
27;Bourgogne-Franche-Comté;89;1;07;437;Venouse;303;10;313
27;Bourgogne-Franche-Comté;89;1;03;438;Venoy;1800;191;1991
27;Bourgogne-Franche-Comté;89;1;15;439;Vergigny;1549;23;1572
27;Bourgogne-Franche-Comté;89;3;11;440;Verlin;425;3;428
27;Bourgogne-Franche-Comté;89;1;12;441;Vermenton;1289;27;1316
27;Bourgogne-Franche-Comté;89;3;10;442;Vernoy;245;4;249
27;Bourgogne-Franche-Comté;89;3;20;443;Véron;1955;38;1993
27;Bourgogne-Franche-Comté;89;2;19;445;Vézannes;49;2;51
27;Bourgogne-Franche-Comté;89;2;12;446;Vézelay;428;4;432
27;Bourgogne-Franche-Comté;89;2;19;447;Vézinnes;159;5;164
27;Bourgogne-Franche-Comté;89;3;14;449;Villeblevin;1865;31;1896
27;Bourgogne-Franche-Comté;89;3;10;450;Villebougis;630;21;651
27;Bourgogne-Franche-Comté;89;3;06;451;Villechétive;241;4;245
27;Bourgogne-Franche-Comté;89;3;11;452;Villecien;405;6;411
27;Bourgogne-Franche-Comté;89;1;01;453;Villefargeau;1107;29;1136
27;Bourgogne-Franche-Comté;89;3;14;456;Villemanoche;670;9;679
27;Bourgogne-Franche-Comté;89;3;14;458;Villenavotte;176;7;183
27;Bourgogne-Franche-Comté;89;3;06;461;Villeneuve-l'Archevêque;1131;22;1153
27;Bourgogne-Franche-Comté;89;3;10;459;Villeneuve-la-Dondagre;301;0;301
27;Bourgogne-Franche-Comté;89;3;14;460;Villeneuve-la-Guyard;3465;48;3513
27;Bourgogne-Franche-Comté;89;1;09;462;Villeneuve-les-Genêts;281;3;284
27;Bourgogne-Franche-Comté;89;1;07;463;Villeneuve-Saint-Salves;253;4;257
27;Bourgogne-Franche-Comté;89;3;20;464;Villeneuve-sur-Yonne;5219;83;5302
27;Bourgogne-Franche-Comté;89;3;14;465;Villeperrot;323;1;324
27;Bourgogne-Franche-Comté;89;3;10;466;Villeroy;390;10;400
27;Bourgogne-Franche-Comté;89;3;10;467;Villethierry;838;15;853
27;Bourgogne-Franche-Comté;89;3;11;468;Villevallier;424;50;474
27;Bourgogne-Franche-Comté;89;2;19;470;Villiers-les-Hauts;125;7;132
27;Bourgogne-Franche-Comté;89;3;06;471;Villiers-Louis;457;15;472
27;Bourgogne-Franche-Comté;89;1;09;472;Villiers-Saint-Benoît;476;9;485
27;Bourgogne-Franche-Comté;89;1;15;474;Villiers-Vineux;282;4;286
27;Bourgogne-Franche-Comté;89;2;19;475;Villon;110;4;114
27;Bourgogne-Franche-Comté;89;1;07;477;Villy;107;2;109
27;Bourgogne-Franche-Comté;89;1;21;478;Vincelles;930;20;950
27;Bourgogne-Franche-Comté;89;1;21;479;Vincelottes;279;6;285
27;Bourgogne-Franche-Comté;89;3;18;480;Vinneuf;1548;22;1570
27;Bourgogne-Franche-Comté;89;2;19;481;Vireaux;131;6;137
27;Bourgogne-Franche-Comté;89;2;19;482;Viviers;127;1;128
27;Bourgogne-Franche-Comté;89;3;18;483;Voisines;498;16;514
27;Bourgogne-Franche-Comté;89;2;12;485;Voutenay-sur-Cure;214;4;218
27;Bourgogne-Franche-Comté;89;2;19;486;Yrouerre;159;5;164
27;Bourgogne-Franche-Comté;90;1;05;001;Andelnans;1199;22;1221
27;Bourgogne-Franche-Comté;90;1;08;002;Angeot;345;8;353
27;Bourgogne-Franche-Comté;90;1;07;003;Anjoutey;603;22;625
27;Bourgogne-Franche-Comté;90;1;05;004;Argiésans;461;13;474
27;Bourgogne-Franche-Comté;90;1;08;082;Autrechêne;280;9;289
27;Bourgogne-Franche-Comté;90;1;07;005;Auxelles-Bas;463;14;477
27;Bourgogne-Franche-Comté;90;1;07;006;Auxelles-Haut;289;8;297
27;Bourgogne-Franche-Comté;90;1;05;007;Banvillars;282;5;287
27;Bourgogne-Franche-Comté;90;1;01;008;Bavilliers;4726;110;4836
27;Bourgogne-Franche-Comté;90;1;06;009;Beaucourt;5007;63;5070
27;Bourgogne-Franche-Comté;90;1;99;010;Belfort;47656;767;48423
27;Bourgogne-Franche-Comté;90;1;05;011;Bermont;391;9;400
27;Bourgogne-Franche-Comté;90;1;08;012;Bessoncourt;1245;31;1276
27;Bourgogne-Franche-Comté;90;1;08;013;Bethonvilliers;248;11;259
27;Bourgogne-Franche-Comté;90;1;08;014;Boron;480;8;488
27;Bourgogne-Franche-Comté;90;1;05;015;Botans;242;9;251
27;Bourgogne-Franche-Comté;90;1;07;016;Bourg-sous-Châtelet;118;2;120
27;Bourgogne-Franche-Comté;90;1;05;017;Bourogne;1896;25;1921
27;Bourgogne-Franche-Comté;90;1;08;018;Brebotte;385;7;392
27;Bourgogne-Franche-Comté;90;1;08;019;Bretagne;265;6;271
27;Bourgogne-Franche-Comté;90;1;05;020;Buc;283;9;292
27;Bourgogne-Franche-Comté;90;1;05;021;Charmois;340;4;344
27;Bourgogne-Franche-Comté;90;1;05;022;Châtenois-les-Forges;2750;56;2806
27;Bourgogne-Franche-Comté;90;1;07;023;Chaux;1147;30;1177
27;Bourgogne-Franche-Comté;90;1;08;024;Chavanatte;154;3;157
27;Bourgogne-Franche-Comté;90;1;08;025;Chavannes-les-Grands;338;4;342
27;Bourgogne-Franche-Comté;90;1;05;026;Chèvremont;1600;40;1640
27;Bourgogne-Franche-Comté;90;1;06;027;Courcelles;120;0;120
27;Bourgogne-Franche-Comté;90;1;06;028;Courtelevant;419;7;426
27;Bourgogne-Franche-Comté;90;1;01;029;Cravanche;1957;55;2012
27;Bourgogne-Franche-Comté;90;1;06;030;Croix;165;3;168
27;Bourgogne-Franche-Comté;90;1;08;031;Cunelières;355;14;369
27;Bourgogne-Franche-Comté;90;1;01;032;Danjoutin;3715;64;3779
27;Bourgogne-Franche-Comté;90;1;06;033;Delle;5690;87;5777
27;Bourgogne-Franche-Comté;90;1;09;034;Denney;762;26;788
27;Bourgogne-Franche-Comté;90;1;05;035;Dorans;751;9;760
27;Bourgogne-Franche-Comté;90;1;08;036;Eguenigue;274;9;283
27;Bourgogne-Franche-Comté;90;1;09;037;Éloie;948;26;974
27;Bourgogne-Franche-Comté;90;1;01;039;Essert;3306;98;3404
27;Bourgogne-Franche-Comté;90;1;07;041;Étueffont;1491;47;1538
27;Bourgogne-Franche-Comté;90;1;09;042;Évette-Salbert;2055;67;2122
27;Bourgogne-Franche-Comté;90;1;06;043;Faverois;574;8;582
27;Bourgogne-Franche-Comté;90;1;06;045;Fêche-l'Église;768;13;781
27;Bourgogne-Franche-Comté;90;1;07;044;Felon;244;5;249
27;Bourgogne-Franche-Comté;90;1;06;046;Florimont;446;6;452
27;Bourgogne-Franche-Comté;90;1;08;047;Fontaine;603;14;617
27;Bourgogne-Franche-Comté;90;1;08;048;Fontenelle;127;3;130
27;Bourgogne-Franche-Comté;90;1;08;049;Foussemagne;921;18;939
27;Bourgogne-Franche-Comté;90;1;08;050;Frais;219;6;225
27;Bourgogne-Franche-Comté;90;1;08;051;Froidefontaine;456;8;464
27;Bourgogne-Franche-Comté;90;1;07;052;Giromagny;3064;85;3149
27;Bourgogne-Franche-Comté;90;1;08;053;Grandvillars;2974;61;3035
27;Bourgogne-Franche-Comté;90;1;07;054;Grosmagny;524;7;531
27;Bourgogne-Franche-Comté;90;1;08;055;Grosne;329;2;331
27;Bourgogne-Franche-Comté;90;1;06;056;Joncherey;1353;27;1380
27;Bourgogne-Franche-Comté;90;1;07;057;Lachapelle-sous-Chaux;741;26;767
27;Bourgogne-Franche-Comté;90;1;07;058;Lachapelle-sous-Rougemont;580;6;586
27;Bourgogne-Franche-Comté;90;1;08;059;Lacollonge;228;7;235
27;Bourgogne-Franche-Comté;90;1;08;060;Lagrange;129;3;132
27;Bourgogne-Franche-Comté;90;1;07;061;Lamadeleine-Val-des-Anges;40;2;42
27;Bourgogne-Franche-Comté;90;1;08;062;Larivière;301;10;311
27;Bourgogne-Franche-Comté;90;1;06;063;Lebetain;421;9;430
27;Bourgogne-Franche-Comté;90;1;07;065;Lepuix;1154;20;1174
27;Bourgogne-Franche-Comté;90;1;06;064;Lepuix-Neuf;298;4;302
27;Bourgogne-Franche-Comté;90;1;07;066;Leval;241;1;242
27;Bourgogne-Franche-Comté;90;1;08;067;Menoncourt;390;17;407
27;Bourgogne-Franche-Comté;90;1;05;068;Meroux-Moval;1307;30;1337
27;Bourgogne-Franche-Comté;90;1;08;069;Méziré;1334;25;1359
27;Bourgogne-Franche-Comté;90;1;06;070;Montbouton;405;10;415
27;Bourgogne-Franche-Comté;90;1;08;071;Montreux-Château;1181;14;1195
27;Bourgogne-Franche-Comté;90;1;08;072;Morvillars;1078;22;1100
27;Bourgogne-Franche-Comté;90;1;08;074;Novillard;299;4;303
27;Bourgogne-Franche-Comté;90;1;09;075;Offemont;4108;96;4204
27;Bourgogne-Franche-Comté;90;1;01;076;Pérouse;1169;30;1199
27;Bourgogne-Franche-Comté;90;1;08;077;Petit-Croix;299;7;306
27;Bourgogne-Franche-Comté;90;1;07;078;Petitefontaine;190;5;195
27;Bourgogne-Franche-Comté;90;1;07;079;Petitmagny;298;6;304
27;Bourgogne-Franche-Comté;90;1;08;080;Phaffans;451;12;463
27;Bourgogne-Franche-Comté;90;1;06;081;Réchésy;786;14;800
27;Bourgogne-Franche-Comté;90;1;08;083;Recouvrance;108;1;109
27;Bourgogne-Franche-Comté;90;1;08;084;Reppe;342;10;352
27;Bourgogne-Franche-Comté;90;1;07;085;Riervescemont;100;2;102
27;Bourgogne-Franche-Comté;90;1;07;086;Romagny-sous-Rougemont;218;6;224
27;Bourgogne-Franche-Comté;90;1;09;087;Roppe;1045;18;1063
27;Bourgogne-Franche-Comté;90;1;07;088;Rougegoutte;976;25;1001
27;Bourgogne-Franche-Comté;90;1;07;089;Rougemont-le-Château;1479;64;1543
27;Bourgogne-Franche-Comté;90;1;06;090;Saint-Dizier-l'Évêque;428;11;439
27;Bourgogne-Franche-Comté;90;1;07;091;Saint-Germain-le-Châtelet;644;24;668
27;Bourgogne-Franche-Comté;90;1;09;093;Sermamagny;860;19;879
27;Bourgogne-Franche-Comté;90;1;05;094;Sevenans;701;17;718
27;Bourgogne-Franche-Comté;90;1;08;095;Suarce;436;3;439
27;Bourgogne-Franche-Comté;90;1;06;096;Thiancourt;290;8;298
27;Bourgogne-Franche-Comté;90;1;05;097;Trévenans;1248;32;1280
27;Bourgogne-Franche-Comté;90;1;05;098;Urcerey;233;10;243
27;Bourgogne-Franche-Comté;90;1;09;099;Valdoie;5300;235;5535
27;Bourgogne-Franche-Comté;90;1;08;100;Vauthiermont;210;12;222
27;Bourgogne-Franche-Comté;90;1;08;101;Vellescot;255;6;261
27;Bourgogne-Franche-Comté;90;1;07;102;Vescemont;746;24;770
27;Bourgogne-Franche-Comté;90;1;09;103;Vétrigne;638;22;660
27;Bourgogne-Franche-Comté;90;1;05;104;Vézelois;953;17;970
27;Bourgogne-Franche-Comté;90;1;06;105;Villars-le-Sec;181;2;183
11;Île-de-France;91;1;08;001;Abbéville-la-Rivière;303;7;310
11;Île-de-France;91;1;08;016;Angerville;4270;67;4337
11;Île-de-France;91;3;05;017;Angervilliers;1673;24;1697
11;Île-de-France;91;3;01;021;Arpajon;10378;89;10467
11;Île-de-France;91;1;08;022;Arrancourt;152;4;156
11;Île-de-France;91;3;02;027;Athis-Mons;34347;377;34724
11;Île-de-France;91;1;08;035;Authon-la-Plaine;373;6;379
11;Île-de-France;91;2;13;037;Auvernaux;324;1;325
11;Île-de-France;91;1;08;038;Auvers-Saint-Georges;1283;21;1304
11;Île-de-France;91;3;01;041;Avrainville;985;7;992
11;Île-de-France;91;3;11;044;Ballainvilliers;4581;43;4624
11;Île-de-France;91;2;13;045;Ballancourt-sur-Essonne;7597;99;7696
11;Île-de-France;91;1;13;047;Baulne;1315;14;1329
11;Île-de-France;91;3;10;064;Bièvres;4639;111;4750
11;Île-de-France;91;1;08;067;Blandy;120;2;122
11;Île-de-France;91;2;13;069;Boigneville;389;10;399
11;Île-de-France;91;1;08;075;Bois-Herpin;77;1;78
11;Île-de-France;91;1;08;079;Boissy-la-Rivière;526;7;533
11;Île-de-France;91;1;08;080;Boissy-le-Cutté;1319;13;1332
11;Île-de-France;91;1;08;081;Boissy-le-Sec;683;11;694
11;Île-de-France;91;1;01;085;Boissy-sous-Saint-Yon;3868;47;3915
11;Île-de-France;91;2;15;086;Bondoufle;9538;135;9673
11;Île-de-France;91;3;10;093;Boullay-les-Troux;643;21;664
11;Île-de-France;91;1;01;095;Bouray-sur-Juine;2184;27;2211
11;Île-de-France;91;2;07;097;Boussy-Saint-Antoine;7552;72;7624
11;Île-de-France;91;1;08;098;Boutervilliers;425;6;431
11;Île-de-France;91;1;13;099;Boutigny-sur-Essonne;2998;41;3039
11;Île-de-France;91;1;08;100;Bouville;648;16;664
11;Île-de-France;91;3;03;103;Brétigny-sur-Orge;26528;313;26841
11;Île-de-France;91;3;05;105;Breuillet;8394;119;8513
11;Île-de-France;91;1;05;106;Breux-Jouy;1245;11;1256
11;Île-de-France;91;1;08;109;Brières-les-Scellés;1250;8;1258
11;Île-de-France;91;3;05;111;Briis-sous-Forges;3408;38;3446
11;Île-de-France;91;1;08;112;Brouy;133;4;137
11;Île-de-France;91;2;98;114;Brunoy;25669;427;26096
11;Île-de-France;91;3;01;115;Bruyères-le-Châtel;3302;36;3338
11;Île-de-France;91;2;13;121;Buno-Bonnevaux;442;7;449
11;Île-de-France;91;3;10;122;Bures-sur-Yvette;9804;193;9997
11;Île-de-France;91;1;08;129;Cerny;3336;163;3499
11;Île-de-France;91;1;08;130;Chalo-Saint-Mars;1054;28;1082
11;Île-de-France;91;1;08;131;Chalou-Moulineux;431;3;434
11;Île-de-France;91;1;05;132;Chamarande;1147;14;1161
11;Île-de-France;91;2;13;135;Champcueil;2867;57;2924
11;Île-de-France;91;3;11;136;Champlan;2761;18;2779
11;Île-de-France;91;1;08;137;Champmotteux;368;6;374
11;Île-de-France;91;1;08;145;Chatignonville;64;1;65
11;Île-de-France;91;1;05;148;Chauffour-lès-Étréchy;134;0;134
11;Île-de-France;91;3;01;156;Cheptainville;2055;29;2084
11;Île-de-France;91;2;13;159;Chevannes;1621;28;1649
11;Île-de-France;91;3;12;161;Chilly-Mazarin;20181;139;20320
11;Île-de-France;91;1;08;613;Congerville-Thionville;221;7;228
11;Île-de-France;91;2;04;174;Corbeil-Essonnes;51292;280;51572
11;Île-de-France;91;1;05;175;Corbreuse;1741;30;1771
11;Île-de-France;91;2;13;179;Le Coudray-Montceaux;4865;45;4910
11;Île-de-France;91;2;13;180;Courances;342;10;352
11;Île-de-France;91;2;13;184;Courdimanche-sur-Essonne;267;7;274
11;Île-de-France;91;3;05;186;Courson-Monteloup;572;8;580
11;Île-de-France;91;2;19;191;Crosne;9231;58;9289
11;Île-de-France;91;1;08;198;D'Huison-Longueville;1508;25;1533
11;Île-de-France;91;2;13;195;Dannemois;822;6;828
11;Île-de-France;91;1;05;200;Dourdan;10806;184;10990
11;Île-de-France;91;2;06;201;Draveil;28833;242;29075
11;Île-de-France;91;2;04;204;Écharcon;786;17;803
11;Île-de-France;91;3;01;207;Égly;5865;46;5911
11;Île-de-France;91;2;07;215;Épinay-sous-Sénart;12446;85;12531
11;Île-de-France;91;3;11;216;Épinay-sur-Orge;11270;125;11395
11;Île-de-France;91;1;08;223;Étampes;25092;165;25257
11;Île-de-France;91;2;06;225;Étiolles;3161;152;3313
11;Île-de-France;91;1;05;226;Étréchy;6541;93;6634
11;Île-de-France;91;2;09;228;Évry-Courcouronnes;67967;526;68493
11;Île-de-France;91;1;13;232;La Ferté-Alais;3800;57;3857
11;Île-de-France;91;2;15;235;Fleury-Mérogis;12673;16;12689
11;Île-de-France;91;1;08;240;Fontaine-la-Rivière;212;4;216
11;Île-de-France;91;2;13;244;Fontenay-le-Vicomte;1540;24;1564
11;Île-de-France;91;3;05;243;Fontenay-lès-Briis;2149;26;2175
11;Île-de-France;91;1;05;247;La Forêt-le-Roi;524;5;529
11;Île-de-France;91;1;08;248;La Forêt-Sainte-Croix;162;1;163
11;Île-de-France;91;3;05;249;Forges-les-Bains;3851;75;3926
11;Île-de-France;91;3;10;272;Gif-sur-Yvette;21379;615;21994
11;Île-de-France;91;2;13;273;Gironville-sur-Essonne;763;18;781
11;Île-de-France;91;3;10;274;Gometz-la-Ville;1483;24;1507
11;Île-de-France;91;3;18;275;Gometz-le-Châtel;2752;35;2787
11;Île-de-France;91;1;05;284;Les Granges-le-Roi;1198;24;1222
11;Île-de-France;91;2;20;286;Grigny;28737;125;28862
11;Île-de-France;91;3;01;292;Guibeville;707;12;719
11;Île-de-France;91;1;13;293;Guigneville-sur-Essonne;930;17;947
11;Île-de-France;91;1;08;294;Guillerval;819;11;830
11;Île-de-France;91;3;14;312;Igny;10052;353;10405
11;Île-de-France;91;1;13;315;Itteville;6585;61;6646
11;Île-de-France;91;1;01;318;Janville-sur-Juine;1962;47;2009
11;Île-de-France;91;3;05;319;Janvry;636;10;646
11;Île-de-France;91;3;02;326;Juvisy-sur-Orge;16667;128;16795
11;Île-de-France;91;1;01;330;Lardy;5526;74;5600
11;Île-de-France;91;3;03;332;Leudeville;1463;25;1488
11;Île-de-France;91;3;01;333;Leuville-sur-Orge;4471;57;4528
11;Île-de-France;91;3;05;338;Limours;6625;125;6750
11;Île-de-France;91;3;11;339;Linas;6785;54;6839
11;Île-de-France;91;2;04;340;Lisses;7445;59;7504
11;Île-de-France;91;3;11;345;Longjumeau;21221;169;21390
11;Île-de-France;91;3;03;347;Longpont-sur-Orge;6338;51;6389
11;Île-de-France;91;2;13;359;Maisse;2719;32;2751
11;Île-de-France;91;3;18;363;Marcoussis;8139;161;8300
11;Île-de-France;91;1;08;374;Marolles-en-Beauce;233;3;236
11;Île-de-France;91;3;03;376;Marolles-en-Hurepoix;5388;52;5440
11;Île-de-France;91;3;12;377;Massy;50833;309;51142
11;Île-de-France;91;1;05;378;Mauchamps;275;2;277
11;Île-de-France;91;2;13;386;Mennecy;14319;332;14651
11;Île-de-France;91;1;08;390;Le Mérévillois;3347;43;3390
11;Île-de-France;91;1;08;393;Mérobert;614;9;623
11;Île-de-France;91;1;08;399;Mespuits;211;4;215
11;Île-de-France;91;2;13;405;Milly-la-Forêt;4609;88;4697
11;Île-de-France;91;2;13;408;Moigny-sur-École;1253;16;1269
11;Île-de-France;91;3;10;411;Les Molières;1914;48;1962
11;Île-de-France;91;1;13;412;Mondeville;727;14;741
11;Île-de-France;91;1;08;414;Monnerville;382;5;387
11;Île-de-France;91;2;99;421;Montgeron;23775;290;24065
11;Île-de-France;91;3;11;425;Montlhéry;7593;236;7829
11;Île-de-France;91;3;17;432;Morangis;13729;73;13802
11;Île-de-France;91;1;08;433;Morigny-Champigny;4346;106;4452
11;Île-de-France;91;2;16;434;Morsang-sur-Orge;20909;174;21083
11;Île-de-France;91;2;07;435;Morsang-sur-Seine;526;39;565
11;Île-de-France;91;2;13;441;Nainville-les-Roches;470;11;481
11;Île-de-France;91;3;01;457;La Norville;4097;42;4139
11;Île-de-France;91;3;18;458;Nozay;4642;73;4715
11;Île-de-France;91;3;01;461;Ollainville;4722;59;4781
11;Île-de-France;91;2;13;463;Oncy-sur-École;1038;22;1060
11;Île-de-France;91;2;13;468;Ormoy;2046;20;2066
11;Île-de-France;91;1;08;469;Ormoy-la-Rivière;921;60;981
11;Île-de-France;91;3;14;471;Orsay;16421;332;16753
11;Île-de-France;91;1;08;473;Orveau;193;7;200
11;Île-de-France;91;3;14;477;Palaiseau;35514;367;35881
11;Île-de-France;91;3;02;479;Paray-Vieille-Poste;7457;55;7512
11;Île-de-France;91;3;10;482;Pecqueuse;549;17;566
11;Île-de-France;91;3;15;494;Le Plessis-Pâté;4103;59;4162
11;Île-de-France;91;1;08;495;Plessis-Saint-Benoist;330;2;332
11;Île-de-France;91;2;13;507;Prunay-sur-Essonne;295;5;300
11;Île-de-France;91;1;08;508;Puiselet-le-Marais;266;4;270
11;Île-de-France;91;1;08;511;Pussay;2200;31;2231
11;Île-de-France;91;2;07;514;Quincy-sous-Sénart;9021;43;9064
11;Île-de-France;91;1;05;519;Richarville;397;6;403
11;Île-de-France;91;2;15;521;Ris-Orangis;29225;193;29418
11;Île-de-France;91;1;05;525;Roinville;1393;23;1416
11;Île-de-France;91;1;08;526;Roinvilliers;107;1;108
11;Île-de-France;91;1;08;533;Saclas;1806;24;1830
11;Île-de-France;91;3;10;534;Saclay;4029;54;4083
11;Île-de-France;91;3;10;538;Saint-Aubin;703;21;724
11;Île-de-France;91;1;05;540;Saint-Chéron;5072;77;5149
11;Île-de-France;91;1;08;544;Saint-Cyr-la-Rivière;517;9;526
11;Île-de-France;91;1;05;546;Saint-Cyr-sous-Dourdan;978;23;1001
11;Île-de-France;91;1;08;547;Saint-Escobille;562;3;565
11;Île-de-France;91;3;01;552;Saint-Germain-lès-Arpajon;10707;72;10779
11;Île-de-France;91;2;06;553;Saint-Germain-lès-Corbeil;7493;99;7592
11;Île-de-France;91;1;08;556;Saint-Hilaire;408;9;417
11;Île-de-France;91;3;18;560;Saint-Jean-de-Beauregard;441;6;447
11;Île-de-France;91;3;05;568;Saint-Maurice-Montcouronne;1564;36;1600
11;Île-de-France;91;3;03;570;Saint-Michel-sur-Orge;19758;144;19902
11;Île-de-France;91;2;07;573;Saint-Pierre-du-Perray;10835;109;10944
11;Île-de-France;91;1;05;578;Saint-Sulpice-de-Favières;294;5;299
11;Île-de-France;91;3;03;579;Saint-Vrain;3059;52;3111
11;Île-de-France;91;1;01;581;Saint-Yon;894;10;904
11;Île-de-France;91;3;16;549;Sainte-Geneviève-des-Bois;36207;320;36527
11;Île-de-France;91;2;07;577;Saintry-sur-Seine;5720;54;5774
11;Île-de-France;91;3;11;587;Saulx-les-Chartreux;5886;41;5927
11;Île-de-France;91;3;17;589;Savigny-sur-Orge;36533;284;36817
11;Île-de-France;91;1;05;593;Sermaise;1622;39;1661
11;Île-de-France;91;2;13;599;Soisy-sur-École;1269;21;1290
11;Île-de-France;91;2;06;600;Soisy-sur-Seine;7154;133;7287
11;Île-de-France;91;1;05;602;Souzy-la-Briche;428;8;436
11;Île-de-France;91;2;07;617;Tigery;4017;73;4090
11;Île-de-France;91;1;01;619;Torfou;272;10;282
11;Île-de-France;91;3;18;692;Les Ulis;25208;153;25361
11;Île-de-France;91;1;05;630;Le Val-Saint-Germain;1475;31;1506
11;Île-de-France;91;1;08;629;Valpuiseaux;612;11;623
11;Île-de-France;91;2;07;631;Varennes-Jarcy;2310;30;2340
11;Île-de-France;91;3;05;634;Vaugrigneuse;1287;17;1304
11;Île-de-France;91;3;10;635;Vauhallan;2059;32;2091
11;Île-de-France;91;1;08;639;Vayres-sur-Essonne;929;67;996
11;Île-de-France;91;3;10;645;Verrières-le-Buisson;15242;336;15578
11;Île-de-France;91;2;15;648;Vert-le-Grand;2322;28;2350
11;Île-de-France;91;2;15;649;Vert-le-Petit;2790;37;2827
11;Île-de-France;91;1;13;654;Videlles;600;17;617
11;Île-de-France;91;2;19;657;Vigneux-sur-Seine;31574;178;31752
11;Île-de-France;91;2;04;659;Villabé;5438;40;5478
11;Île-de-France;91;3;11;665;La Ville-du-Bois;7753;62;7815
11;Île-de-France;91;3;18;661;Villebon-sur-Yvette;10489;168;10657
11;Île-de-France;91;1;05;662;Villeconin;724;22;746
11;Île-de-France;91;3;18;666;Villejust;2385;16;2401
11;Île-de-France;91;3;16;667;Villemoisson-sur-Orge;6996;88;7084
11;Île-de-France;91;1;08;671;Villeneuve-sur-Auvers;617;13;630
11;Île-de-France;91;3;10;679;Villiers-le-Bâcle;1237;16;1253
11;Île-de-France;91;3;16;685;Villiers-sur-Orge;4548;37;4585
11;Île-de-France;91;2;20;687;Viry-Châtillon;31093;224;31317
11;Île-de-France;91;3;17;689;Wissous;7470;74;7544
11;Île-de-France;91;2;21;691;Yerres;29029;234;29263
11;Île-de-France;92;1;01;002;Antony;62570;749;63319
11;Île-de-France;92;2;95;004;Asnières-sur-Seine;85191;684;85875
11;Île-de-France;92;1;03;007;Bagneux;40918;193;41111
11;Île-de-France;92;2;11;009;Bois-Colombes;28239;237;28476
11;Île-de-France;92;3;96;012;Boulogne-Billancourt;120071;1178;121249
11;Île-de-France;92;1;03;014;Bourg-la-Reine;20667;342;21009
11;Île-de-France;92;1;06;019;Châtenay-Malabry;33286;378;33664
11;Île-de-France;92;1;07;020;Châtillon;37355;341;37696
11;Île-de-France;92;3;17;022;Chaville;20520;325;20845
11;Île-de-France;92;1;08;023;Clamart;52971;538;53509
11;Île-de-France;92;2;09;024;Clichy;61070;309;61379
11;Île-de-France;92;2;97;025;Colombes;85177;598;85775
11;Île-de-France;92;2;98;026;Courbevoie;81719;608;82327
11;Île-de-France;92;1;07;032;Fontenay-aux-Roses;24564;245;24809
11;Île-de-France;92;2;23;033;Garches;17869;415;18284
11;Île-de-France;92;2;11;035;La Garenne-Colombes;29169;245;29414
11;Île-de-France;92;2;14;036;Gennevilliers;46907;262;47169
11;Île-de-France;92;3;15;040;Issy-les-Moulineaux;68451;826;69277
11;Île-de-France;92;2;16;044;Levallois-Perret;64379;543;64922
11;Île-de-France;92;1;18;046;Malakoff;30720;212;30932
11;Île-de-France;92;3;23;047;Marnes-la-Coquette;1810;52;1862
11;Île-de-France;92;3;17;048;Meudon;45352;657;46009
11;Île-de-France;92;1;18;049;Montrouge;50260;221;50481
11;Île-de-France;92;2;99;050;Nanterre;95105;634;95739
11;Île-de-France;92;2;21;051;Neuilly-sur-Seine;60361;935;61296
11;Île-de-France;92;1;06;060;Le Plessis-Robinson;29100;149;29249
11;Île-de-France;92;2;13;062;Puteaux;44645;260;44905
11;Île-de-France;92;2;22;063;Rueil-Malmaison;78152;1593;79745
11;Île-de-France;92;2;23;064;Saint-Cloud;29973;609;30582
11;Île-de-France;92;1;06;071;Sceaux;19344;368;19712
11;Île-de-France;92;3;05;072;Sèvres;23507;403;23910
11;Île-de-France;92;2;20;073;Suresnes;48264;472;48736
11;Île-de-France;92;3;08;075;Vanves;27729;277;28006
11;Île-de-France;92;2;23;076;Vaucresson;8667;326;8993
11;Île-de-France;92;3;23;077;Ville-d'Avray;11453;317;11770
11;Île-de-France;92;2;14;078;Villeneuve-la-Garenne;23771;110;23881
11;Île-de-France;93;3;01;001;Aubervilliers;86375;222;86597
11;Île-de-France;93;2;02;005;Aulnay-sous-Bois;85740;440;86180
11;Île-de-France;93;1;03;006;Bagnolet;35674;123;35797
11;Île-de-France;93;2;04;007;Le Blanc-Mesnil;56783;246;57029
11;Île-de-France;93;1;95;008;Bobigny;53640;174;53814
11;Île-de-France;93;1;06;010;Bondy;53353;187;53540
11;Île-de-France;93;2;07;013;Le Bourget;16594;49;16643
11;Île-de-France;93;2;11;014;Clichy-sous-Bois;29348;85;29433
11;Île-de-France;93;2;20;015;Coubron;4833;30;4863
11;Île-de-France;93;3;07;027;La Courneuve;43054;149;43203
11;Île-de-France;93;2;96;029;Drancy;71318;287;71605
11;Île-de-France;93;2;07;030;Dugny;10732;40;10772
11;Île-de-France;93;3;97;031;Épinay-sur-Seine;55084;153;55237
11;Île-de-France;93;2;10;032;Gagny;39358;177;39535
11;Île-de-France;93;2;14;033;Gournay-sur-Marne;6869;64;6933
11;Île-de-France;93;3;18;039;L' Île-Saint-Denis;7981;35;8016
11;Île-de-France;93;1;03;045;Les Lilas;23045;123;23168
11;Île-de-France;93;2;11;046;Livry-Gargan;44437;224;44661
11;Île-de-France;93;2;20;047;Montfermeil;26783;106;26889
11;Île-de-France;93;1;98;048;Montreuil;109897;577;110474
11;Île-de-France;93;2;21;049;Neuilly-Plaisance;21150;118;21268
11;Île-de-France;93;2;10;050;Neuilly-sur-Marne;34993;119;35112
11;Île-de-France;93;2;14;051;Noisy-le-Grand;68183;332;68515
11;Île-de-France;93;1;05;053;Noisy-le-Sec;44136;138;44274
11;Île-de-France;93;1;15;055;Pantin;57482;186;57668
11;Île-de-France;93;2;06;057;Les Pavillons-sous-Bois;23962;98;24060
11;Île-de-France;93;3;09;059;Pierrefitte-sur-Seine;30306;81;30387
11;Île-de-France;93;1;15;061;Le Pré-Saint-Gervais;17950;90;18040
11;Île-de-France;93;2;21;062;Le Raincy;14648;228;14876
11;Île-de-France;93;1;03;063;Romainville;27567;88;27655
11;Île-de-France;93;2;12;064;Rosny-sous-Bois;46207;188;46395
11;Île-de-France;93;3;99;066;Saint-Denis;111135;813;111948
11;Île-de-France;93;3;18;070;Saint-Ouen-sur-Seine;51108;160;51268
11;Île-de-France;93;2;19;071;Sevran;51016;185;51201
11;Île-de-France;93;3;17;072;Stains;38720;103;38823
11;Île-de-France;93;2;20;073;Tremblay-en-France;36180;165;36345
11;Île-de-France;93;2;20;074;Vaujours;7030;87;7117
11;Île-de-France;93;2;21;077;Villemomble;29964;188;30152
11;Île-de-France;93;2;19;078;Villepinte;36830;104;36934
11;Île-de-France;93;3;09;079;Villetaneuse;13646;60;13706
11;Île-de-France;94;3;15;001;Ablon-sur-Seine;5785;26;5811
11;Île-de-France;94;1;01;002;Alfortville;43881;182;44063
11;Île-de-France;94;3;02;003;Arcueil;21501;131;21632
11;Île-de-France;94;1;16;004;Boissy-Saint-Léger;16345;81;16426
11;Île-de-France;94;1;18;011;Bonneuil-sur-Marne;17950;89;18039
11;Île-de-France;94;2;22;015;Bry-sur-Marne;16624;181;16805
11;Île-de-France;94;3;02;016;Cachan;31069;473;31542
11;Île-de-France;94;2;93;017;Champigny-sur-Marne;77630;362;77992
11;Île-de-France;94;2;05;018;Charenton-le-Pont;30374;194;30568
11;Île-de-France;94;1;04;019;Chennevières-sur-Marne;18321;123;18444
11;Île-de-France;94;3;19;021;Chevilly-Larue;19491;87;19578
11;Île-de-France;94;3;06;022;Choisy-le-Roi;45331;221;45552
11;Île-de-France;94;1;94;028;Créteil;90605;515;91120
11;Île-de-France;94;2;09;033;Fontenay-sous-Bois;52939;479;53418
11;Île-de-France;94;3;10;034;Fresnes;27802;103;27905
11;Île-de-France;94;3;12;037;Gentilly;18605;102;18707
11;Île-de-France;94;3;10;038;L' Haÿ-les-Roses;31204;160;31364
11;Île-de-France;94;3;11;041;Ivry-sur-Seine;62052;242;62294
11;Île-de-France;94;2;05;042;Joinville-le-Pont;19133;149;19282
11;Île-de-France;94;3;12;043;Le Kremlin-Bicêtre;25334;134;25468
11;Île-de-France;94;1;21;044;Limeil-Brévannes;27228;108;27336
11;Île-de-France;94;2;13;046;Maisons-Alfort;55655;333;55988
11;Île-de-France;94;1;16;047;Mandres-les-Roses;4755;39;4794
11;Île-de-France;94;1;16;048;Marolles-en-Brie;4847;101;4948
11;Île-de-France;94;2;95;052;Nogent-sur-Marne;32851;227;33078
11;Île-de-France;94;1;16;053;Noiseau;4651;43;4694
11;Île-de-France;94;3;15;054;Orly;23801;201;24002
11;Île-de-France;94;1;18;055;Ormesson-sur-Marne;10305;101;10406
11;Île-de-France;94;1;16;056;Périgny;2668;24;2692
11;Île-de-France;94;2;14;058;Le Perreux-sur-Marne;33879;282;34161
11;Île-de-France;94;1;22;059;Le Plessis-Trévise;20130;85;20215
11;Île-de-France;94;1;16;060;La Queue-en-Brie;11931;130;12061
11;Île-de-France;94;3;19;065;Rungis;5611;66;5677
11;Île-de-France;94;2;23;067;Saint-Mandé;22619;216;22835
11;Île-de-France;94;2;96;068;Saint-Maur-des-Fossés;74859;900;75759
11;Île-de-France;94;2;05;069;Saint-Maurice;14056;97;14153
11;Île-de-France;94;1;16;070;Santeny;3775;57;3832
11;Île-de-France;94;1;18;071;Sucy-en-Brie;26472;237;26709
11;Île-de-France;94;3;19;073;Thiais;29017;230;29247
11;Île-de-France;94;3;21;074;Valenton;14796;69;14865
11;Île-de-France;94;1;16;075;Villecresnes;10458;58;10516
11;Île-de-France;94;3;20;076;Villejuif;54753;294;55047
11;Île-de-France;94;3;15;077;Villeneuve-le-Roi;21384;97;21481
11;Île-de-France;94;3;97;078;Villeneuve-Saint-Georges;33545;91;33636
11;Île-de-France;94;2;22;079;Villiers-sur-Marne;28456;111;28567
11;Île-de-France;94;2;98;080;Vincennes;49891;376;50267
11;Île-de-France;94;3;99;081;Vitry-sur-Seine;93557;502;94059
11;Île-de-France;95;3;16;002;Ableiges;1161;8;1169
11;Île-de-France;95;3;20;008;Aincourt;916;14;930
11;Île-de-France;95;3;20;011;Ambleville;372;10;382
11;Île-de-France;95;3;20;012;Amenucourt;210;6;216
11;Île-de-France;95;2;15;014;Andilly;2590;55;2645
11;Île-de-France;95;1;98;018;Argenteuil;110210;629;110839
11;Île-de-France;95;2;11;019;Arnouville;14227;86;14313
11;Île-de-France;95;3;16;023;Arronville;656;3;659
11;Île-de-France;95;3;20;024;Arthies;278;5;283
11;Île-de-France;95;2;14;026;Asnières-sur-Oise;2650;36;2686
11;Île-de-France;95;2;09;028;Attainville;1702;8;1710
11;Île-de-France;95;3;17;039;Auvers-sur-Oise;6908;107;7015
11;Île-de-France;95;3;20;040;Avernes;852;22;874
11;Île-de-France;95;2;07;042;Baillet-en-France;1957;16;1973
11;Île-de-France;95;3;20;046;Banthelu;154;2;156
11;Île-de-France;95;1;19;051;Beauchamp;8683;92;8775
11;Île-de-France;95;3;14;052;Beaumont-sur-Oise;9576;93;9669
11;Île-de-France;95;3;16;054;Le Bellay-en-Vexin;234;5;239
11;Île-de-France;95;2;09;055;Bellefontaine;485;7;492
11;Île-de-France;95;2;09;056;Belloy-en-France;2189;8;2197
11;Île-de-France;95;3;14;058;Bernes-sur-Oise;2708;27;2735
11;Île-de-France;95;3;16;059;Berville;352;3;355
11;Île-de-France;95;1;19;060;Bessancourt;7318;55;7373
11;Île-de-France;95;3;07;061;Béthemont-la-Forêt;414;3;417
11;Île-de-France;95;1;03;063;Bezons;29383;125;29508
11;Île-de-France;95;3;05;074;Boisemont;745;16;761
11;Île-de-France;95;3;16;078;Boissy-l'Aillerie;1816;32;1848
11;Île-de-France;95;2;21;088;Bonneuil-en-France;1076;3;1079
11;Île-de-France;95;2;07;091;Bouffémont;6327;56;6383
11;Île-de-France;95;2;21;094;Bouqueval;306;2;308
11;Île-de-France;95;3;20;101;Bray-et-Lû;957;13;970
11;Île-de-France;95;3;16;102;Bréançon;373;8;381
11;Île-de-France;95;3;16;110;Brignancourt;206;3;209
11;Île-de-France;95;3;14;116;Bruyères-sur-Oise;4323;28;4351
11;Île-de-France;95;3;20;119;Buhy;325;2;327
11;Île-de-France;95;3;17;120;Butry-sur-Oise;2272;24;2296
11;Île-de-France;95;3;99;127;Cergy;65177;470;65647
11;Île-de-France;95;3;14;134;Champagne-sur-Oise;5018;41;5059
11;Île-de-France;95;3;20;139;La Chapelle-en-Vexin;333;5;338
11;Île-de-France;95;3;20;141;Charmont;36;0;36
11;Île-de-France;95;3;16;142;Chars;2110;17;2127
11;Île-de-France;95;2;09;144;Châtenay-en-France;74;1;75
11;Île-de-France;95;2;09;149;Chaumontel;3261;55;3316
11;Île-de-France;95;3;20;150;Chaussy;591;15;606
11;Île-de-France;95;3;07;151;Chauvry;299;5;304
11;Île-de-France;95;2;12;154;Chennevières-lès-Louvres;306;3;309
11;Île-de-France;95;3;20;157;Chérence;138;4;142
11;Île-de-France;95;3;20;166;Cléry-en-Vexin;459;7;466
11;Île-de-France;95;3;16;169;Commeny;483;3;486
11;Île-de-France;95;3;20;170;Condécourt;556;1;557
11;Île-de-France;95;1;10;176;Cormeilles-en-Parisis;24161;193;24354
11;Île-de-France;95;3;16;177;Cormeilles-en-Vexin;1402;14;1416
11;Île-de-France;95;3;16;181;Courcelles-sur-Viosne;268;6;274
11;Île-de-France;95;3;20;183;Courdimanche;6681;110;6791
11;Île-de-France;95;2;06;197;Deuil-la-Barre;22306;191;22497
11;Île-de-France;95;2;07;199;Domont;15514;204;15718
11;Île-de-France;95;1;08;203;Eaubonne;25097;333;25430
11;Île-de-France;95;2;09;205;Écouen;7188;48;7236
11;Île-de-France;95;2;15;210;Enghien-les-Bains;11228;141;11369
11;Île-de-France;95;3;16;211;Ennery;2430;26;2456
11;Île-de-France;95;2;12;212;Épiais-lès-Louvres;107;0;107
11;Île-de-France;95;3;16;213;Épiais-Rhus;615;16;631
11;Île-de-France;95;2;09;214;Épinay-Champlâtreux;68;0;68
11;Île-de-France;95;3;05;218;Éragny;17354;111;17465
11;Île-de-France;95;1;08;219;Ermont;29108;240;29348
11;Île-de-France;95;2;09;229;Ézanville;9775;61;9836
11;Île-de-France;95;2;09;241;Fontenay-en-Parisis;1980;15;1995
11;Île-de-France;95;2;09;250;Fosses;9679;65;9744
11;Île-de-France;95;1;10;252;Franconville;36762;210;36972
11;Île-de-France;95;3;20;253;Frémainville;499;10;509
11;Île-de-France;95;3;16;254;Frémécourt;572;8;580
11;Île-de-France;95;1;17;256;Frépillon;3337;32;3369
11;Île-de-France;95;1;13;257;La Frette-sur-Seine;4686;40;4726
11;Île-de-France;95;3;17;258;Frouville;358;8;366
11;Île-de-France;95;2;11;268;Garges-lès-Gonesse;42728;125;42853
11;Île-de-France;95;3;20;270;Genainville;543;19;562
11;Île-de-France;95;3;16;271;Génicourt;528;8;536
11;Île-de-France;95;2;21;277;Gonesse;25999;133;26132
11;Île-de-France;95;2;12;280;Goussainville;30637;150;30787
11;Île-de-France;95;3;16;282;Gouzangrez;165;1;166
11;Île-de-France;95;3;16;287;Grisy-les-Plâtres;696;12;708
11;Île-de-France;95;2;06;288;Groslay;8778;82;8860
11;Île-de-France;95;3;20;295;Guiry-en-Vexin;155;3;158
11;Île-de-France;95;3;16;298;Haravilliers;550;6;556
11;Île-de-France;95;3;20;301;Haute-Isle;278;5;283
11;Île-de-France;95;3;16;303;Le Heaulme;211;1;212
11;Île-de-France;95;3;17;304;Hédouville;282;8;290
11;Île-de-France;95;1;13;306;Herblay-sur-Seine;29342;229;29571
11;Île-de-France;95;3;17;308;Hérouville-en-Vexin;605;13;618
11;Île-de-France;95;3;20;309;Hodent;214;3;217
11;Île-de-France;95;3;14;313;L' Isle-Adam;12057;212;12269
11;Île-de-France;95;2;09;316;Jagny-sous-Bois;258;2;260
11;Île-de-France;95;3;05;323;Jouy-le-Moutier;16035;122;16157
11;Île-de-France;95;3;17;328;Labbeville;626;7;633
11;Île-de-France;95;2;09;331;Lassy;176;3;179
11;Île-de-France;95;3;16;341;Livilliers;385;9;394
11;Île-de-France;95;3;20;348;Longuesse;542;6;548
11;Île-de-France;95;2;12;351;Louvres;10337;79;10416
11;Île-de-France;95;2;09;352;Luzarches;4551;69;4620
11;Île-de-France;95;2;09;353;Maffliers;1843;17;1860
11;Île-de-France;95;3;20;355;Magny-en-Vexin;5653;62;5715
11;Île-de-France;95;2;09;365;Mareil-en-France;698;9;707
11;Île-de-France;95;2;15;369;Margency;2887;51;2938
11;Île-de-France;95;3;16;370;Marines;3481;62;3543
11;Île-de-France;95;2;12;371;Marly-la-Ville;5677;44;5721
11;Île-de-France;95;3;20;379;Maudétour-en-Vexin;189;2;191
11;Île-de-France;95;3;16;387;Menouville;60;0;60
11;Île-de-France;95;3;20;388;Menucourt;5771;53;5824
11;Île-de-France;95;3;17;392;Mériel;5083;43;5126
11;Île-de-France;95;3;17;394;Méry-sur-Oise;9892;100;9992
11;Île-de-France;95;2;09;395;Le Mesnil-Aubry;921;9;930
11;Île-de-France;95;2;07;409;Moisselles;1347;3;1350
11;Île-de-France;95;3;16;422;Montgeroult;369;3;372
11;Île-de-France;95;1;13;424;Montigny-lès-Cormeilles;21601;117;21718
11;Île-de-France;95;2;15;426;Montlignon;2978;90;3068
11;Île-de-France;95;2;06;427;Montmagny;14173;65;14238
11;Île-de-France;95;2;15;428;Montmorency;21461;271;21732
11;Île-de-France;95;3;20;429;Montreuil-sur-Epte;417;10;427
11;Île-de-France;95;2;07;430;Montsoult;3482;34;3516
11;Île-de-France;95;3;14;436;Mours;1609;11;1620
11;Île-de-France;95;3;16;438;Moussy;130;2;132
11;Île-de-France;95;3;14;445;Nerville-la-Forêt;663;3;666
11;Île-de-France;95;3;17;446;Nesles-la-Vallée;1843;33;1876
11;Île-de-France;95;3;16;447;Neuilly-en-Vexin;208;4;212
11;Île-de-France;95;3;05;450;Neuville-sur-Oise;2048;27;2075
11;Île-de-France;95;3;14;452;Nointel;816;7;823
11;Île-de-France;95;3;14;456;Noisy-sur-Oise;665;4;669
11;Île-de-France;95;3;16;459;Nucourt;712;15;727
11;Île-de-France;95;3;20;462;Omerville;319;8;327
11;Île-de-France;95;3;04;476;Osny;16910;225;17135
11;Île-de-France;95;3;14;480;Parmain;5549;93;5642
11;Île-de-France;95;3;16;483;Le Perchay;541;4;545
11;Île-de-France;95;3;14;487;Persan;12695;40;12735
11;Île-de-France;95;1;19;488;Pierrelaye;8393;38;8431
11;Île-de-France;95;2;07;489;Piscop;676;69;745
11;Île-de-France;95;1;07;491;Le Plessis-Bouchard;8408;69;8477
11;Île-de-France;95;2;09;492;Le Plessis-Gassot;71;0;71
11;Île-de-France;95;2;09;493;Le Plessis-Luzarches;136;1;137
11;Île-de-France;95;3;16;500;Pontoise;30767;667;31434
11;Île-de-France;95;3;14;504;Presles;3904;52;3956
11;Île-de-France;95;2;09;509;Puiseux-en-France;3523;40;3563
11;Île-de-France;95;3;04;510;Puiseux-Pontoise;603;12;615
11;Île-de-France;95;3;20;523;La Roche-Guyon;478;37;515
11;Île-de-France;95;2;21;527;Roissy-en-France;2883;25;2908
11;Île-de-France;95;3;14;529;Ronquerolles;872;7;879
11;Île-de-France;95;3;20;535;Sagy;1114;26;1140
11;Île-de-France;95;2;06;539;Saint-Brice-sous-Forêt;14883;79;14962
11;Île-de-France;95;3;20;541;Saint-Clair-sur-Epte;996;14;1010
11;Île-de-France;95;3;20;543;Saint-Cyr-en-Arthies;244;1;245
11;Île-de-France;95;3;20;554;Saint-Gervais;920;19;939
11;Île-de-France;95;2;01;555;Saint-Gratien;20682;177;20859
11;Île-de-France;95;1;07;563;Saint-Leu-la-Forêt;15798;168;15966
11;Île-de-France;95;2;09;566;Saint-Martin-du-Tertre;2778;13;2791
11;Île-de-France;95;3;17;572;Saint-Ouen-l'Aumône;23741;112;23853
11;Île-de-France;95;2;07;574;Saint-Prix;7158;106;7264
11;Île-de-France;95;2;12;580;Saint-Witz;2383;105;2488
11;Île-de-France;95;1;01;582;Sannois;26662;358;27020
11;Île-de-France;95;3;16;584;Santeuil;672;6;678
11;Île-de-France;95;2;18;585;Sarcelles;58587;262;58849
11;Île-de-France;95;3;20;592;Seraincourt;1299;14;1313
11;Île-de-France;95;2;09;594;Seugy;999;14;1013
11;Île-de-France;95;2;15;598;Soisy-sous-Montmorency;18155;186;18341
11;Île-de-France;95;2;12;604;Survilliers;4171;25;4196
11;Île-de-France;95;1;19;607;Taverny;26441;189;26630
11;Île-de-France;95;3;20;610;Théméricourt;297;6;303
11;Île-de-France;95;3;16;611;Theuville;45;0;45
11;Île-de-France;95;2;21;612;Le Thillay;4557;21;4578
11;Île-de-France;95;3;16;625;Us;1322;12;1334
11;Île-de-France;95;3;16;627;Vallangoujard;612;14;626
11;Île-de-France;95;3;17;628;Valmondois;1195;21;1216
11;Île-de-France;95;2;21;633;Vaudherland;92;0;92
11;Île-de-France;95;3;20;637;Vauréal;16464;213;16677
11;Île-de-France;95;2;12;641;Vémars;2471;23;2494
11;Île-de-France;95;3;20;651;Vétheuil;857;20;877
11;Île-de-France;95;2;09;652;Viarmes;5175;65;5240
11;Île-de-France;95;3;20;656;Vienne-en-Arthies;416;7;423
11;Île-de-France;95;3;20;658;Vigny;1089;23;1112
11;Île-de-France;95;2;09;660;Villaines-sous-Bois;776;7;783
11;Île-de-France;95;2;12;675;Villeron;1001;9;1010
11;Île-de-France;95;3;20;676;Villers-en-Arthies;503;10;513
11;Île-de-France;95;3;14;678;Villiers-Adam;859;11;870
11;Île-de-France;95;2;21;680;Villiers-le-Bel;27676;132;27808
11;Île-de-France;95;2;09;682;Villiers-le-Sec;185;3;188
11;Île-de-France;95;3;20;690;Wy-dit-Joli-Village;333;7;340
01;Guadeloupe;971;2;93;101;Les Abymes;53491;558;54049
01;Guadeloupe;971;2;14;102;Anse-Bertrand;4275;68;4343
01;Guadeloupe;971;1;94;103;Baie-Mahault;30929;475;31404
01;Guadeloupe;971;1;21;104;Baillif;5605;98;5703
01;Guadeloupe;971;1;06;105;Basse-Terre;10058;247;10305
01;Guadeloupe;971;1;95;106;Bouillante;7024;111;7135
01;Guadeloupe;971;1;07;107;Capesterre-Belle-Eau;18270;147;18417
01;Guadeloupe;971;2;10;108;Capesterre-de-Marie-Galante;3301;44;3345
01;Guadeloupe;971;1;18;111;Deshaies;4081;64;4145
01;Guadeloupe;971;2;16;110;La Désirade;1448;34;1482
01;Guadeloupe;971;2;96;113;Le Gosier;26783;313;27096
01;Guadeloupe;971;1;20;109;Gourbeyre;7795;184;7979
01;Guadeloupe;971;1;13;114;Goyave;7555;136;7691
01;Guadeloupe;971;2;10;112;Grand-Bourg;5012;135;5147
01;Guadeloupe;971;1;09;115;Lamentin;16573;318;16891
01;Guadeloupe;971;2;12;116;Morne-à-l'Eau;17434;203;17637
01;Guadeloupe;971;2;11;117;Le Moule;22150;239;22389
01;Guadeloupe;971;1;97;118;Petit-Bourg;24277;511;24788
01;Guadeloupe;971;2;14;119;Petit-Canal;8220;150;8370
01;Guadeloupe;971;2;15;120;Pointe-à-Pitre;15923;125;16048
01;Guadeloupe;971;1;18;121;Pointe-Noire;6107;133;6240
01;Guadeloupe;971;2;14;122;Port-Louis;5704;61;5765
01;Guadeloupe;971;1;06;124;Saint-Claude;10381;242;10623
01;Guadeloupe;971;2;16;125;Saint-François;12816;173;12989
01;Guadeloupe;971;2;10;126;Saint-Louis;2447;54;2501
01;Guadeloupe;971;2;98;128;Sainte-Anne;23675;276;23951
01;Guadeloupe;971;1;99;129;Sainte-Rose;19162;340;19502
01;Guadeloupe;971;1;20;130;Terre-de-Bas;1046;21;1067
01;Guadeloupe;971;1;20;131;Terre-de-Haut;1532;39;1571
01;Guadeloupe;971;1;20;132;Trois-Rivières;8124;182;8306
01;Guadeloupe;971;1;20;133;Vieux-Fort;1845;31;1876
01;Guadeloupe;971;1;21;134;Vieux-Habitants;7210;188;7398
02;Martinique;972;2;  ;201;L' Ajoupa-Bouillon;1874;33;1907
02;Martinique;972;3;  ;202;Les Anses-d'Arlet;3587;53;3640
02;Martinique;972;2;  ;203;Basse-Pointe;3026;45;3071
02;Martinique;972;4;  ;234;Bellefontaine;1721;107;1828
02;Martinique;972;4;  ;204;Le Carbet;3535;48;3583
02;Martinique;972;4;  ;205;Case-Pilote;4454;69;4523
02;Martinique;972;3;  ;206;Le Diamant;5642;74;5716
02;Martinique;972;3;  ;207;Ducos;17367;290;17657
02;Martinique;972;4;  ;208;Fonds-Saint-Denis;730;12;742
02;Martinique;972;1;  ;209;Fort-de-France;80041;965;81006
02;Martinique;972;3;  ;210;Le François;16949;313;17262
02;Martinique;972;2;  ;211;Grand'Rivière;721;10;731
02;Martinique;972;2;  ;212;Gros-Morne;9869;79;9948
02;Martinique;972;1;  ;213;Le Lamentin;39809;662;40471
02;Martinique;972;2;  ;214;Le Lorrain;6878;77;6955
02;Martinique;972;2;  ;215;Macouba;1074;9;1083
02;Martinique;972;2;  ;216;Le Marigot;3196;33;3229
02;Martinique;972;3;  ;217;Le Marin;8791;146;8937
02;Martinique;972;4;  ;218;Le Morne-Rouge;5114;60;5174
02;Martinique;972;4;  ;233;Le Morne-Vert;1834;26;1860
02;Martinique;972;4;  ;219;Le Prêcheur;1304;24;1328
02;Martinique;972;3;  ;220;Rivière-Pilote;11935;132;12067
02;Martinique;972;3;  ;221;Rivière-Salée;12168;219;12387
02;Martinique;972;2;  ;222;Le Robert;22719;209;22928
02;Martinique;972;3;  ;223;Saint-Esprit;9432;88;9520
02;Martinique;972;1;  ;224;Saint-Joseph;16232;228;16460
02;Martinique;972;4;  ;225;Saint-Pierre;4123;55;4178
02;Martinique;972;3;  ;226;Sainte-Anne;4298;58;4356
02;Martinique;972;3;  ;227;Sainte-Luce;9816;221;10037
02;Martinique;972;2;  ;228;Sainte-Marie;15932;150;16082
02;Martinique;972;1;  ;229;Schœlcher;19997;225;20222
02;Martinique;972;2;  ;230;La Trinité;12243;173;12416
02;Martinique;972;3;  ;231;Les Trois-Îlets;7339;127;7466
02;Martinique;972;3;  ;232;Le Vauclin;8844;97;8941
03;Guyane;973;2;  ;360;Apatou;9241;4;9245
03;Guyane;973;2;  ;361;Awala-Yalimapo;1411;12;1423
03;Guyane;973;1;  ;356;Camopi;1805;23;1828
03;Guyane;973;1;  ;302;Cayenne;61268;377;61645
03;Guyane;973;2;  ;357;Grand-Santi;7918;33;7951
03;Guyane;973;1;  ;303;Iracoubo;1799;20;1819
03;Guyane;973;1;  ;304;Kourou;25685;228;25913
03;Guyane;973;1;  ;305;Macouria;14202;153;14355
03;Guyane;973;2;  ;306;Mana;10894;165;11059
03;Guyane;973;2;  ;353;Maripasoula;13227;124;13351
03;Guyane;973;1;  ;307;Matoury;31956;277;32233
03;Guyane;973;1;  ;313;Montsinéry-Tonnegrande;2589;20;2609
03;Guyane;973;1;  ;314;Ouanary;200;1;201
03;Guyane;973;2;  ;362;Papaichton;6668;21;6689
03;Guyane;973;1;  ;301;Régina;876;25;901
03;Guyane;973;1;  ;309;Remire-Montjoly;25122;416;25538
03;Guyane;973;1;  ;310;Roura;3783;59;3842
03;Guyane;973;1;  ;358;Saint-Élie;242;1;243
03;Guyane;973;1;  ;308;Saint-Georges;4131;89;4220
03;Guyane;973;2;  ;311;Saint-Laurent-du-Maroni;42612;324;42936
03;Guyane;973;2;  ;352;Saül;152;8;160
03;Guyane;973;1;  ;312;Sinnamary;2919;44;2963
04;La Réunion;974;2;01;401;Les Avirons;11345;166;11511
04;La Réunion;974;3;06;402;Bras-Panon;12811;181;12992
04;La Réunion;974;2;16;424;Cilaos;5456;81;5537
04;La Réunion;974;2;16;403;Entre-Deux;6902;67;6969
04;La Réunion;974;2;01;404;L' Étang-Salé;13894;209;14103
04;La Réunion;974;2;22;405;Petite-Île;12162;111;12273
04;La Réunion;974;3;07;406;La Plaine-des-Palmistes;6565;94;6659
04;La Réunion;974;4;02;407;Le Port;34128;310;34438
04;La Réunion;974;4;03;408;La Possession;33020;354;33374
04;La Réunion;974;3;91;409;Saint-André;56268;421;56689
04;La Réunion;974;3;92;410;Saint-Benoît;37759;254;38013
04;La Réunion;974;1;93;411;Saint-Denis;147931;1382;149313
04;La Réunion;974;2;94;412;Saint-Joseph;37644;522;38166
04;La Réunion;974;4;95;413;Saint-Leu;33576;454;34030
04;La Réunion;974;2;96;414;Saint-Louis;53365;591;53956
04;La Réunion;974;4;97;415;Saint-Paul;104519;1368;105887
04;La Réunion;974;2;08;417;Saint-Philippe;5260;53;5313
04;La Réunion;974;2;98;416;Saint-Pierre;84212;871;85083
04;La Réunion;974;1;23;418;Sainte-Marie;33839;391;34230
04;La Réunion;974;3;08;419;Sainte-Rose;6418;79;6497
04;La Réunion;974;1;04;420;Sainte-Suzanne;23505;199;23704
04;La Réunion;974;3;06;421;Salazie;7312;75;7387
04;La Réunion;974;2;99;422;Le Tampon;78629;1076;79705
04;La Réunion;974;4;14;423;Les Trois-Bassins;7139;95;7234
